station_id,station_name,station_y,station_x,citizen_user_usage,tourist_user_usage,total_user_usage,citizen_station_usage,tourist_station_usage,total_station_usage,station_address,cluster_group,cluster_target,cluster_level,cluster_x,cluster_y
1,국제여객선터미널,33.52438,126.54433,4003,2122,6125,3912,1875,5787,제주특별자치도 제주시 건입동 908-20,제주시,0,1,126.528805,33.50356375
2,오광로입구,33.49527,126.45618,8422,2301,10723,8105,2210,10315,제주특별자치도 제주시 이호이동 1587-4,제주시,0,2,126.528805,33.50356375
3,오광로입구,33.495459999999994,126.45623,940,288,1228,908,276,1184,제주특별자치도 제주시 이호이동 1587-1,제주시,0,2,126.528805,33.50356375
4,이호2동,33.49488,126.46137,9892,206,10098,9827,188,10015,제주특별자치도 제주시 이호이동 803-6,제주시,1,2,126.4019414285714,33.479899999999994
5,이호2동,33.49508,126.46122,3007,113,3120,2979,109,3088,제주특별자치도 제주시 이호이동 803-5,제주시,1,2,126.4019414285714,33.479899999999994
6,노형주공아파트,33.4906,126.47393000000001,4202,16,4218,4149,16,4165,제주특별자치도 제주시 노형동 2577-2,제주시,2,2,126.40150375000002,33.478381250000005
7,노형주공아파트,33.49068,126.47418,10200,173,10373,10124,172,10296,제주특별자치도 제주시 노형동 1238-1,제주시,2,2,126.40150375000002,33.478381250000005
8,못가름,33.48843,126.47678,1541,53,1594,1525,52,1577,제주특별자치도 제주시 노형동 1297-5,제주시,3,2,126.46005749999999,33.49101875
9,노형우체국,33.48765,126.47726000000002,28730,595,29325,28427,578,29005,제주특별자치도 제주시 노형동 1064-6,제주시,3,2,126.46005749999999,33.49101875
10,노형우체국,33.48709,126.47833,16780,283,17063,16540,269,16809,제주특별자치도 제주시 노형동 1297-5,제주시,578,4,126.47833,33.48709
11,노형오거리,33.48503,126.48013,34003,1269,35272,33396,1180,34576,제주특별자치도 제주시 노형동 919,제주시,4,2,126.57949375000001,33.455851249999995
12,롯데마트,33.4819,126.48218,11926,337,12263,11815,334,12149,제주특별자치도 제주시 노형동 767,제주시,5,2,126.52680249999999,33.47999624999999
13,롯데마트,33.48215,126.4824,19585,443,20028,19335,421,19756,제주특별자치도 제주시 노형동 767,제주시,5,2,126.52680249999999,33.47999624999999
14,비석동,33.48838,126.4179,1389,91,1480,1351,87,1438,제주특별자치도 제주시 애월읍 하귀1리 275-4,제주시,579,4,126.4179,33.48838
15,관전동,33.48883,126.41909,5096,167,5263,5041,160,5201,제주특별자치도 제주시 애월읍 하귀1리 264-7,제주시,3,3,126.46005749999999,33.49101875
16,관전동,33.48983,126.42015,570,19,589,565,19,584,제주특별자치도 제주시 애월읍 하귀1리 13,제주시,3,3,126.46005749999999,33.49101875
17,연대마을,33.49129,126.4228,1451,113,1564,1412,106,1518,제주특별자치도 제주시 외도일동 2111-1,제주시,6,2,126.468044,33.475798999999995
18,연대마을,33.49174,126.42325,867,94,961,847,89,936,제주특별자치도 제주시 외도일동 2552-1,제주시,6,2,126.468044,33.475798999999995
19,수정동,33.49264,126.42858999999999,3766,532,4298,3700,505,4205,제주특별자치도 제주시 외도일동 646-1,제주시,7,2,126.49200428571427,33.494951428571426
20,연대마을,33.49282,126.42858000000001,5355,478,5833,5210,459,5669,제주특별자치도 제주시 외도이동 2552,제주시,7,2,126.49200428571427,33.494951428571426
21,모감동,33.47573,126.38115,975,190,1165,938,184,1122,제주특별자치도 제주시 애월읍 구엄리 930-1,제주시,8,2,126.43528,33.484955
22,모감동,33.47591,126.38108000000001,509,211,720,488,200,688,제주특별자치도 제주시 애월읍 구엄리 860-5,제주시,8,2,126.43528,33.484955
23,번대동,33.47889,126.39157,465,209,674,450,201,651,제주특별자치도 제주시 애월읍 구엄리 50-1,제주시,580,4,126.39157,33.47889
24,번대동,33.478840000000005,126.39263999999999,1656,258,1914,1629,243,1872,제주특별자치도 제주시 애월읍 하귀2리 2970-1,제주시,58,1,126.44750285714285,33.48175428571429
25,하귀리,33.47955,126.39517,175,36,211,169,34,203,제주특별자치도 제주시 애월읍 하귀2리 2442,제주시,9,2,126.47283285714285,33.49399571428571
26,하귀초등학교,33.48017,126.40212,25532,1249,26781,25152,1192,26344,제주특별자치도 제주시 애월읍 하귀2리 1908-2,제주시,71,3,126.5170125,33.507554999999996
27,외도초등학교,33.49342,126.43321,18650,880,19530,18401,853,19254,제주특별자치도 제주시 외도이동 251-1,제주시,51,3,126.5372542857143,33.463521428571426
28,외도초등학교,33.4939,126.4344,11399,422,11821,11220,407,11627,제주특별자치도 제주시 외도이동 272-38,제주시,51,3,126.5372542857143,33.463521428571426
29,내도동서마을,33.49393,126.43848,3516,186,3702,3491,183,3674,제주특별자치도 제주시 내도동 580-8,제주시,10,2,126.47669142857141,33.496474285714285
30,내도동서마을,33.49415,126.43845,1490,82,1572,1468,80,1548,제주특별자치도 제주시 내도동 580-1,제주시,10,2,126.47669142857141,33.496474285714285
31,내도동동마을,33.49309,126.44243,4353,289,4642,4309,280,4589,제주특별자치도 제주시 내도동 310-8,제주시,11,2,126.58891571428572,33.522305714285714
32,내도동동마을,33.49324,126.44242,2237,79,2316,2199,76,2275,제주특별자치도 제주시 내도동 351-9,제주시,11,2,126.58891571428572,33.522305714285714
33,신산마을,33.493520000000004,126.44445,1891,151,2042,1865,136,2001,제주특별자치도 제주시 내도동 896,제주시,40,3,126.36481875,33.41299125
34,신산마을,33.493520000000004,126.44538999999999,5668,427,6095,5616,394,6010,제주특별자치도 제주시 내도동 274-8,제주시,40,3,126.36481875,33.41299125
35,현사마을,33.4947,126.45023,141,25,166,137,25,162,제주특별자치도 제주시 이호일동 1905-8,제주시,12,2,126.55788625000001,33.49230625
36,현사마을,33.49473,126.44961,4690,1262,5952,4522,1229,5751,제주특별자치도 제주시 이호일동 1962,제주시,12,2,126.55788625000001,33.49230625
37,하귀초등학교,33.48022,126.40105,14511,802,15313,14350,779,15129,제주특별자치도 제주시 애월읍 하귀2리 3016,제주시,71,3,126.5170125,33.507554999999996
38,하귀우체국,33.48122,126.4045,17131,240,17371,16827,230,17057,제주특별자치도 제주시 애월읍 하귀2리 3016,제주시,1,1,126.4019414285714,33.479899999999994
39,하귀우체국,33.4813,126.40443,5000,273,5273,4939,267,5206,제주특별자치도 제주시 애월읍 하귀2리 3016,제주시,1,1,126.4019414285714,33.479899999999994
40,안남동,33.48238,126.40616000000001,764,83,847,761,83,844,제주특별자치도 제주시 애월읍 하귀1리 3013,제주시,13,2,126.43331250000001,33.481816249999994
41,안남동,33.48251,126.40661999999999,3631,106,3737,3595,103,3698,제주특별자치도 제주시 애월읍 하귀1리 1375,제주시,13,2,126.43331250000001,33.481816249999994
42,남주동,33.48368,126.40847,3717,166,3883,3657,153,3810,제주특별자치도 제주시 애월읍 하귀1리 1362-1,제주시,14,2,126.50241000000001,33.50123142857143
43,남주동,33.48405,126.40876000000002,3308,236,3544,3226,230,3456,제주특별자치도 제주시 애월읍 하귀1리 3013,제주시,14,2,126.50241000000001,33.50123142857143
44,하귀환승정류장(하귀하나로마트),33.48567,126.4121,10936,480,11416,10808,465,11273,제주특별자치도 제주시 애월읍 하귀1리 569-3,제주시,2,1,126.40150375000002,33.478381250000005
45,하귀환승정류장(하귀하나로마트),33.48578,126.41171000000001,6012,358,6370,5925,342,6267,제주특별자치도 제주시 애월읍 하귀1리 492-19,제주시,2,1,126.40150375000002,33.478381250000005
46,큰구릉내,33.48655,126.41353000000001,860,79,939,852,79,931,제주특별자치도 제주시 애월읍 하귀1리 477-2,제주시,581,4,126.41353000000001,33.48655
47,학원동,33.47493,126.39766000000002,2116,19,2135,2101,17,2118,제주특별자치도 제주시 애월읍 하귀2리 3018,제주시,582,4,126.39766000000002,33.47493
49,외도부영2차아파트,33.48488,126.43073999999999,11427,55,11482,11264,54,11318,제주특별자치도 제주시 외도일동 644-6,제주시,15,2,126.53399874999998,33.49357875
50,외도부영2차아파트,33.48483,126.43098,15380,121,15501,15247,121,15368,제주특별자치도 제주시 외도일동 646-1,제주시,15,2,126.53399874999998,33.49357875
51,도평초등학교,33.48185,126.44561999999999,5750,57,5807,5629,55,5684,제주특별자치도 제주시 도평동 1351-1,제주시,16,2,126.51379375,33.50224
52,도평초등학교,33.48168,126.44555,3390,22,3412,3355,21,3376,제주특별자치도 제주시 도평동 1352-3,제주시,16,2,126.51379375,33.50224
53,아름마을아파트,33.483979999999995,126.42908,5664,23,5687,5635,23,5658,제주특별자치도 제주시 외도일동 1587-2,제주시,17,2,126.55606124999998,33.50669
54,아름마을아파트,33.48413,126.42833999999999,979,1,980,975,1,976,제주특별자치도 제주시 외도일동 646-1,제주시,17,2,126.55606124999998,33.50669
55,계명동,33.4855,126.4268,456,1,457,453,1,454,제주특별자치도 제주시 외도일동 646-1,제주시,18,2,126.57508249999998,33.493767500000004
56,계명동,33.485929999999996,126.42662,3171,15,3186,3131,15,3146,제주특별자치도 제주시 외도일동 1609-1,제주시,18,2,126.57508249999998,33.493767500000004
57,한라주택,33.48807,126.4268,590,9,599,583,9,592,제주특별자치도 제주시 외도일동 646-1,제주시,19,2,126.41712714285715,33.471355714285714
58,계명동입구,33.48803,126.42665,3166,21,3187,3149,20,3169,제주특별자치도 제주시 외도일동 646-1,제주시,19,2,126.41712714285715,33.471355714285714
59,일우한란아파트,33.492509999999996,126.43087,5860,74,5934,5778,69,5847,제주특별자치도 제주시 외도일동 646-1,제주시,20,2,126.42909875,33.60540125
60,일우한란아파트,33.4926,126.43101999999999,12956,617,13573,12779,592,13371,제주특별자치도 제주시 외도일동 426-1,제주시,20,2,126.42909875,33.60540125
61,우령이마을,33.4885,126.4308,13211,39,13250,13079,39,13118,제주특별자치도 제주시 외도일동 498-9,제주시,21,2,126.53701428571428,33.51103285714286
62,우령마을입구,33.488459999999996,126.43099,19186,209,19395,18995,202,19197,제주특별자치도 제주시 외도일동 646-1,제주시,21,2,126.53701428571428,33.51103285714286
63,외도부영1차아파트,33.48635,126.43097,23370,213,23583,23136,208,23344,제주특별자치도 제주시 외도일동 646-1,제주시,22,2,126.4479757142857,33.47316
64,하귀리,33.47931,126.39563999999999,20,4,24,19,4,23,제주특별자치도 제주시 애월읍 하귀2리 2424-7,제주시,9,2,126.47283285714285,33.49399571428571
65,연미마을회관,33.486540000000005,126.50488999999999,337,2,339,336,2,338,제주특별자치도 제주시 오라이동 3044-3,제주시,23,2,126.48255285714285,33.48248285714286
66,연미마을회관,33.48665,126.5048,427,2,429,425,2,427,제주특별자치도 제주시 오라이동 3034-1,제주시,23,2,126.48255285714285,33.48248285714286
67,연미마을,33.486999999999995,126.50738,477,2,479,475,2,477,제주특별자치도 제주시 오라이동 1918-2,제주시,24,2,126.512225,33.50131125
68,연미마을,33.48686,126.50708999999999,440,13,453,437,12,449,제주특별자치도 제주시 오라이동 1946-1,제주시,24,2,126.512225,33.50131125
69,연미입구,33.48762,126.50838,460,4,464,460,4,464,제주특별자치도 제주시 오라이동 1843-2,제주시,25,2,126.55256857142857,33.50196285714286
70,연미입구,33.48772,126.50846000000001,421,2,423,416,2,418,제주특별자치도 제주시 오라이동 3827-6,제주시,25,2,126.55256857142857,33.50196285714286
72,오라초등학교,33.48916,126.5125,3061,5,3066,3033,5,3038,제주특별자치도 제주시 오라이동 1373-3,제주시,583,4,126.5125,33.48916
73,제주시보건소,33.49129,126.51937,909,10,919,907,10,917,제주특별자치도 제주시 오라일동 1044-12,제주시,26,2,126.56073375000001,33.4921825
74,보건소,33.49108,126.51957,2731,35,2766,2715,33,2748,제주특별자치도 제주시 도남동 1039-3,제주시,26,2,126.56073375000001,33.4921825
75,오라1동,33.49225,126.5173,4113,42,4155,4085,40,4125,제주특별자치도 제주시 오라일동 1042-6,제주시,584,4,126.5173,33.49225
76,오라1동,33.49263,126.51621999999999,4031,39,4070,3997,36,4033,제주특별자치도 제주시 오라일동 1001-9,제주시,27,2,126.40820142857142,33.47559285714285
77,사평마을,33.49287,126.51245,6226,89,6315,6189,85,6274,제주특별자치도 제주시 오라이동 1209-4,제주시,28,2,126.48837428571427,33.499021428571425
78,사평마을,33.49257,126.51321999999999,10273,67,10340,10218,66,10284,제주특별자치도 제주시 오라이동 1212-1,제주시,28,2,126.48837428571427,33.499021428571425
79,동성마을입구,33.4932,126.50753,2663,111,2774,2624,104,2728,제주특별자치도 제주시 오라삼동 2138-1,제주시,29,2,126.53580285714285,33.4833
80,연미마을입구,33.492979999999996,126.5075,3409,87,3496,3378,83,3461,제주특별자치도 제주시 오라삼동 2107-3,제주시,29,2,126.53580285714285,33.4833
83,수산리사무소앞,33.46794000000001,126.39339,3437,81,3518,3387,79,3466,제주특별자치도 제주시 애월읍 수산리 506-7,제주시,30,2,126.64079625,33.50402750000001
84,수산리사무소앞,33.46765,126.39336999999999,11029,238,11267,10876,228,11104,제주특별자치도 제주시 애월읍 수산리 463-12,제주시,30,2,126.64079625,33.50402750000001
85,수산리사무소,33.46954,126.39457,1096,19,1115,1085,19,1104,제주특별자치도 제주시 애월읍 수산리 531-1,제주시,31,2,126.57869714285714,33.49127857142857
86,수산리,33.46995,126.39453999999999,84,3,87,83,3,86,제주특별자치도 제주시 애월읍 수산리 550-1,제주시,31,2,126.57869714285714,33.49127857142857
87,세기아파트,33.49335,126.5015,6802,135,6937,6762,131,6893,제주특별자치도 제주시 오라삼동 2724-2,제주시,35,3,126.58674142857141,33.49185714285714
88,세기아파트,33.493559999999995,126.50055,1574,38,1612,1559,34,1593,제주특별자치도 제주시 오라삼동 2728-2,제주시,35,3,126.58674142857141,33.49185714285714
89,신광사거리,33.49365,126.49318000000001,3024,695,3719,2947,648,3595,제주특별자치도 제주시 연동 305-3,제주시,32,2,126.4152257142857,33.42904285714286
90,신성마을,33.49367,126.48916000000001,5713,509,6222,5650,478,6128,제주특별자치도 제주시 연동 2335-4,제주시,33,2,126.30488375000002,33.38845875
91,신성마을,33.493829999999996,126.48852,6711,1261,7972,6483,1167,7650,제주특별자치도 제주시 연동 1941-1,제주시,33,2,126.30488375000002,33.38845875
92,제성마을,33.49361,126.4854,5101,231,5332,5051,218,5269,제주특별자치도 제주시 연동 2335-4,제주시,57,3,126.45485,33.47211857142857
93,제성마을,33.49374,126.48403,5659,724,6383,5448,668,6116,제주특별자치도 제주시 연동 2419-3,제주시,57,3,126.45485,33.47211857142857
94,제주서중학교,33.49351,126.48168000000001,1699,75,1774,1672,72,1744,제주특별자치도 제주시 연동 2395-1,제주시,34,2,126.291986,33.375851
95,제주서중학교,33.49367,126.48135,3555,172,3727,3448,166,3614,제주특별자치도 제주시 연동 2412-1,제주시,34,2,126.291986,33.375851
96,제주민속오일장,33.493759999999995,126.4767,27518,2002,29520,26960,1904,28864,제주특별자치도 제주시 노형동 1142-3,제주시,60,3,126.49666142857143,33.48074571428571
97,제주민속오일장,33.493520000000004,126.47763,27062,1162,28224,26661,1117,27778,제주특별자치도 제주시 노형동 1297-1,제주시,60,3,126.49666142857143,33.48074571428571
98,제주민속오일장입구,33.493759999999995,126.47495,706,138,844,694,137,831,제주특별자치도 제주시 노형동 1141-3,제주시,35,2,126.58674142857141,33.49185714285714
99,월랑로입구,33.49368,126.47213,5314,444,5758,5248,428,5676,제주특별자치도 제주시 도두일동 2270-2,제주시,3,1,126.46005749999999,33.49101875
100,월랑입구,33.49395,126.47156000000001,6639,326,6965,6516,316,6832,제주특별자치도 제주시 도두일동 2270-3,제주시,3,1,126.46005749999999,33.49101875
107,수선화아파트,33.48923,126.52984,7900,40,7940,7855,40,7895,제주특별자치도 제주시 도남동 91-3,제주시,36,2,126.68651375,33.4751675
108,제주연안여객터미널,33.51898,126.53551999999999,232,118,350,226,113,339,제주특별자치도 제주시 건입동 918-13,제주시,37,2,126.77774749999999,33.52082
109,제주연안여객터미널,33.51915,126.53535,2620,621,3241,2594,579,3173,제주특별자치도 제주시 건입동 918-54,제주시,37,2,126.77774749999999,33.52082
110,산지변전소,33.51713,126.53268,955,78,1033,935,76,1011,제주특별자치도 제주시 건입동 984-4,제주시,38,2,126.54743142857144,33.496007142857145
111,산지변전소,33.51692,126.53261,182,28,210,179,28,207,제주특별자치도 제주시 건입동 984-118,제주시,38,2,126.54743142857144,33.496007142857145
112,종합어시장,33.5164,126.52793,1073,292,1365,1036,277,1313,제주특별자치도 제주시 건입동 1429,제주시,39,2,126.32776000000001,33.39511
113,탑동푸른쉼터,33.51656,126.52711000000001,7162,758,7920,7013,715,7728,제주특별자치도 제주시 건입동 1388-18,제주시,39,2,126.32776000000001,33.39511
114,탑동입구,33.51531,126.52467,6894,204,7098,6804,195,6999,제주특별자치도 제주시 일도일동 1279-9,제주시,40,2,126.36481875,33.41299125
115,탑동입구,33.51585,126.52483000000001,845,293,1138,818,273,1091,제주특별자치도 제주시 일도일동 1278-11,제주시,40,2,126.36481875,33.41299125
116,남국사,33.46215,126.54958,1120,138,1258,1084,132,1216,제주특별자치도 제주시 아라일동 1918-9,제주시,4,1,126.57949375000001,33.455851249999995
117,남국사,33.46049,126.54978999999999,171,26,197,165,25,190,제주특별자치도 제주시 아라일동 499-7,제주시,585,4,126.54978999999999,33.46049
118,웃인다마을,33.464459999999995,126.54925,650,40,690,634,40,674,제주특별자치도 제주시 아라일동 628-2,제주시,4,1,126.57949375000001,33.455851249999995
119,죽성마을입구,33.46313,126.5491,510,25,535,497,25,522,제주특별자치도 제주시 아라일동 1918-13,제주시,4,1,126.57949375000001,33.455851249999995
120,제주대학교병원,33.469159999999995,126.54777,53554,780,54334,53040,759,53799,제주특별자치도 제주시 아라일동 1801-4,제주시,41,2,126.41387999999999,33.42416142857142
121,제주대학교병원,33.46909,126.54739,22954,453,23407,22538,441,22979,제주특별자치도 제주시 아라일동 1803-8,제주시,41,2,126.41387999999999,33.42416142857142
122,인다마을,33.47064,126.54581999999999,36114,435,36549,35678,423,36101,제주특별자치도 제주시 아라일동 6174,제주시,42,2,126.44627714285716,33.456517142857145
123,인다마을,33.47145,126.5454,10026,172,10198,9903,169,10072,제주특별자치도 제주시 아라일동 6174,제주시,42,2,126.44627714285716,33.456517142857145
124,아라주공아파트,33.473079999999996,126.54569,74238,840,75078,73422,800,74222,제주특별자치도 제주시 아라일동 6174,제주시,43,2,126.41751714285714,33.46041714285714
125,아라주공아파트,33.473659999999995,126.54542,14311,277,14588,14112,269,14381,제주특별자치도 제주시 아라일동 6092-7,제주시,43,2,126.41751714285714,33.46041714285714
126,케이티앤지,33.48207,126.48535,19052,323,19375,18832,316,19148,제주특별자치도 제주시 노형동 767,제주시,586,4,126.48535,33.48207
127,종합사격장,33.44028,126.56753,243,22,265,242,22,264,제주특별자치도 제주시 영평동 산 8-24,제주시,63,3,126.5741,33.48683
128,종합사격장,33.441829999999996,126.56625,79,3,82,75,3,78,제주특별자치도 제주시 아라일동 3-44,제주시,63,3,126.5741,33.48683
129,제주의료원,33.44571,126.55843,5629,143,5772,5571,136,5707,제주특별자치도 제주시 아라일동 4-121,제주시,44,2,126.58267,33.47515857142857
130,제주의료원,33.44567,126.55816000000002,1447,61,1508,1415,57,1472,제주특별자치도 제주시 아라일동 2986-1,제주시,44,2,126.58267,33.47515857142857
131,아라동주민센터,33.4759,126.5449,44171,574,44745,43562,557,44119,제주특별자치도 제주시 아라일동 6174,제주시,5,1,126.52680249999999,33.47999624999999
132,아라초등학교,33.47653,126.54428,11883,214,12097,11645,211,11856,제주특별자치도 제주시 아라일동 6174,제주시,5,1,126.52680249999999,33.47999624999999
135,산천단,33.44786,126.55538999999999,8238,668,8906,8119,639,8758,제주특별자치도 제주시 아라일동 371-4,제주시,45,2,126.55458375,33.445024999999994
136,산천단한국폴리텍대학,33.447990000000004,126.55558,24595,525,25120,24167,522,24689,제주특별자치도 제주시 아라일동 370-10,제주시,45,2,126.55458375,33.445024999999994
137,사회복지법인춘강,33.45265,126.55125,28,5,33,28,5,33,제주특별자치도 제주시 아라일동 2995-25,제주시,46,2,126.62861222222222,33.44766888888889
138,사회복지법인춘강,33.45264,126.55163999999999,1466,38,1504,1453,37,1490,제주특별자치도 제주시 아라일동 415-14,제주시,46,2,126.62861222222222,33.44766888888889
139,영주고등학교,33.457190000000004,126.57786000000002,13325,76,13401,12821,73,12894,제주특별자치도 제주시 월평동 1378-1,제주시,47,2,126.44603000000001,33.468295000000005
140,영주고등학교,33.45712,126.57775,2488,69,2557,2434,69,2503,제주특별자치도 제주시 월평동 651-73,제주시,47,2,126.44603000000001,33.468295000000005
141,정부제주지방합동청사,33.49205,126.52738000000001,21493,135,21628,21353,131,21484,제주특별자치도 제주시 도남동 91-2,제주시,48,2,126.40944571428574,33.456941428571426
142,정부제주지방합동청사,33.4923,126.5266,22383,213,22596,22244,207,22451,제주특별자치도 제주시 도남동 91-2,제주시,48,2,126.40944571428574,33.456941428571426
143,양지(추모)공원,33.43865,126.57652,683,37,720,650,34,684,제주특별자치도 제주시 영평동 2255-2,제주시,49,2,126.67595750000001,33.484984999999995
144,양지(추모)공원,33.43848,126.5764,159,23,182,150,23,173,제주특별자치도 제주시 영평동 2255-5,제주시,49,2,126.67595750000001,33.484984999999995
145,제주국제대학교,33.438629999999996,126.56943999999999,2771,214,2985,2705,207,2912,제주특별자치도 제주시 영평동 산 8-10,제주시,50,2,126.62230625,33.503832499999994
146,제주국제대학교,33.43842,126.56936,1857,139,1996,1847,135,1982,제주특별자치도 제주시 영평동 산 8-6,제주시,50,2,126.62230625,33.503832499999994
147,용천마을,33.49991,126.52135,19164,1322,20486,19036,1250,20286,제주특별자치도 제주시 삼도일동 585-35,제주시,51,2,126.5372542857143,33.463521428571426
148,남서광마을입구,33.49968,126.52126000000001,44728,2133,46861,44363,2017,46380,제주특별자치도 제주시 삼도일동 585-35,제주시,51,2,126.5372542857143,33.463521428571426
149,제주버스터미널,33.49993,126.51486000000001,112199,11887,124086,109996,11231,121227,제주특별자치도 제주시 오라일동 2455-2,제주시,6,1,126.468044,33.475798999999995
150,제주버스터미널,33.5002,126.51471000000001,55708,7830,63538,54706,7454,62160,제주특별자치도 제주시 용담일동 2830-6,제주시,6,1,126.468044,33.475798999999995
151,한국병원,33.499790000000004,126.51768999999999,42711,5048,47759,41989,4775,46764,제주특별자치도 제주시 삼도일동 585-35,제주시,52,2,126.47459428571428,33.483898571428576
152,한국병원,33.50005,126.51807,18924,851,19775,18792,813,19605,제주특별자치도 제주시 삼도일동 585-35,제주시,52,2,126.47459428571428,33.483898571428576
153,중앙마을,33.50163,126.5197,1004,24,1028,994,24,1018,제주특별자치도 제주시 삼도일동 533-6,제주시,53,2,126.58769124999998,33.44820375
154,용천마을,33.50155,126.51995,2752,275,3027,2723,269,2992,제주특별자치도 제주시 삼도일동 585-13,제주시,53,2,126.58769124999998,33.44820375
155,삼도1동주민센터,33.50318,126.51971,1997,27,2024,1985,27,2012,제주특별자치도 제주시 삼도일동 531-14,제주시,587,4,126.51971,33.50318
157,보건소,33.49238,126.52088,8133,115,8248,8056,109,8165,제주특별자치도 제주시 도남동 1035-1,제주시,24,3,126.512225,33.50131125
158,보건소,33.49212,126.52207,11183,62,11245,11086,60,11146,제주특별자치도 제주시 도남동 792-4,제주시,24,3,126.512225,33.50131125
164,광양사거리,33.50047,126.5271,44200,2896,47096,43657,2767,46424,제주특별자치도 제주시 이도일동 1775-21,제주시,588,4,126.5271,33.50047
165,탐라장애인종합복지관,33.50023,126.52563,10041,304,10345,9949,296,10245,제주특별자치도 제주시 이도일동 1938,제주시,54,2,126.51919875,33.456756250000005
166,탐라장애인종합복지관,33.50002,126.52583,41760,1587,43347,41252,1532,42784,제주특별자치도 제주시 이도이동 1781-9,제주시,54,2,126.51919875,33.456756250000005
167,홍랑로입구,33.499970000000005,126.52387,15564,654,16218,15459,633,16092,제주특별자치도 제주시 삼도일동 585-35,제주시,55,2,126.57922571428571,33.512727142857145
168,남서광마을,33.499790000000004,126.52376000000001,26464,561,27025,26320,542,26862,제주특별자치도 제주시 삼도일동 585-35,제주시,55,2,126.57922571428571,33.512727142857145
169,동성마을,33.50005,126.51103,5906,265,6171,5859,260,6119,제주특별자치도 제주시 오라이동 2424-7,제주시,56,2,126.64144142857143,33.49493857142857
170,동산교,33.50028,126.51026999999999,13264,2047,15311,13110,1965,15075,제주특별자치도 제주시 용담이동 2637-7,제주시,56,2,126.64144142857143,33.49493857142857
171,월구마을,33.50013,126.507,6584,831,7415,6490,814,7304,제주특별자치도 제주시 오라삼동 2341-3,제주시,589,4,126.507,33.50013
172,오라3동,33.49925,126.50318,7116,304,7420,7045,300,7345,제주특별자치도 제주시 오라삼동 2574-1,제주시,57,2,126.45485,33.47211857142857
173,명신마을,33.49962,126.50303000000001,5529,494,6023,5420,482,5902,제주특별자치도 제주시 용담이동 2775,제주시,57,2,126.45485,33.47211857142857
174,명주주택,33.49579,126.49349,1742,860,2602,1680,835,2515,제주특별자치도 제주시 용담이동 1815,제주시,58,2,126.44750285714285,33.48175428571429
175,명주주택,33.495670000000004,126.49376000000001,886,309,1195,859,285,1144,제주특별자치도 제주시 연동 2514-1,제주시,58,2,126.44750285714285,33.48175428571429
176,문서교,33.52815,126.61419,428,20,448,425,20,445,제주특별자치도 제주시 조천읍 신촌리 2793,제주시,21,3,126.53701428571428,33.51103285714286
177,문서교,33.527770000000004,126.61328,2176,50,2226,2160,48,2208,제주특별자치도 제주시 조천읍 신촌리 3170-2,제주시,21,3,126.53701428571428,33.51103285714286
178,진드르,33.5242,126.60813,37,5,42,37,5,42,제주특별자치도 제주시 조천읍 신촌리 3096-10,제주시,64,3,126.42354777777776,33.752810000000004
179,진드르,33.52367,126.60692,233,6,239,232,6,238,제주특별자치도 제주시 조천읍 신촌리 4005,제주시,64,3,126.42354777777776,33.752810000000004
180,삼양검문소,33.52095,126.60085,104,11,115,102,10,112,제주특별자치도 제주시 조천읍 신촌리 3901-3,제주시,59,2,126.55799571428572,33.507851428571435
181,삼양검문소,33.52102,126.60003,407,18,425,405,17,422,제주특별자치도 제주시 삼양일동 604-2,제주시,59,2,126.55799571428572,33.507851428571435
184,제원아파트,33.48845,126.49013000000001,13492,657,14149,13171,620,13791,제주특별자치도 제주시 연동 272,제주시,60,2,126.49666142857143,33.48074571428571
185,제원아파트,33.48753,126.48988999999999,33491,2149,35640,32563,2015,34578,제주특별자치도 제주시 연동 262-5,제주시,60,2,126.49666142857143,33.48074571428571
186,은남동,33.485820000000004,126.4909,48717,5664,54381,47602,5326,52928,제주특별자치도 제주시 연동 273,제주시,55,3,126.57922571428571,33.512727142857145
187,은남동,33.48588,126.49248,20611,1032,21643,20362,997,21359,제주특별자치도 제주시 연동 283,제주시,55,3,126.57922571428571,33.512727142857145
188,도호동,33.485659999999996,126.49492,31471,2235,33706,31020,2111,33131,제주특별자치도 제주시 연동 293,제주시,61,2,126.53408285714285,33.43949428571429
189,도호동,33.48581,126.49501000000001,19946,442,20388,19641,420,20061,제주특별자치도 제주시 연동 293,제주시,61,2,126.53408285714285,33.43949428571429
190,제주중앙중학교,33.48553,126.49938,1107,13,1120,1093,12,1105,제주특별자치도 제주시 연동 313,제주시,62,2,126.5365675,33.501315000000005
191,제주중앙중학교,33.485690000000005,126.5001,656,8,664,643,8,651,제주특별자치도 제주시 연동 323-14,제주시,62,2,126.5365675,33.501315000000005
192,함덕환승정류장(함덕해수욕장),33.54101,126.66913999999998,42076,9698,51774,40772,9057,49829,제주특별자치도 제주시 조천읍 함덕리 4143,제주시,63,2,126.5741,33.48683
193,함덕리(4구),33.53998,126.67323,6937,540,7477,6761,521,7282,제주특별자치도 제주시 조천읍 함덕리 286-6,제주시,590,4,126.67323,33.53998
195,함덕광명샤인빌앞,33.53823,126.67461000000002,7541,209,7750,7377,201,7578,제주특별자치도 제주시 조천읍 함덕리 4171,제주시,55,1,126.57922571428571,33.512727142857145
196,신사동,33.53483,126.67575,10863,172,11035,10718,168,10886,제주특별자치도 제주시 조천읍 함덕리 72-5,제주시,7,1,126.49200428571427,33.494951428571426
197,신사동,33.534659999999995,126.6756,200,4,204,200,4,204,제주특별자치도 제주시 조천읍 함덕리 72-60,제주시,7,1,126.49200428571427,33.494951428571426
198,함덕환승정류장(함덕해수욕장),33.54101,126.66877,20820,4467,25287,20304,4263,24567,제주특별자치도 제주시 조천읍 함덕리 1002-73,제주시,63,2,126.5741,33.48683
199,제주모자원입구,33.46286,126.56643999999999,1217,61,1278,1197,57,1254,제주특별자치도 제주시 영평동 2796,제주시,591,4,126.56643999999999,33.46286
200,제주대학교,33.45989,126.56161999999999,39652,1182,40834,39144,1127,40271,제주특별자치도 제주시 아라일동 1,제주시,64,2,126.42354777777776,33.752810000000004
201,제주대학교,33.46011,126.56166,154142,2093,156235,151976,2027,154003,제주특별자치도 제주시 아라이동 35-4,제주시,64,2,126.42354777777776,33.752810000000004
202,제대아파트,33.45878,126.55735,49,10,59,49,10,59,제주특별자치도 제주시 아라일동 349-5,제주시,65,2,126.42995666666667,33.62573555555556
203,제대아파트,33.4589,126.5573,5237,290,5527,5125,279,5404,제주특별자치도 제주시 아라일동 349-4,제주시,65,2,126.42995666666667,33.62573555555556
204,제대마을,33.45772,126.55401,127,8,135,126,8,134,제주특별자치도 제주시 아라일동 452-9,제주시,66,2,126.6356425,33.44581
205,제대마을,33.45785,126.55394,3487,316,3803,3457,309,3766,제주특별자치도 제주시 아라일동 452-2,제주시,66,2,126.6356425,33.44581
206,제주대학교입구,33.45627,126.55175,3541,184,3725,3522,179,3701,제주특별자치도 제주시 아라일동 428-2,제주시,29,1,126.53580285714285,33.4833
207,제주대학교입구,33.456720000000004,126.55076000000001,6837,436,7273,6749,425,7174,제주특별자치도 제주시 아라일동 426-11,제주시,29,1,126.53580285714285,33.4833
208,서해아파트,33.504259999999995,126.54151999999999,14781,77,14858,14653,74,14727,제주특별자치도 제주시 일도이동 414,제주시,67,2,126.3706425,33.434627500000005
209,서해아파트,33.50488,126.54153000000001,14425,137,14562,14269,135,14404,제주특별자치도 제주시 일도이동 459,제주시,67,2,126.3706425,33.434627500000005
210,인화동,33.50888,126.53981999999999,10155,185,10340,10078,178,10256,제주특별자치도 제주시 일도이동 432,제주시,68,2,126.6912025,33.51858
211,인화동,33.50923,126.5394,4952,78,5030,4934,77,5011,제주특별자치도 제주시 일도이동 330-26,제주시,68,2,126.6912025,33.51858
212,일도2동주민센터,33.51068,126.53906,4441,61,4502,4423,58,4481,제주특별자치도 제주시 일도이동 432,제주시,8,1,126.43528,33.484955
213,일도2동주민센터,33.5113,126.53853000000001,6580,47,6627,6557,46,6603,제주특별자치도 제주시 일도이동 161-21,제주시,8,1,126.43528,33.484955
214,인화동입구,33.51272,126.53851999999999,4853,59,4912,4836,59,4895,제주특별자치도 제주시 일도이동 421,제주시,8,1,126.43528,33.484955
215,인화동입구,33.51362,126.53827,2450,110,2560,2428,110,2538,제주특별자치도 제주시 일도이동 1050-1,제주시,8,1,126.43528,33.484955
216,제주해양경찰서,33.52042,126.5397,79,21,100,79,21,100,제주특별자치도 제주시 건입동 918-13,제주시,69,2,126.49114,33.488147500000004
218,제4부두,33.520179999999996,126.53818000000001,1263,267,1530,1186,230,1416,제주특별자치도 제주시 건입동 918-13,제주시,592,4,126.53818000000001,33.520179999999996
219,원당분화원,33.52107,126.59493,536,14,550,523,14,537,제주특별자치도 제주시 삼양일동 1354-6,제주시,593,4,126.59493,33.52107
220,원당봉,33.52166,126.59325,2191,21,2212,2172,20,2192,제주특별자치도 제주시 삼양일동 1509-4,제주시,594,4,126.59325,33.52166
221,삼양초등학교,33.52112,126.58611,27785,829,28614,27358,788,28146,제주특별자치도 제주시 삼양이동 2186-1,제주시,70,2,126.50214,33.4967575
222,삼양동주민센터,33.52128,126.58567,48438,1273,49711,47679,1207,48886,제주특별자치도 제주시 삼양이동 2186-1,제주시,70,2,126.50214,33.4967575
223,삼양2동,33.52128,126.58236000000001,26373,364,26737,26100,357,26457,제주특별자치도 제주시 삼양이동 2186-1,제주시,31,3,126.57869714285714,33.49127857142857
224,삼양2동,33.52118,126.58041999999999,7007,100,7107,6899,94,6993,제주특별자치도 제주시 삼양이동 2186-1,제주시,31,3,126.57869714285714,33.49127857142857
225,조천리,33.535779999999995,126.6365,5849,148,5997,5710,139,5849,제주특별자치도 제주시 조천읍 조천리 2229-9,제주시,9,1,126.47283285714285,33.49399571428571
226,조천리,33.535779999999995,126.63625,14924,203,15127,14755,200,14955,제주특별자치도 제주시 조천읍 조천리 2385,제주시,9,1,126.47283285714285,33.49399571428571
228,조천리새마을공장,33.53497,126.63271,5678,145,5823,5601,142,5743,제주특별자치도 제주시 조천읍 조천리 3205-1,제주시,71,2,126.5170125,33.507554999999996
229,조천읍사무소,33.534859999999995,126.63217,1366,108,1474,1309,103,1412,제주특별자치도 제주시 조천읍 조천리 3231,제주시,71,2,126.5170125,33.507554999999996
230,대섬입구,33.53568,126.62565,1845,196,2041,1793,193,1986,제주특별자치도 제주시 조천읍 신촌리 541-4,제주시,72,2,126.47784000000001,33.740965
231,대섬입구,33.53586,126.62603999999999,2618,235,2853,2576,228,2804,제주특별자치도 제주시 조천읍 신촌리 529-17,제주시,72,2,126.47784000000001,33.740965
232,신촌리,33.53463,126.62168,14578,214,14792,14415,207,14622,제주특별자치도 제주시 조천읍 신촌리 4005,제주시,73,2,126.55358000000001,33.5120225
233,신촌리,33.53439,126.62156,5172,161,5333,5075,158,5233,제주특별자치도 제주시 조천읍 신촌리 1791-3,제주시,73,2,126.55358000000001,33.5120225
234,신촌초등학교,33.53275,126.61877,22164,602,22766,21836,579,22415,제주특별자치도 제주시 조천읍 신촌리 4005,제주시,10,1,126.47669142857141,33.496474285714285
235,신촌초등학교,33.5323,126.61856,7722,272,7994,7520,260,7780,제주특별자치도 제주시 조천읍 신촌리 4005,제주시,10,1,126.47669142857141,33.496474285714285
236,명도암입구,33.48465,126.60386000000001,13,4,17,13,2,15,제주특별자치도 제주시 봉개동 2736,제주시,74,2,126.43390000000001,33.449625
237,명도암입구,33.48495,126.60411,92,13,105,90,12,102,제주특별자치도 제주시 봉개동 601-12,제주시,74,2,126.43390000000001,33.449625
239,봉개동주민센터,33.49073,126.59445,11273,70,11343,11168,69,11237,제주특별자치도 제주시 봉개동 1829-3,제주시,595,4,126.59445,33.49073
240,화북주공아파트,33.521229999999996,126.57588999999999,8727,80,8807,8621,79,8700,제주특별자치도 제주시 화북일동 29-1,제주시,79,3,126.56231499999998,33.51245
241,화북주공아파트,33.52121,126.57471000000001,27490,319,27809,27251,310,27561,제주특별자치도 제주시 화북일동 1265-4,제주시,79,3,126.56231499999998,33.51245
242,화북주공아파트입구,33.51882,126.57271000000001,2318,16,2334,2264,15,2279,제주특별자치도 제주시 화북일동 1221-13,제주시,11,1,126.58891571428572,33.522305714285714
243,화북주공아파트입구,33.51899,126.57295,8652,60,8712,8567,60,8627,제주특별자치도 제주시 화북일동 29-4,제주시,11,1,126.58891571428572,33.522305714285714
244,동화로입구,33.51312,126.57286,4990,31,5021,4887,31,4918,제주특별자치도 제주시 화북이동 826-7,제주시,75,2,126.44789750000001,33.726627500000006
245,동화로입구,33.5124,126.57311999999999,78,3,81,78,1,79,제주특별자치도 제주시 화북이동 824-9,제주시,75,2,126.44789750000001,33.726627500000006
246,혜원정사,33.49038,126.60065,605,11,616,600,11,611,제주특별자치도 제주시 봉개동 1504-5,제주시,596,4,126.60065,33.49038
248,서회천,33.49855,126.60688,97,3,100,96,3,99,제주특별자치도 제주시 회천동 2939-2,제주시,76,2,126.6364875,33.52015
249,서회천,33.49858,126.60673,1830,20,1850,1803,20,1823,제주특별자치도 제주시 회천동 2929-3,제주시,76,2,126.6364875,33.52015
250,조천리상동,33.53522,126.6358,261,5,266,260,5,265,제주특별자치도 제주시 조천읍 조천리 2202-1,제주시,9,1,126.47283285714285,33.49399571428571
251,신설동,33.49788,126.54661999999999,5709,61,5770,5676,58,5734,제주특별자치도 제주시 일도이동 115,제주시,42,3,126.44627714285716,33.456517142857145
252,신설동,33.49865,126.54843000000001,4030,30,4060,4010,30,4040,제주특별자치도 제주시 일도이동 115,제주시,42,3,126.44627714285716,33.456517142857145
253,대림아파트,33.49962,126.55023,7681,72,7753,7632,72,7704,제주특별자치도 제주시 일도이동 115,제주시,77,2,126.50119,33.48135499999999
254,대림아파트,33.49988,126.55038,11458,64,11522,11389,64,11453,제주특별자치도 제주시 일도이동 115,제주시,77,2,126.50119,33.48135499999999
255,대유대림아파트,33.50245,126.55272,12358,78,12436,12308,77,12385,제주특별자치도 제주시 일도이동 91-1,제주시,78,2,126.559105,33.5105825
256,대유대림아파트,33.5024,126.5526,12671,53,12724,12583,52,12635,제주특별자치도 제주시 일도이동 91-1,제주시,78,2,126.559105,33.5105825
257,신천동,33.50393,126.54959,6711,83,6794,6670,82,6752,제주특별자치도 제주시 일도이동 115-13,제주시,79,2,126.56231499999998,33.51245
258,신천동,33.50343,126.54907,5461,27,5488,5438,27,5465,제주특별자치도 제주시 일도이동 115-13,제주시,79,2,126.56231499999998,33.51245
259,동광초등학교,33.5017,126.54576000000002,3480,30,3510,3444,30,3474,제주특별자치도 제주시 일도이동 115,제주시,16,3,126.51379375,33.50224
260,동광초등학교,33.5014,126.54475,5884,158,6042,5836,146,5982,제주특별자치도 제주시 일도이동 115,제주시,16,3,126.51379375,33.50224
261,연수마을,33.50163,126.54336,8384,84,8468,8302,83,8385,제주특별자치도 제주시 일도이동 115,제주시,80,2,126.5587575,33.5094175
262,제주학생문화원,33.5015,126.54316999999999,6221,39,6260,6171,37,6208,제주특별자치도 제주시 이도이동 443,제주시,80,2,126.5587575,33.5094175
263,회천입구,33.489000000000004,126.5984,14932,334,15266,14764,322,15086,제주특별자치도 제주시 봉개동 2736,제주시,81,2,126.479065,33.4204475
264,봉개큰동네,33.48935,126.59881000000001,72,4,76,72,4,76,제주특별자치도 제주시 봉개동 1585-5,제주시,81,2,126.479065,33.4204475
265,화북동마을,33.52352,126.56751000000001,1071,5,1076,1068,5,1073,제주특별자치도 제주시 화북일동 1995-7,제주시,597,4,126.56751000000001,33.52352
266,화북중마을,33.52333,126.56472,1398,3,1401,1389,3,1392,제주특별자치도 제주시 화북일동 1995-3,제주시,598,4,126.56472,33.52333
267,화북서마을,33.522870000000005,126.56286999999999,2137,3,2140,2126,3,2129,제주특별자치도 제주시 화북일동 1995,제주시,599,4,126.56286999999999,33.522870000000005
268,화북남문,33.5189,126.56512,67653,509,68162,67082,495,67577,제주특별자치도 제주시 화북일동 1995-5,제주시,78,3,126.559105,33.5105825
269,삼성초등학교,33.5041,126.52663999999999,24121,711,24832,23933,687,24620,제주특별자치도 제주시 이도일동 1938,제주시,82,2,126.52695,33.50376
270,보성시장,33.50342,126.52726000000001,23733,1250,24983,23559,1197,24756,제주특별자치도 제주시 이도일동 1938,제주시,82,2,126.52695,33.50376
271,광양,33.502320000000005,126.52806000000001,25331,721,26052,25099,702,25801,제주특별자치도 제주시 이도일동 1938,제주시,83,2,126.52801000000001,33.502215
272,광양,33.502109999999995,126.52796000000001,27691,272,27963,27572,266,27838,제주특별자치도 제주시 이도일동 1789-3,제주시,83,2,126.52801000000001,33.502215
273,동광양,33.50202,126.5322,58749,3519,62268,57820,3381,61201,제주특별자치도 제주시 이도이동 1174-26,제주시,84,2,126.53220999999999,33.50211
274,동광양,33.5022,126.53222,29711,1758,31469,29441,1687,31128,제주특별자치도 제주시 이도일동 1938,제주시,84,2,126.53220999999999,33.50211
275,문예회관,33.504490000000004,126.53703,17586,842,18428,17367,818,18185,제주특별자치도 제주시 이도이동 326,제주시,85,2,126.53697,33.50456
276,문예회관,33.50463,126.53691,26665,592,27257,26445,577,27022,제주특별자치도 제주시 일도이동 449,제주시,85,2,126.53697,33.50456
277,인화초등학교,33.50602,126.53888,32022,321,32343,31789,310,32099,제주특별자치도 제주시 일도이동 449,제주시,86,2,126.539125,33.50635
278,인화초등학교,33.506679999999996,126.53936999999999,60638,703,61341,59992,681,60673,제주특별자치도 제주시 일도이동 449,제주시,86,2,126.539125,33.50635
279,동문로터리(동문시장),33.51315,126.52706,66596,13712,80308,64707,12998,77705,제주특별자치도 제주시 일도일동 1478-9,제주시,600,4,126.52706,33.51315
280,동문로터리(동문시장),33.512950000000004,126.52795,97255,4594,101849,95998,4423,100421,제주특별자치도 제주시 일도일동 1491-1,제주시,12,1,126.55788625000001,33.49230625
281,중앙로(중앙성당),33.512,126.52447,22361,2037,24398,22023,1960,23983,제주특별자치도 제주시 이도일동 1369-1,제주시,13,1,126.43331250000001,33.481816249999994
282,중앙로(동문시장),33.51168,126.52457,31916,1150,33066,31717,1113,32830,제주특별자치도 제주시 이도일동 1410-3,제주시,13,1,126.43331250000001,33.481816249999994
283,중앙로(현대약국),33.51089,126.52421000000001,54839,5487,60326,54094,5213,59307,제주특별자치도 제주시 이도일동 1471-3,제주시,13,1,126.43331250000001,33.481816249999994
284,중앙로(국민은행),33.51073,126.5239,91095,2272,93367,89887,2187,92074,제주특별자치도 제주시 이도일동 1466-1,제주시,13,1,126.43331250000001,33.481816249999994
285,시민회관,33.507329999999996,126.5247,32640,1003,33643,32330,977,33307,제주특별자치도 제주시 이도일동 1938,제주시,87,2,126.524625,33.507215
286,시민회관,33.5071,126.52455,42192,458,42650,41752,450,42202,제주특별자치도 제주시 삼도이동 231-3,제주시,87,2,126.524625,33.507215
288,명도암마을회관,33.47099,126.61086,1210,1,1211,1205,1,1206,제주특별자치도 제주시 봉개동 418-1,제주시,601,4,126.61086,33.47099
291,천수동,33.50847,126.5419,55770,2144,57914,55001,2083,57084,제주특별자치도 제주시 일도이동 449,제주시,88,2,126.542235,33.508905
292,천수동,33.50934,126.54257,42726,1285,44011,42345,1229,43574,제주특별자치도 제주시 일도이동 449,제주시,88,2,126.542235,33.508905
293,국립제주박물관,33.51248,126.54997,10568,554,11122,10422,528,10950,제주특별자치도 제주시 건입동 1427-5,제주시,602,4,126.54997,33.51248
294,고으니모르국립제주박물관,33.512609999999995,126.55096,10193,1804,11997,9975,1737,11712,제주특별자치도 제주시 화북이동 4947-3,제주시,603,4,126.55096,33.512609999999995
295,거로남쪽입구,33.50493,126.5613,578,3,581,572,3,575,제주특별자치도 제주시 화북이동 3254-2,제주시,14,1,126.50241000000001,33.50123142857143
296,거로남쪽입구,33.50495,126.56168999999998,567,8,575,562,8,570,제주특별자치도 제주시 화북이동 3254-1,제주시,14,1,126.50241000000001,33.50123142857143
297,부록마을,33.50136,126.56926999999999,290,11,301,288,11,299,제주특별자치도 제주시 화북이동 2780-4,제주시,89,2,126.56900999999999,33.501605
298,부록마을,33.50185,126.56875,1821,44,1865,1804,44,1848,제주특별자치도 제주시 화북이동 2650-3,제주시,89,2,126.56900999999999,33.501605
299,화물청사입구,33.50418,126.50448,1475,499,1974,1457,475,1932,제주특별자치도 제주시 용담이동 746-3,제주시,604,4,126.50448,33.50418
300,용문마을회관,33.50495,126.50765,8927,415,9342,8805,396,9201,제주특별자치도 제주시 용담이동 2813-1,제주시,90,2,126.50795,33.505300000000005
301,용문마을회관,33.50565,126.50825,8231,1128,9359,8112,1084,9196,제주특별자치도 제주시 용담이동 674-3,제주시,90,2,126.50795,33.505300000000005
302,용문마을,33.507259999999995,126.50936000000002,11970,401,12371,11865,395,12260,제주특별자치도 제주시 용담이동 2681-47,제주시,91,2,126.50938500000001,33.50745499999999
303,용문마을,33.50765,126.50941,4176,477,4653,4127,469,4596,제주특별자치도 제주시 용담이동 2580-42,제주시,91,2,126.50938500000001,33.50745499999999
304,용문사거리,33.50866,126.51023,36586,1089,37675,36199,1042,37241,제주특별자치도 제주시 용담이동 2679-7,제주시,92,2,126.51014,33.508735
305,용문사거리,33.50881,126.51005,27509,1895,29404,27210,1825,29035,제주특별자치도 제주시 용담이동 641-29,제주시,92,2,126.51014,33.508735
306,용담1동주민센터,33.50973,126.51323000000001,30445,644,31089,30190,619,30809,제주특별자치도 제주시 용담일동 2583,제주시,15,1,126.53399874999998,33.49357875
307,용담1동주민센터,33.50995,126.51333000000001,18267,1899,20166,18022,1820,19842,제주특별자치도 제주시 용담일동 2579-1,제주시,15,1,126.53399874999998,33.49357875
308,제주중학교/제주향교,33.51078,126.5157,15050,750,15800,14811,728,15539,제주특별자치도 제주시 용담일동 288-1,제주시,19,1,126.41712714285715,33.471355714285714
309,사라봉오거리,33.51367,126.54045,1868,57,1925,1852,56,1908,제주특별자치도 제주시 일도이동 421,제주시,29,3,126.53580285714285,33.4833
310,제주여자상업고등학교,33.51383,126.53696000000001,21485,188,21673,21247,179,21426,제주특별자치도 제주시 일도이동 981-43,제주시,93,2,126.53674000000001,33.51388
311,제주여자상업고등학교,33.51393,126.53652,54349,1226,55575,53888,1202,55090,제주특별자치도 제주시 건입동 1047-1,제주시,93,2,126.53674000000001,33.51388
312,제주동초등학교,33.51328,126.5328,19095,309,19404,18895,297,19192,제주특별자치도 제주시 일도이동 1050-1,제주시,16,1,126.51379375,33.50224
313,제주동초등학교,33.51332,126.53221,30960,610,31570,30793,595,31388,제주특별자치도 제주시 건입동 1109-10,제주시,16,1,126.51379375,33.50224
314,사라봉,33.51294,126.54435,3169,146,3315,3151,139,3290,제주특별자치도 제주시 건입동 1427-5,제주시,94,2,126.54476,33.51278
315,사라봉,33.51316,126.54285,5277,53,5330,5238,52,5290,제주특별자치도 제주시 일도이동 421,제주시,605,4,126.54285,33.51316
316,사라봉오거리,33.513529999999996,126.54158000000001,10333,497,10830,10256,480,10736,제주특별자치도 제주시 건입동 711,제주시,29,3,126.53580285714285,33.4833
317,신제주초등학교,33.4843,126.49648,1954,115,2069,1946,111,2057,제주특별자치도 제주시 연동 304,제주시,95,2,126.4964,33.484674999999996
318,연동주민센터,33.48815,126.49636000000001,21013,729,21742,20680,698,21378,제주특별자치도 제주시 연동 302,제주시,96,2,126.49649,33.48773
319,연동주민센터,33.48731,126.49662,50002,2510,52512,49561,2430,51991,제주특별자치도 제주시 연동 303,제주시,96,2,126.49649,33.48773
320,제주도청신제주로터리,33.49143,126.49678,93702,8978,102680,92859,8669,101528,제주특별자치도 제주시 연동 301,제주시,97,2,126.496625,33.491265
321,제주도청신제주로터리,33.4911,126.49647,62807,5204,68011,62143,5037,67180,제주특별자치도 제주시 연동 301,제주시,97,2,126.496625,33.491265
322,서문시장,33.511759999999995,126.51767,18223,2647,20870,17978,2553,20531,제주특별자치도 제주시 용담일동 2579-1,제주시,98,2,126.51805999999999,33.511894999999996
323,서문시장,33.512029999999996,126.51845,25272,1209,26481,24924,1170,26094,제주특별자치도 제주시 용담일동 124-6,제주시,98,2,126.51805999999999,33.511894999999996
324,관덕정,33.51293,126.52096,27423,2368,29791,27114,2290,29404,제주특별자치도 제주시 삼도이동 955-3,제주시,99,2,126.52092,33.513075
325,관덕정,33.513220000000004,126.52088,45177,7798,52975,44331,7427,51758,제주특별자치도 제주시 삼도이동 995-1,제주시,99,2,126.52092,33.513075
326,농협지역본부,33.508070000000004,126.52006000000002,1333,91,1424,1328,90,1418,제주특별자치도 제주시 삼도이동 1230-4,제주시,100,2,126.51994,33.507895000000005
327,농협지역본부,33.50772,126.51982,6425,325,6750,6400,320,6720,제주특별자치도 제주시 삼도일동 794-1,제주시,100,2,126.51994,33.507895000000005
328,제주중앙여자중학교,33.50553,126.51976,6374,63,6437,6347,59,6406,제주특별자치도 제주시 삼도일동 787-25,제주시,101,2,126.51987,33.50523
329,제주중앙여자중학교,33.50493,126.51998,2382,41,2423,2371,33,2404,제주특별자치도 제주시 삼도이동 1230-4,제주시,101,2,126.51987,33.50523
330,수선화아파트,33.48892,126.52982,4502,20,4522,4476,19,4495,제주특별자치도 제주시 도남동 97-1,제주시,36,2,126.68651375,33.4751675
331,이도주공아파트,33.4902,126.53398999999999,2481,18,2499,2457,18,2475,제주특별자치도 제주시 이도이동 747,제주시,102,2,126.534085,33.490365
332,이도주공아파트,33.49053,126.53418,5497,19,5516,5430,19,5449,제주특별자치도 제주시 이도이동 777,제주시,102,2,126.534085,33.490365
333,남광로입구,33.492509999999996,126.53747,4090,27,4117,4058,27,4085,제주특별자치도 제주시 이도이동 1994-7,제주시,103,2,126.537575,33.49272
334,남광초등학교,33.49293,126.53768000000001,3569,13,3582,3529,13,3542,제주특별자치도 제주시 이도이동 1084-6,제주시,103,2,126.537575,33.49272
335,제주제일중학교,33.49385,126.53936999999999,2526,11,2537,2491,10,2501,제주특별자치도 제주시 이도이동 538-18,제주시,17,1,126.55606124999998,33.50669
336,제주제일중학교,33.4942,126.53968,4187,41,4228,4105,41,4146,제주특별자치도 제주시 이도이동 538-18,제주시,17,1,126.55606124999998,33.50669
337,혜성무지개타운,33.4954,126.54178,4866,30,4896,4845,29,4874,제주특별자치도 제주시 이도이동 443,제주시,104,2,126.54207000000001,33.49545499999999
338,혜성무지개타운,33.495509999999996,126.54236000000002,2717,14,2731,2677,14,2691,제주특별자치도 제주시 이도이동 443,제주시,104,2,126.54207000000001,33.49545499999999
339,이도근린공원,33.49708,126.54507,3532,36,3568,3506,36,3542,제주특별자치도 제주시 이도이동 443,제주시,105,2,126.545225,33.497060000000005
340,한마음근린공원,33.497040000000005,126.54538000000001,2457,19,2476,2438,19,2457,제주특별자치도 제주시 이도이동 443,제주시,105,2,126.545225,33.497060000000005
341,삼무공원,33.48997,126.49127,9739,1004,10743,9553,961,10514,제주특별자치도 제주시 연동 271,제주시,30,3,126.64079625,33.50402750000001
342,삼무공원,33.4898,126.4924,11481,4138,15619,10926,3850,14776,제주특별자치도 제주시 연동 281,제주시,30,3,126.64079625,33.50402750000001
343,제주썬호텔,33.48972,126.4937,27,163,190,27,163,190,제주특별자치도 제주시 연동 291,제주시,106,2,126.49371500000001,33.48981
344,제주썬호텔,33.4899,126.49373,1221,2178,3399,1221,2178,3399,제주특별자치도 제주시 연동 291,제주시,106,2,126.49371500000001,33.48981
345,수협제주도지회,33.48987,126.49503,7524,537,8061,7388,501,7889,제주특별자치도 제주시 연동 291,제주시,107,2,126.495125,33.489785
346,수협제주도지회,33.4897,126.49521999999999,3878,1151,5029,3776,1074,4850,제주특별자치도 제주시 연동 291,제주시,107,2,126.495125,33.489785
347,이호동동마을,33.5004,126.46153999999999,1940,142,2082,1908,132,2040,제주특별자치도 제주시 이호일동 613-6,제주시,108,2,126.46124499999999,33.50035
348,이호동동마을,33.5003,126.46095,1104,45,1149,1097,43,1140,제주특별자치도 제주시 이호일동 1961,제주시,108,2,126.46124499999999,33.50035
349,이호동주민센터,33.49905,126.45878,3257,317,3574,3213,308,3521,제주특별자치도 제주시 이호일동 647-1,제주시,109,2,126.45852500000001,33.498909999999995
350,이호동주민센터,33.49877,126.45827,1464,48,1512,1455,48,1503,제주특별자치도 제주시 이호일동 1961,제주시,109,2,126.45852500000001,33.498909999999995
351,이호테우해수욕장,33.49623,126.45546000000002,2543,942,3485,2445,905,3350,제주특별자치도 제주시 이호일동 1962,제주시,110,2,126.455425,33.496275
352,이호테우해수욕장,33.496320000000004,126.45539,217,32,249,205,30,235,제주특별자치도 제주시 이호일동 1600-18,제주시,110,2,126.455425,33.496275
353,월랑초등학교,33.49265,126.4791,10441,173,10614,10340,170,10510,제주특별자치도 제주시 노형동 1085,제주시,111,2,126.479175,33.49259
354,월랑초등학교,33.49253,126.47925,7072,45,7117,6903,44,6947,제주특별자치도 제주시 연동 2335-1,제주시,111,2,126.479175,33.49259
355,남녕마트,33.48993,126.48185,9393,492,9885,9204,469,9673,제주특별자치도 제주시 연동 2335-1,제주시,112,2,126.481855,33.489815
356,남녕마트,33.4897,126.48186000000001,8918,267,9185,8777,258,9035,제주특별자치도 제주시 노형동 1273-6,제주시,112,2,126.481855,33.489815
357,한라병원,33.48944,126.48508000000001,136315,5587,141902,133894,5357,139251,제주특별자치도 제주시 연동 2335-4,제주시,73,3,126.55358000000001,33.5120225
358,한라병원,33.48963,126.486,119199,5206,124405,117568,4939,122507,제주특별자치도 제주시 연동 251-66,제주시,73,3,126.55358000000001,33.5120225
359,노형오거리,33.48666,126.48057,37658,1054,38712,36938,998,37936,제주특별자치도 제주시 노형동 1297-5,제주시,113,2,126.480745,33.486665
360,노형오거리,33.486670000000004,126.48092,78292,2581,80873,77155,2444,79599,제주특별자치도 제주시 노형동 948,제주시,113,2,126.480745,33.486665
361,남녕고등학교,33.488040000000005,126.48311000000001,32801,3065,35866,32172,2861,35033,제주특별자치도 제주시 노형동 948,제주시,606,4,126.48311000000001,33.488040000000005
362,월랑마을남녕고등학교,33.4877,126.48218999999999,27072,2211,29283,26467,2089,28556,제주특별자치도 제주시 노형동 1297-3,제주시,607,4,126.48218999999999,33.4877
363,신안동,33.51957,126.63523,95,5,100,93,5,98,제주특별자치도 제주시 조천읍 조천리 1937-5,제주시,114,2,126.63508000000002,33.519345
364,신안동,33.51912,126.63493000000001,6,3,9,6,3,9,제주특별자치도 제주시 조천읍 조천리 3437-3,제주시,114,2,126.63508000000002,33.519345
367,대기고등학교,33.49168,126.59361000000001,12516,45,12561,12297,41,12338,제주특별자치도 제주시 봉개동 1812-1,제주시,18,1,126.57508249999998,33.493767500000004
368,대기고등학교,33.49205,126.59353,1924,2,1926,1886,2,1888,제주특별자치도 제주시 봉개동 1795-3,제주시,18,1,126.57508249999998,33.493767500000004
370,아르미아파트,33.49604,126.59447,3121,8,3129,3100,8,3108,제주특별자치도 제주시 도련일동 1205-5,제주시,608,4,126.59447,33.49604
372,밤나무골,33.50202,126.59453,1084,5,1089,1083,5,1088,제주특별자치도 제주시 도련일동 1083-2,제주시,609,4,126.59453,33.50202
373,도련반석스위트타운,33.50666,126.59107,693,3,696,688,3,691,제주특별자치도 제주시 도련일동 1585-3,제주시,115,2,126.591145,33.50666
374,도련반석스위트타운,33.50666,126.59121999999999,3443,18,3461,3415,18,3433,제주특별자치도 제주시 도련일동 1588-2,제주시,115,2,126.591145,33.50666
375,도련1동,33.50906,126.59003,17295,79,17374,17174,74,17248,제주특별자치도 제주시 도련일동 1731-14,제주시,116,2,126.58989,33.509190000000004
376,도련1동,33.50932,126.58975,2420,15,2435,2402,14,2416,제주특별자치도 제주시 도련일동 1729-4,제주시,116,2,126.58989,33.509190000000004
377,하나로아파트,33.51097,126.58918,436,1,437,435,1,436,제주특별자치도 제주시 도련일동 1767-2,제주시,117,2,126.58923,33.510975
378,하나로아파트,33.510979999999996,126.58928,4929,17,4946,4865,16,4881,제주특별자치도 제주시 도련일동 1767-2,제주시,117,2,126.58923,33.510975
379,도련1동입구,33.51263,126.58896000000001,920,2,922,913,2,915,제주특별자치도 제주시 도련이동 1819-7,제주시,118,2,126.58900500000001,33.512755
380,도련2동,33.512879999999996,126.58905,2050,24,2074,2012,24,2036,제주특별자치도 제주시 도련이동 1821-7,제주시,118,2,126.58900500000001,33.512755
381,제주자동차검사소,33.514559999999996,126.58898,5422,31,5453,5390,31,5421,제주특별자치도 제주시 도련이동 568-2,제주시,119,2,126.58890500000001,33.514559999999996
382,자동차검사소,33.514559999999996,126.58883,164,1,165,161,1,162,제주특별자치도 제주시 도련이동 564-19,제주시,119,2,126.58890500000001,33.514559999999996
383,용담사거리,33.51093,126.51371999999999,867,113,980,845,109,954,제주특별자치도 제주시 용담일동 309-14,제주시,15,1,126.53399874999998,33.49357875
384,용담사거리,33.510909999999996,126.51387,2227,325,2552,2187,316,2503,제주특별자치도 제주시 용담일동 2579-1,제주시,15,1,126.53399874999998,33.49357875
385,용담새마을금고,33.5097,126.51488,1040,54,1094,1033,53,1086,제주특별자치도 제주시 용담일동 2583,제주시,19,1,126.41712714285715,33.471355714285714
386,용담새마을금고,33.50958,126.51526000000001,269,11,280,268,11,279,제주특별자치도 제주시 용담일동 2583,제주시,19,1,126.41712714285715,33.471355714285714
387,병문교,33.508829999999996,126.51831000000001,186,13,199,185,13,198,제주특별자치도 제주시 삼도일동 1230,제주시,120,2,126.5184,33.5089
388,병문교,33.50897,126.51848999999999,412,62,474,405,62,467,제주특별자치도 제주시 삼도일동 1230,제주시,120,2,126.5184,33.5089
389,서문로터리,33.51173,126.51932,1398,371,1769,1368,360,1728,제주특별자치도 제주시 용담일동 153-4,제주시,121,2,126.51956,33.51126
390,삼무공원사거리,33.49001,126.48853000000001,18497,1012,19509,18166,971,19137,제주특별자치도 제주시 연동 260,제주시,20,1,126.42909875,33.60540125
391,삼무공원사거리,33.4899,126.48892,33331,3394,36725,32583,3120,35703,제주특별자치도 제주시 연동 260,제주시,20,1,126.42909875,33.60540125
392,월성마을회관,33.50202,126.50518000000001,1425,315,1740,1415,306,1721,제주특별자치도 제주시 용담이동 2749-35,제주시,122,2,126.504965,33.50217000000001
393,월성마을회관,33.502320000000005,126.50475,2737,80,2817,2710,76,2786,제주특별자치도 제주시 용담이동 2747-4,제주시,122,2,126.504965,33.50217000000001
394,함덕리(3구),33.541709999999995,126.6666,10649,2109,12758,10199,2011,12210,제주특별자치도 제주시 조천읍 함덕리 1270-1,제주시,76,3,126.6364875,33.52015
395,함덕리(3구),33.54176,126.66573999999999,6545,1070,7615,6406,1019,7425,제주특별자치도 제주시 조천읍 함덕리 1268-7,제주시,76,3,126.6364875,33.52015
396,함덕농협지소,33.542320000000004,126.66448999999999,14504,1120,15624,14219,1067,15286,제주특별자치도 제주시 조천읍 함덕리 1252-47,제주시,123,2,126.66432999999999,33.542335
397,함덕농협지소,33.54235,126.66417,2298,371,2669,2247,352,2599,제주특별자치도 제주시 조천읍 함덕리 4139,제주시,123,2,126.66432999999999,33.542335
398,함덕비석거리,33.54315,126.66225,7378,1166,8544,7193,1072,8265,제주특별자치도 제주시 조천읍 함덕리 1016,제주시,124,2,126.66196,33.54317999999999
399,함덕비석거리,33.543209999999995,126.66167,2479,580,3059,2392,546,2938,제주특별자치도 제주시 조천읍 함덕리 1047-1,제주시,124,2,126.66196,33.54317999999999
400,해양연구소,33.54385,126.65773,5782,556,6338,5622,533,6155,제주특별자치도 제주시 조천읍 함덕리 3230-1,제주시,125,2,126.658145,33.543800000000005
401,해양연구소,33.54375,126.65856000000001,1688,358,2046,1634,348,1982,제주특별자치도 제주시 조천읍 함덕리 3039-2,제주시,125,2,126.658145,33.543800000000005
402,신흥리(마을입구)함덕고등학교,33.5436,126.65364,12227,511,12738,11852,489,12341,제주특별자치도 제주시 조천읍 신흥리 230-1,제주시,126,2,126.65352,33.543475
403,신흥리(마을입구)함덕고등학교,33.54335,126.6534,3350,269,3619,3213,249,3462,제주특별자치도 제주시 조천읍 신흥리 235-2,제주시,126,2,126.65352,33.543475
404,충혼묘지,33.541920000000005,126.64983000000001,536,43,579,525,40,565,제주특별자치도 제주시 조천읍 신흥리 346-1,제주시,127,2,126.64951500000001,33.541745000000006
405,충혼묘지,33.54157,126.6492,200,11,211,184,11,195,제주특별자치도 제주시 조천읍 조천리 3462,제주시,127,2,126.64951500000001,33.541745000000006
406,주암주택,33.54072,126.64567,1240,27,1267,1216,27,1243,제주특별자치도 제주시 조천읍 조천리 803-2,제주시,128,2,126.64555,33.540785
407,주암주택,33.54085,126.64543,2948,53,3001,2930,49,2979,제주특별자치도 제주시 조천읍 조천리 836-1,제주시,128,2,126.64555,33.540785
408,조천만세동산,33.53958,126.6417,5275,201,5476,5188,193,5381,제주특별자치도 제주시 조천읍 조천리 1205-2,제주시,610,4,126.6417,33.53958
409,조천체육관,33.54007,126.64273,1699,152,1851,1632,147,1779,제주특별자치도 제주시 조천읍 조천리 1198-3,제주시,129,2,126.64276,33.540085000000005
410,조천환승정류장(조천리사무소),33.53826,126.6399,6409,329,6738,6229,311,6540,제주특별자치도 제주시 조천읍 조천리 1220-2,제주시,130,2,126.639945,33.537825
411,조천환승정류장(조천우체국),33.5377,126.63877,18056,657,18713,17840,635,18475,제주특별자치도 제주시 조천읍 조천리 2360-1,제주시,611,4,126.63877,33.5377
412,용담레포츠공원,33.51801,126.49991999999999,986,177,1163,962,173,1135,제주특별자치도 제주시 용담삼동 1089-5,제주시,52,3,126.47459428571428,33.483898571428576
413,용담레포츠공원,33.51938,126.49945,135,42,177,133,41,174,제주특별자치도 제주시 용담삼동 1092-2,제주시,52,3,126.47459428571428,33.483898571428576
414,서해안로,33.51982,126.4937,326,119,445,311,118,429,제주특별자치도 제주시 용담삼동 2292-2,제주시,131,2,126.49372500000001,33.519765
415,서해안로,33.519709999999996,126.49375,1320,461,1781,1283,443,1726,제주특별자치도 제주시 용담삼동 2293-6,제주시,131,2,126.49372500000001,33.519765
416,어영마을,33.519009999999994,126.49008,1268,258,1526,1243,245,1488,제주특별자치도 제주시 용담삼동 2580,제주시,132,2,126.48977500000001,33.519009999999994
417,어영마을,33.519009999999994,126.48947,427,52,479,419,50,469,제주특별자치도 제주시 용담삼동 2292-26,제주시,132,2,126.48977500000001,33.519009999999994
418,몰래물,33.51051,126.48283,520,176,696,504,168,672,제주특별자치도 제주시 도두이동 706-12,제주시,133,2,126.482505,33.5105
419,제주대학교교육대학,33.51312,126.553,3435,95,3530,3378,91,3469,제주특별자치도 제주시 화북이동 4948-1,제주시,59,3,126.55799571428572,33.507851428571435
420,제주대학교교육대학,33.5137,126.55388,14472,148,14620,14271,147,14418,제주특별자치도 제주시 화북일동 4810-1,제주시,59,3,126.55799571428572,33.507851428571435
421,거로입구,33.51464,126.55623999999999,11321,117,11438,11212,115,11327,제주특별자치도 제주시 화북일동 5749,제주시,21,1,126.53701428571428,33.51103285714286
422,거로입구,33.51453,126.55653000000001,6945,68,7013,6835,65,6900,제주특별자치도 제주시 화북일동 4701-5,제주시,21,1,126.53701428571428,33.51103285714286
423,오현중고등학교,33.51518,126.55707,32780,403,33183,31844,390,32234,제주특별자치도 제주시 화북일동 4668-5,제주시,21,1,126.53701428571428,33.51103285714286
424,오현중고등학교,33.515609999999995,126.55861000000002,12563,381,12944,12056,373,12429,제주특별자치도 제주시 화북일동 4723,제주시,612,4,126.55861000000002,33.515609999999995
425,화북초등학교,33.51762,126.56172,9429,153,9582,9225,145,9370,제주특별자치도 제주시 화북일동 3994-11,제주시,134,2,126.562065,33.51766
427,월산마을,33.47305,126.46346000000001,12993,171,13164,12901,169,13070,제주특별자치도 제주시 노형동 3378-1,제주시,135,2,126.463255,33.473110000000005
428,월산마을,33.47317,126.46305,5668,343,6011,5615,335,5950,제주특별자치도 제주시 노형동 3278-16,제주시,135,2,126.463255,33.473110000000005
429,월산정수장입구,33.4784,126.46869,3241,367,3608,3186,351,3537,제주특별자치도 제주시 노형동 2267-9,제주시,136,2,126.46880999999999,33.478555
430,월산정수장입구,33.47871,126.46893,2973,384,3357,2925,368,3293,제주특별자치도 제주시 노형동 3766,제주시,136,2,126.46880999999999,33.478555
431,정존마을,33.481320000000004,126.4733,20904,1711,22615,20619,1650,22269,제주특별자치도 제주시 노형동 3815,제주시,137,2,126.47341,33.481565
432,정존마을,33.481809999999996,126.47352,36036,1324,37360,35601,1299,36900,제주특별자치도 제주시 노형동 2617-2,제주시,137,2,126.47341,33.481565
433,노형초등학교,33.48353,126.47596000000001,16264,380,16644,16083,363,16446,제주특별자치도 제주시 노형동 3815,제주시,138,2,126.47587000000001,33.48362
434,노형초등학교,33.483709999999995,126.47578,8522,141,8663,8424,137,8561,제주특별자치도 제주시 노형동 2617-3,제주시,138,2,126.47587000000001,33.48362
435,노형오거리,33.485209999999995,126.47796000000001,14696,456,15152,14447,443,14890,제주특별자치도 제주시 노형동 1297-4,제주시,613,4,126.47796000000001,33.485209999999995
436,고성1리사무소,33.45805,126.41264,772,11,783,769,10,779,제주특별자치도 제주시 애월읍 고성리 1241-9,제주시,139,2,126.41275,33.457945
437,고성1리사무소,33.457840000000004,126.41286000000001,259,150,409,242,147,389,제주특별자치도 제주시 애월읍 고성리 1241-4,제주시,139,2,126.41275,33.457945
438,고성1리종합운동장,33.45845,126.41516999999999,1122,153,1275,1095,152,1247,제주특별자치도 제주시 애월읍 고성리 1556,제주시,140,2,126.41539,33.458439999999996
439,고성1리종합운동장,33.45843,126.41561000000002,3289,259,3548,3186,253,3439,제주특별자치도 제주시 애월읍 고성리 443,제주시,140,2,126.41539,33.458439999999996
440,광령3리,33.45893,126.42388000000001,219,10,229,217,10,227,제주특별자치도 제주시 애월읍 광령리 3945-7,제주시,22,1,126.4479757142857,33.47316
441,광령3리,33.45875,126.42445,599,18,617,588,18,606,제주특별자치도 제주시 애월읍 광령리 3944-1,제주시,22,1,126.4479757142857,33.47316
442,으뜸마을,33.4791,126.48035,99,3,102,99,3,102,제주특별자치도 제주시 노형동 787,제주시,141,2,126.480345,33.479020000000006
443,제주한라대학교,33.47833,126.47511999999999,45798,1305,47103,44979,1252,46231,제주특별자치도 제주시 노형동 1518-1,제주시,23,1,126.48255285714285,33.48248285714286
444,탐라도서관,33.47756,126.47741,1655,39,1694,1628,39,1667,제주특별자치도 제주시 노형동 3812-2,제주시,142,2,126.47749999999999,33.47755
445,제주한라대학교,33.47808,126.47516,16207,261,16468,15968,252,16220,제주특별자치도 제주시 노형동 1518-1,제주시,23,1,126.48255285714285,33.48248285714286
446,시티주유소,33.4764,126.47976000000001,4879,75,4954,4819,74,4893,제주특별자치도 제주시 노형동 765,제주시,614,4,126.47976000000001,33.4764
447,제주고등학교/중흥S클래스,33.476259999999996,126.48141000000001,73928,1616,75544,72743,1524,74267,제주특별자치도 제주시 노형동 765,제주시,143,2,126.481775,33.476325
448,중흥S클래스아파트,33.47639,126.48213999999999,7902,282,8184,7784,272,8056,제주특별자치도 제주시 노형동 765,제주시,143,2,126.481775,33.476325
449,부영아파트,33.4769,126.48313,17334,354,17688,17092,346,17438,제주특별자치도 제주시 노형동 768,제주시,615,4,126.48313,33.4769
450,으뜸마을,33.477990000000005,126.48253000000001,4628,238,4866,4565,224,4789,제주특별자치도 제주시 노형동 768,제주시,25,1,126.55256857142857,33.50196285714286
451,대학동,33.51305,126.50667,11287,240,11527,11194,232,11426,제주특별자치도 제주시 용담이동 592-4,제주시,14,3,126.50241000000001,33.50123142857143
452,대학동,33.513000000000005,126.5076,4349,104,4453,4313,98,4411,제주특별자치도 제주시 용담이동 594-1,제주시,14,3,126.50241000000001,33.50123142857143
453,사대부고,33.512570000000004,126.50997,9480,460,9940,9249,444,9693,제주특별자치도 제주시 용담이동 599-8,제주시,24,1,126.512225,33.50131125
454,사대부고,33.51279,126.50945,6922,312,7234,6785,297,7082,제주특별자치도 제주시 용담삼동 581-12,제주시,24,1,126.512225,33.50131125
455,광령초등학교,33.4607,126.43643999999999,957,17,974,932,17,949,제주특별자치도 제주시 애월읍 광령리 1345-1,제주시,144,2,126.436295,33.460615000000004
456,광령초등학교,33.46053,126.43615,3222,26,3248,3189,25,3214,제주특별자치도 제주시 애월읍 광령리 1227-1,제주시,144,2,126.436295,33.460615000000004
457,광령1리사무소,33.46099,126.43976,920,10,930,912,10,922,제주특별자치도 제주시 애월읍 광령리 4227,제주시,145,2,126.439825,33.460935
458,광령1리사무소,33.460879999999996,126.43988999999999,4580,46,4626,4528,44,4572,제주특별자치도 제주시 애월읍 광령리 1276-2,제주시,145,2,126.439825,33.460935
459,제일빌리지,33.46083,126.44483999999999,1330,40,1370,1326,40,1366,제주특별자치도 제주시 애월읍 광령리 30-3,제주시,146,2,126.44483999999999,33.460755000000006
460,제일빌리지,33.46068,126.44483999999999,5191,30,5221,5139,28,5167,제주특별자치도 제주시 애월읍 광령리 29-4,제주시,146,2,126.44483999999999,33.460755000000006
461,무수천,33.461059999999996,126.44859,5374,261,5635,5305,251,5556,제주특별자치도 제주시 해안동 2382-4,제주시,147,2,126.44863,33.461214999999996
462,무수천,33.46137,126.44866999999999,2161,94,2255,2142,90,2232,제주특별자치도 제주시 해안동 2382-3,제주시,147,2,126.44863,33.461214999999996
463,해안동입구,33.462759999999996,126.45115,2930,172,3102,2892,167,3059,제주특별자치도 제주시 해안동 2350-4,제주시,77,3,126.50119,33.48135499999999
464,제주고등학교,33.47221,126.48438999999999,265,45,310,261,43,304,제주특별자치도 제주시 노형동 607-1,제주시,58,3,126.44750285714285,33.48175428571429
465,제주고등학교,33.47433,126.48392,7845,417,8262,7630,397,8027,제주특별자치도 제주시 노형동 768,제주시,58,3,126.44750285714285,33.48175428571429
466,화북남문,33.51858,126.56598000000001,27984,253,28237,27715,245,27960,제주특별자치도 제주시 화북일동 2034-7,제주시,78,3,126.559105,33.5105825
467,제주동중학교,33.52001,126.5723,41759,341,42100,41385,327,41712,제주특별자치도 제주시 화북일동 1235-5,제주시,11,1,126.58891571428572,33.522305714285714
468,제주동중학교,33.51958,126.57078,46685,942,47627,46214,916,47130,제주특별자치도 제주시 화북일동 1239-11,제주시,616,4,126.57078,33.51958
469,원동,33.39925,126.37917,338,66,404,330,63,393,제주특별자치도 제주시 애월읍 상가리 10-3,제주시,148,2,126.37917,33.39993
470,원동,33.40061,126.37917,125,36,161,122,35,157,제주특별자치도 제주시 애월읍 상가리 4-4,제주시,148,2,126.37917,33.39993
471,운전면허시험장,33.40595,126.38644,5635,201,5836,5523,193,5716,제주특별자치도 제주시 애월읍 소길리 산 210-14,제주시,149,2,126.38632,33.4062
472,운전면허시험장,33.40645,126.3862,3717,243,3960,3650,231,3881,제주특별자치도 제주시 애월읍 소길리 산 195-12,제주시,149,2,126.38632,33.4062
473,유수암상동,33.42269,126.40879,2773,187,2960,2731,178,2909,제주특별자치도 제주시 애월읍 유수암리 1082-1,제주시,54,3,126.51919875,33.456756250000005
474,유수암상동,33.42299000000001,126.40795,829,128,957,815,126,941,제주특별자치도 제주시 애월읍 유수암리 1028-3,제주시,54,3,126.51919875,33.456756250000005
475,한화아파트,33.47902,126.48308,1861,63,1924,1824,62,1886,제주특별자치도 제주시 노형동 767,제주시,25,1,126.55256857142857,33.50196285714286
476,한라중학교/부영아파트,33.47887,126.48383000000001,19611,235,19846,19375,231,19606,제주특별자치도 제주시 노형동 767,제주시,25,1,126.55256857142857,33.50196285714286
477,한라초등학교,33.479,126.48629,1172,31,1203,1158,29,1187,제주특별자치도 제주시 노형동 767,제주시,617,4,126.48629,33.479
478,대림2차아파트,33.479,126.488,1984,52,2036,1964,51,2015,제주특별자치도 제주시 연동 1399-1,제주시,150,2,126.488175,33.478925000000004
479,대림2차아파트,33.47885,126.48835,15312,271,15583,15148,265,15413,제주특별자치도 제주시 연동 1546,제주시,150,2,126.488175,33.478925000000004
480,연동대림1차아파트,33.48028,126.48975,4702,381,5083,4612,364,4976,제주특별자치도 제주시 연동 1546,제주시,151,2,126.48984,33.48049
481,연동대림1차아파트,33.4807,126.48993,29278,694,29972,29048,671,29719,제주특별자치도 제주시 연동 1546,제주시,151,2,126.48984,33.48049
482,신제주오피스텔,33.4832,126.48996000000001,3220,451,3671,3187,424,3611,제주특별자치도 제주시 연동 334,제주시,152,2,126.48984,33.48325
483,신제주오피스텔,33.4833,126.48971999999999,1242,126,1368,1215,122,1337,제주특별자치도 제주시 연동 268-5,제주시,152,2,126.48984,33.48325
484,신사수동,33.50874,126.47751000000001,554,130,684,537,124,661,제주특별자치도 제주시 도두이동 1667-12,제주시,153,2,126.47732,33.508775
485,신사수동,33.50881,126.47713,244,54,298,232,49,281,제주특별자치도 제주시 도두이동 1669-4,제주시,153,2,126.47732,33.508775
486,해안로,33.50932,126.47231000000001,403,200,603,388,193,581,제주특별자치도 제주시 도두일동 1734,제주시,154,2,126.47236000000001,33.509265
487,해안로,33.509209999999996,126.47241000000001,1209,583,1792,1153,564,1717,제주특별자치도 제주시 도두일동 1687,제주시,154,2,126.47236000000001,33.509265
488,오래물광장,33.50486,126.46722,4774,521,5295,4711,507,5218,제주특별자치도 제주시 도두일동 2605-7,제주시,155,2,126.46719999999999,33.504935
489,오래물광장,33.50501,126.46718,743,143,886,715,140,855,제주특별자치도 제주시 도두일동 2605-5,제주시,155,2,126.46719999999999,33.504935
490,도두동,33.50258,126.46656000000002,2171,228,2399,2135,217,2352,제주특별자치도 제주시 도두일동 2510-2,제주시,156,2,126.46638000000002,33.502725
491,도리초등학교,33.50117,126.46618000000001,4833,445,5278,4745,423,5168,제주특별자치도 제주시 이호일동 304-1,제주시,157,2,126.466015,33.50129
492,도리초등학교,33.50141,126.46585,1684,127,1811,1658,120,1778,제주특별자치도 제주시 이호일동 1961,제주시,157,2,126.466015,33.50129
494,해안,33.45857,126.45433999999999,877,11,888,871,11,882,제주특별자치도 제주시 해안동 1970-1,제주시,618,4,126.45433999999999,33.45857
496,해안동입구,33.463159999999995,126.45299999999999,13408,180,13588,13225,175,13400,제주특별자치도 제주시 해안동 2793-1,제주시,77,3,126.50119,33.48135499999999
497,제주아트리움,33.46559,126.45606000000001,500,86,586,489,82,571,제주특별자치도 제주시 해안동 2793,제주시,158,2,126.456445,33.46586
498,제주아트리움,33.46613,126.45683000000001,1049,54,1103,1024,53,1077,제주특별자치도 제주시 해안동 2170-4,제주시,158,2,126.456445,33.46586
499,제주제일고등학교,33.48055,126.48156999999999,5297,148,5445,5192,138,5330,제주특별자치도 제주시 노형동 768,제주시,159,2,126.48176999999998,33.480315000000004
500,제주제일고등학교,33.48008,126.48196999999999,13322,121,13443,13193,119,13312,제주특별자치도 제주시 노형동 768,제주시,159,2,126.48176999999998,33.480315000000004
501,한라수목원,33.469840000000005,126.48491000000001,18317,3205,21522,17749,3009,20758,제주특별자치도 제주시 노형동 103-4,제주시,160,2,126.484825,33.469875
502,하귀반석,33.47768,126.40798999999998,146,1,147,145,1,146,제주특별자치도 제주시 애월읍 상귀리 354-1,제주시,161,2,126.407925,33.477615
503,히귀반석,33.47755,126.40786000000001,382,1,383,380,1,381,제주특별자치도 제주시 애월읍 하귀2리 1286-1,제주시,161,2,126.407925,33.477615
504,광석동,33.47464,126.40903999999999,267,4,271,267,4,271,제주특별자치도 제주시 애월읍 상귀리 283-3,제주시,162,2,126.40896000000001,33.474545
505,광석동,33.47445,126.40888000000001,340,5,345,337,5,342,제주특별자치도 제주시 애월읍 상귀리 382-1,제주시,162,2,126.40896000000001,33.474545
506,상귀리,33.472,126.40919,500,5,505,495,5,500,제주특별자치도 제주시 애월읍 상귀리 106-2,제주시,163,2,126.40915000000001,33.47201
507,상귀리,33.47202,126.40911000000001,593,20,613,589,19,608,제주특별자치도 제주시 애월읍 상귀리 538-3,제주시,163,2,126.40915000000001,33.47201
508,소앵동입구,33.46945,126.40829,247,2,249,247,2,249,제주특별자치도 제주시 애월읍 상귀리 556-1,제주시,164,2,126.408195,33.46936
509,소앵동입구,33.46927,126.4081,152,5,157,151,5,156,제주특별자치도 제주시 애월읍 상귀리 567-2,제주시,164,2,126.408195,33.46936
510,보로미마을,33.46545,126.40911000000001,2254,11,2265,2220,11,2231,제주특별자치도 제주시 애월읍 상귀리 679-3,제주시,165,2,126.40923500000001,33.46545
511,보로미마을,33.46545,126.40936,2228,3,2231,2205,3,2208,제주특별자치도 제주시 애월읍 고성리 1579,제주시,165,2,126.40923500000001,33.46545
512,평화로광령1리입구,33.4558,126.44179,395,45,440,385,44,429,제주특별자치도 제주시 애월읍 광령리 103-1,제주시,69,3,126.49114,33.488147500000004
513,평화로광령1리입구,33.455659999999995,126.44278999999999,5081,105,5186,4970,98,5068,제주특별자치도 제주시 애월읍 광령리 108-4,제주시,69,3,126.49114,33.488147500000004
514,해병대아파트입구,33.48045,126.4971,57,5,62,57,5,62,제주특별자치도 제주시 연동 524-6,제주시,166,2,126.49719999999999,33.480405
515,해병대아파트입구,33.48036,126.4973,241,12,253,238,12,250,제주특별자치도 제주시 연동 524-5,제주시,166,2,126.49719999999999,33.480405
516,월정사,33.46778,126.51052,819,5,824,768,5,773,제주특별자치도 제주시 오라이동 664-9,제주시,619,4,126.51052,33.46778
518,정실마을,33.46918,126.50971000000001,1017,8,1025,1015,8,1023,제주특별자치도 제주시 오라이동 696-18,제주시,167,2,126.50969,33.4694
519,정실,33.46962,126.50967,2087,23,2110,2064,23,2087,제주특별자치도 제주시 오라이동 707-4,제주시,167,2,126.50969,33.4694
520,오름가름,33.47165,126.50787,371,1,372,369,1,370,제주특별자치도 제주시 오라이동 744-2,제주시,168,2,126.508015,33.47167
521,오름가름,33.47169,126.50816,1414,19,1433,1407,18,1425,제주특별자치도 제주시 오라이동 739-3,제주시,168,2,126.508015,33.47167
522,새가름,33.47325,126.50413999999999,733,3,736,732,3,735,제주특별자치도 제주시 오라이동 3295-3,제주시,169,2,126.504055,33.47336
523,새가름,33.47347,126.50397,1764,11,1775,1756,11,1767,제주특별자치도 제주시 오라이동 3295-1,제주시,169,2,126.504055,33.47336
524,예비군훈련장,33.47517,126.50166999999999,173,3,176,171,3,174,제주특별자치도 제주시 연동 584-2,제주시,170,2,126.501685,33.47526
525,예비군훈련장,33.47535,126.5017,361,10,371,360,10,370,제주특별자치도 제주시 연동 2477-36,제주시,170,2,126.501685,33.47526
526,대원오등동입구,33.47762,126.54291,29,1,30,28,1,29,제주특별자치도 제주시 아라일동 2999,제주시,171,2,126.54262,33.47748
528,대원마을,33.4765,126.5345,875,6,881,873,6,879,제주특별자치도 제주시 아라일동 2738-9,제주시,172,2,126.53461999999999,33.476470000000006
529,대원마을,33.476440000000004,126.53473999999999,3490,30,3520,3386,30,3416,제주특별자치도 제주시 아라일동 2745-5,제주시,172,2,126.53461999999999,33.476470000000006
530,장구마을,33.47637,126.53248,179,1,180,179,1,180,제주특별자치도 제주시 아라일동 2905-5,제주시,173,2,126.532255,33.475840000000005
531,장구마을,33.47531,126.53203,428,5,433,422,5,427,제주특별자치도 제주시 아라일동 2894-4,제주시,173,2,126.532255,33.475840000000005
532,오등동,33.47527,126.5298,300,3,303,299,3,302,제주특별자치도 제주시 오등동 604-2,제주시,174,2,126.529605,33.475205
533,오등동,33.47514,126.52941000000001,1027,6,1033,1023,6,1029,제주특별자치도 제주시 오등동 619-5,제주시,174,2,126.529605,33.475205
534,오봉교,33.474740000000004,126.52627,476,15,491,468,15,483,제주특별자치도 제주시 오등동 1377-15,제주시,175,2,126.52631500000001,33.4747
535,오봉교,33.47466,126.52636000000001,1909,27,1936,1883,27,1910,제주특별자치도 제주시 오등동 1366-3,제주시,175,2,126.52631500000001,33.4747
536,진평연립입구,33.47055,126.5222,604,1,605,545,1,546,제주특별자치도 제주시 오등동 1555-3,제주시,176,2,126.522265,33.47054
537,진평연립입구,33.47053,126.52233000000001,1458,2,1460,1431,2,1433,제주특별자치도 제주시 오등동 1899,제주시,176,2,126.522265,33.47054
538,GM빌라,33.46673,126.52078999999999,810,3,813,792,3,795,제주특별자치도 제주시 오등동 1678-1,제주시,177,2,126.52080000000001,33.46668
539,GM빌라,33.46663,126.52081000000001,1330,9,1339,1317,9,1326,제주특별자치도 제주시 오등동 1899,제주시,177,2,126.52080000000001,33.46668
540,온난화대응농업연구소,33.466879999999996,126.51863,1073,8,1081,1068,8,1076,제주특별자치도 제주시 오등동 1899,제주시,26,1,126.56073375000001,33.4921825
541,온난화대응농업연구소,33.46676,126.51928999999998,2222,6,2228,2152,6,2158,제주특별자치도 제주시 오등동 1720-1,제주시,26,1,126.56073375000001,33.4921825
542,정실오거리,33.467079999999996,126.51448,1114,7,1121,1098,7,1105,제주특별자치도 제주시 오라이동 44-5,제주시,60,1,126.49666142857143,33.48074571428571
543,정실오거리,33.46723,126.51363,958,25,983,953,25,978,제주특별자치도 제주시 오라이동 73-2,제주시,60,1,126.49666142857143,33.48074571428571
544,신성여자중고등학교,33.47808,126.56175,2039,1,2040,1991,1,1992,제주특별자치도 제주시 영평동 2407-2,제주시,178,2,126.56156999999999,33.478089999999995
545,신성여자중고등학교,33.4781,126.56138999999999,12718,28,12746,12364,28,12392,제주특별자치도 제주시 영평동 2408-2,제주시,178,2,126.56156999999999,33.478089999999995
546,제주교통방송아라아이파크,33.47763,126.54936000000001,138,6,144,136,5,141,제주특별자치도 제주시 아라일동 884-2,제주시,179,2,126.54933500000001,33.477729999999994
547,제주교통방송아라아이파크,33.47783,126.54931,8413,68,8481,8346,64,8410,제주특별자치도 제주시 아라이동 914-7,제주시,179,2,126.54933500000001,33.477729999999994
548,아라초등학교,33.47748,126.5447,5262,71,5333,5190,68,5258,제주특별자치도 제주시 아라이동 1574-2,제주시,5,1,126.52680249999999,33.47999624999999
549,영평상동마을회관,33.476659999999995,126.56822,1594,13,1607,1556,13,1569,제주특별자치도 제주시 영평동 1878-10,제주시,180,2,126.56823,33.476725
550,영평상동마을회관,33.47679,126.56823999999999,7431,39,7470,7331,39,7370,제주특별자치도 제주시 영평동 1878-15,제주시,180,2,126.56823,33.476725
551,영평동,33.47931,126.56325,11196,19,11215,10890,19,10909,제주특별자치도 제주시 영평동 2444-5,제주시,181,2,126.56328,33.479585
553,제주관광대학,33.44742,126.4352,9344,427,9771,9224,414,9638,제주특별자치도 제주시 애월읍 광령리 2613-6,제주시,182,2,126.43551500000001,33.447810000000004
554,제주관광대학,33.447309999999995,126.43653,15252,560,15812,14934,545,15479,제주특별자치도 제주시 애월읍 광령리 4227,제주시,620,4,126.43653,33.447309999999995
555,월평마을,33.46976,126.57518999999999,5954,77,6031,5888,75,5963,제주특별자치도 제주시 월평동 1039-1,제주시,183,2,126.57529,33.469719999999995
557,제주중앙고등학교,33.47162,126.57158000000001,15377,25,15402,14968,25,14993,제주특별자치도 제주시 월평동 1141-2,제주시,621,4,126.57158000000001,33.47162
558,반석아파트,33.48795,126.59026999999999,446,4,450,437,4,441,제주특별자치도 제주시 봉개동 2374-2,제주시,622,4,126.59026999999999,33.48795
563,용강동,33.47929,126.58611,341,3,344,340,3,343,제주특별자치도 제주시 용강동 1777,제주시,184,2,126.58614,33.478854999999996
565,용강동퐁낭밭,33.47133,126.58424,715,1,716,715,1,716,제주특별자치도 제주시 용강동 1184-2,제주시,623,4,126.58424,33.47133
567,시각장애인복지관,33.47072,126.58068,1642,5,1647,1629,5,1634,제주특별자치도 제주시 월평동 419-4,제주시,624,4,126.58068,33.47072
569,황사평,33.49457,126.56367,1305,6,1311,1298,5,1303,제주특별자치도 제주시 화북이동 5756,제주시,625,4,126.56367,33.49457
571,반석주택,33.48207,126.57108999999998,1668,4,1672,1634,4,1638,제주특별자치도 제주시 영평동 791-3,제주시,626,4,126.57108999999998,33.48207
573,월광로,33.4932,126.47537,74,12,86,71,9,80,제주특별자치도 제주시 노형동 1137,제주시,35,2,126.58674142857141,33.49185714285714
574,월광로,33.48833,126.4692,468,3,471,467,3,470,제주특별자치도 제주시 노형동 2572,제주시,627,4,126.4692,33.48833
576,광평,33.48397,126.46808,7743,177,7920,7683,171,7854,제주특별자치도 제주시 노형동 2431-5,제주시,185,2,126.468245,33.48393
577,광평,33.48389,126.46841,3877,119,3996,3815,112,3927,제주특별자치도 제주시 노형동 2598-5,제주시,185,2,126.468245,33.48393
578,광평동로노형성당,33.48207,126.47041999999999,3864,128,3992,3826,119,3945,제주특별자치도 제주시 노형동 2598-5,제주시,186,2,126.4704,33.482185
579,광평동로,33.4823,126.47038,3933,230,4163,3860,226,4086,제주특별자치도 제주시 노형동 2598-5,제주시,186,2,126.4704,33.482185
580,오광로,33.48525,126.461,109,3,112,108,3,111,제주특별자치도 제주시 노형동 3740-3,제주시,187,2,126.46078499999999,33.485455
581,오광로,33.485659999999996,126.46056999999999,432,23,455,430,22,452,제주특별자치도 제주시 노형동 3744-1,제주시,187,2,126.46078499999999,33.485455
582,오도마을,33.4909,126.45767,443,6,449,438,6,444,제주특별자치도 제주시 이호이동 1023-7,제주시,188,2,126.45751999999999,33.490985
583,오도마을,33.49107,126.45737,2535,37,2572,2523,36,2559,제주특별자치도 제주시 이호이동 1380-2,제주시,188,2,126.45751999999999,33.490985
585,갈왓,33.49366,126.45589,1162,253,1415,1111,247,1358,제주특별자치도 제주시 이호이동 1553-2,제주시,628,4,126.45589,33.49366
586,오라오거리,33.500029999999995,126.50465,8545,2080,10625,8411,2022,10433,제주특별자치도 제주시 용담이동 2756-5,제주시,629,4,126.50465,33.500029999999995
588,우당도서관,33.51231,126.54815,6193,491,6684,6087,475,6562,제주특별자치도 제주시 건입동 602-18,제주시,630,4,126.54815,33.51231
589,큰동네,33.48923,126.59697,21126,450,21576,20908,428,21336,제주특별자치도 제주시 봉개동 1878-1,제주시,189,2,126.596625,33.489360000000005
590,큰동네,33.48949,126.59628000000001,6903,239,7142,6838,231,7069,제주특별자치도 제주시 봉개동 1883-1,제주시,189,2,126.596625,33.489360000000005
591,원노형,33.48467,126.47993000000001,13952,610,14562,13762,571,14333,제주특별자치도 제주시 노형동 3816,제주시,4,2,126.57949375000001,33.455851249999995
592,화북초등학교,33.5177,126.56241000000001,3090,366,3456,3011,362,3373,제주특별자치도 제주시 화북일동 3806-3,제주시,134,2,126.562065,33.51766
593,매촌,33.517959999999995,126.58856000000002,2056,6,2062,2030,6,2036,제주특별자치도 제주시 도련이동 522-10,제주시,190,2,126.58864500000001,33.51792
594,매촌,33.51788,126.58873,2471,51,2522,2444,50,2494,제주특별자치도 제주시 도련이동 522-3,제주시,190,2,126.58864500000001,33.51792
595,연동입구,33.49625,126.49701,6373,839,7212,6317,820,7137,제주특별자치도 제주시 연동 115-4,제주시,191,2,126.49687499999999,33.496215
596,원노형,33.48345,126.48076,26575,867,27442,26206,828,27034,제주특별자치도 제주시 노형동 948,제주시,631,4,126.48076,33.48345
597,금천마을,33.47864000000001,126.55343,6552,47,6599,6500,47,6547,제주특별자치도 제주시 아라이동 943-4,제주시,192,2,126.55345500000001,33.478565
598,금천마을,33.47849,126.55348000000001,3523,7,3530,3476,7,3483,제주특별자치도 제주시 아라이동 943-4,제주시,192,2,126.55345500000001,33.478565
600,은혜마을종점,33.46522,126.615,214,10,224,213,10,223,제주특별자치도 제주시 봉개동 227-66,제주시,632,4,126.615,33.46522
601,동회천,33.504129999999996,126.61536000000001,1355,16,1371,1345,16,1361,제주특별자치도 제주시 회천동 1284,제주시,633,4,126.61536000000001,33.504129999999996
602,삼양종점,33.52843,126.59147,346,29,375,342,28,370,제주특별자치도 제주시 삼양일동 1588-1,제주시,193,2,126.59139,33.528475
603,삼양종점,33.52852,126.59131000000001,8204,186,8390,8117,182,8299,제주특별자치도 제주시 삼양일동 1583-13,제주시,193,2,126.59139,33.528475
604,삼양1동,33.52763,126.59,10067,155,10222,9983,151,10134,제주특별자치도 제주시 삼양일동 1581-29,제주시,634,4,126.59,33.52763
605,삼양해수욕장입구,33.52618,126.58786,4871,300,5171,4743,282,5025,제주특별자치도 제주시 삼양일동 1669-1,제주시,635,4,126.58786,33.52618
606,해오름아파트,33.4818,126.48638000000001,7383,82,7465,7323,78,7401,제주특별자치도 제주시 노형동 767,제주시,636,4,126.48638000000001,33.4818
608,영평하동,33.486940000000004,126.57332,1964,6,1970,1960,6,1966,제주특별자치도 제주시 영평동 927-2,제주시,194,2,126.573235,33.486895000000004
609,영평하동,33.48685,126.57315,273,1,274,268,1,269,제주특별자치도 제주시 영평동 2795,제주시,194,2,126.573235,33.486895000000004
610,함덕5구,33.534259999999996,126.67596,1823,33,1856,1796,32,1828,제주특별자치도 제주시 조천읍 함덕리 72-5,제주시,7,1,126.49200428571427,33.494951428571426
612,청화마을입구,33.456140000000005,126.43012,32,2,34,32,2,34,제주특별자치도 제주시 애월읍 광령리 3313-2,제주시,195,2,126.430175,33.45611
613,광령3리사무소,33.46387,126.42336,1485,11,1496,1478,10,1488,제주특별자치도 제주시 애월읍 광령리 3798-7,제주시,637,4,126.42336,33.46387
619,성지요양원,33.48342,126.43761,412,15,427,407,12,419,제주특별자치도 제주시 외도일동 127-6,제주시,34,3,126.291986,33.375851
620,다호마을,33.50458,126.49625,8902,823,9725,8694,784,9478,제주특별자치도 제주시 용담이동 1596-12,제주시,196,2,126.49636000000001,33.504594999999995
621,제주국제공항입구,33.50461,126.49647,724,221,945,688,216,904,제주특별자치도 제주시 용담이동 1588-5,제주시,196,2,126.49636000000001,33.504594999999995
622,백록초등학교,33.485409999999995,126.47151000000001,6407,39,6446,6354,38,6392,제주특별자치도 제주시 노형동 2598-3,제주시,23,3,126.48255285714285,33.48248285714286
623,백록초등학교,33.48458,126.47065,16296,230,16526,16128,218,16346,제주특별자치도 제주시 노형동 2511-2,제주시,23,3,126.48255285714285,33.48248285714286
624,큰구릉내,33.48707,126.41543,4313,220,4533,4269,212,4481,제주특별자치도 제주시 애월읍 하귀1리 562,제주시,27,1,126.40820142857142,33.47559285714285
625,한국방송통신대학,33.48672,126.47341000000002,157,4,161,154,4,158,제주특별자치도 제주시 노형동 2615-4,제주시,197,2,126.473735,33.487085
626,정든마을,33.48745,126.47406000000001,7729,44,7773,7658,43,7701,제주특별자치도 제주시 노형동 2598-2,제주시,197,2,126.473735,33.487085
627,몰래물,33.510490000000004,126.48218,233,32,265,230,32,262,제주특별자치도 제주시 도두이동 701,제주시,133,2,126.482505,33.5105
628,한라수목원,33.46991,126.48473999999999,1654,250,1904,1627,246,1873,제주특별자치도 제주시 노형동 103-4,제주시,160,2,126.484825,33.469875
629,연동입구,33.496179999999995,126.49673999999999,2912,596,3508,2845,576,3421,제주특별자치도 제주시 연동 115-4,제주시,191,2,126.49687499999999,33.496215
631,공항초소,33.51362,126.48435,192,135,327,186,132,318,제주특별자치도 제주시 용담삼동 2580-55,제주시,198,2,126.48446,33.5136
632,성지요양원,33.48274,126.43866000000001,338,2,340,332,2,334,제주특별자치도 제주시 외도일동 107-1,제주시,34,3,126.291986,33.375851
633,도평마을입구,33.479929999999996,126.45088,1826,27,1853,1807,27,1834,제주특별자치도 제주시 도평동 814-3,제주시,199,2,126.45107,33.48003
634,도평동,33.480129999999996,126.45126,1365,17,1382,1342,17,1359,제주특별자치도 제주시 도평동 779,제주시,199,2,126.45107,33.48003
635,공항초소,33.51358,126.48456999999999,711,483,1194,687,466,1153,제주특별자치도 제주시 용담삼동 1286-5,제주시,198,2,126.48446,33.5136
637,월성마을,33.50419,126.50338,12809,2050,14859,12464,1976,14440,제주특별자치도 제주시 용담이동 750-12,제주시,638,4,126.50338,33.50419
638,제주국제공항(구제주방면),33.506609999999995,126.49345,91226,55164,146390,89598,52635,142233,제주특별자치도 제주시 용담이동 1462-1,제주시,28,1,126.48837428571427,33.499021428571425
639,대동마을,33.494609999999994,126.46378999999999,1095,66,1161,1070,58,1128,제주특별자치도 제주시 이호이동 209-4,제주시,200,2,126.46378999999999,33.49453
640,대동마을,33.49445,126.46378999999999,5098,128,5226,5049,124,5173,제주특별자치도 제주시 이호이동 201-12,제주시,200,2,126.46378999999999,33.49453
641,외도부영1차아파트,33.48675,126.43083,11453,19,11472,11309,19,11328,제주특별자치도 제주시 외도일동 646-1,제주시,22,2,126.4479757142857,33.47316
643,거로복지회관,33.508340000000004,126.56113,671,1,672,655,1,656,제주특별자치도 제주시 화북이동 3378-4,제주시,639,4,126.56113,33.508340000000004
644,거로입구,33.50496,126.56238,85,3,88,85,3,88,제주특별자치도 제주시 화북이동 3283-6,제주시,14,1,126.50241000000001,33.50123142857143
645,용강마을,33.4757,126.58553,684,1,685,682,1,683,제주특별자치도 제주시 용강동 1257-2,제주시,201,2,126.58545000000001,33.475685
646,용강동,33.47567,126.58537,396,2,398,396,2,398,제주특별자치도 제주시 용강동 1316,제주시,201,2,126.58545000000001,33.475685
647,용강동대합실,33.47842,126.58617,652,8,660,652,8,660,제주특별자치도 제주시 용강동 1777,제주시,184,2,126.58614,33.478854999999996
649,봉개남문,33.49042,126.59063,396,5,401,395,5,400,제주특별자치도 제주시 봉개동 2482-4,제주시,640,4,126.59063,33.49042
651,봉개동,33.49151,126.59245,7594,233,7827,7534,221,7755,제주특별자치도 제주시 봉개동 1945-2,제주시,18,1,126.57508249999998,33.493767500000004
652,봉개동,33.49154,126.59275,21122,330,21452,20658,320,20978,제주특별자치도 제주시 봉개동 1812-9,제주시,18,1,126.57508249999998,33.493767500000004
659,우당도서관입구,33.51262,126.54517,379,11,390,373,11,384,제주특별자치도 제주시 건입동 607-3,제주시,94,2,126.54476,33.51278
662,월평마을,33.46968,126.57538999999998,3362,23,3385,3286,23,3309,제주특별자치도 제주시 월평동 1038-3,제주시,183,2,126.57529,33.469719999999995
663,전원유치원,33.48724,126.53966000000001,591,3,594,589,3,592,제주특별자치도 제주시 아라일동 2470-4,제주시,641,4,126.53966000000001,33.48724
665,선덕어린이집,33.48101,126.51248000000001,1417,9,1426,1410,9,1419,제주특별자치도 제주시 오라이동 1618-2,제주시,642,4,126.51248000000001,33.48101
666,사평마을입구,33.48134,126.51127,1520,12,1532,1513,12,1525,제주특별자치도 제주시 오라이동 1770-3,제주시,643,4,126.51127,33.48134
667,민오름,33.48142,126.50168000000001,4967,53,5020,4925,50,4975,제주특별자치도 제주시 오라이동 3161-2,제주시,22,3,126.4479757142857,33.47316
668,민오름,33.481759999999994,126.50046999999999,3927,65,3992,3816,61,3877,제주특별자치도 제주시 연동 440-2,제주시,22,3,126.4479757142857,33.47316
670,이도2동행정복지센터,33.4965,126.5364,2337,19,2356,2309,19,2328,제주특별자치도 제주시 이도이동 1085-4,제주시,56,3,126.64144142857143,33.49493857142857
671,경제통상진흥원,33.498870000000004,126.54047,2250,13,2263,2220,11,2231,제주특별자치도 제주시 이도이동 444,제주시,202,2,126.540385,33.498975
672,한라일보,33.49857,126.51966000000002,1219,22,1241,1210,18,1228,제주특별자치도 제주시 삼도일동 568-1,제주시,203,2,126.519765,33.498585000000006
673,게이트볼장,33.49475,126.51963,1182,11,1193,1180,11,1191,제주특별자치도 제주시 오라일동 1076-1,제주시,204,2,126.51975,33.494835
674,게이트볼장,33.49492,126.51987,1171,16,1187,1156,13,1169,제주특별자치도 제주시 오라일동 1076-1,제주시,204,2,126.51975,33.494835
675,한라일보,33.4986,126.51987,501,39,540,496,39,535,제주특별자치도 제주시 삼도일동 585-26,제주시,203,2,126.519765,33.498585000000006
676,경제통상진흥원,33.49908,126.5403,4967,98,5065,4917,95,5012,제주특별자치도 제주시 이도이동 444,제주시,202,2,126.540385,33.498975
677,이도2동행정복지센터,33.496109999999994,126.53546000000001,2001,89,2090,1988,84,2072,제주특별자치도 제주시 이도이동 1085-4,제주시,56,3,126.64144142857143,33.49493857142857
678,서부경찰서,33.47293,126.40666999999999,164,3,167,163,3,166,제주특별자치도 제주시 애월읍 상귀리 419-6,제주시,205,2,126.40669499999998,33.472854999999996
679,서부경찰서,33.47278,126.40671999999999,1216,12,1228,1213,11,1224,제주특별자치도 제주시 애월읍 상귀리 419-6,제주시,205,2,126.40669499999998,33.472854999999996
680,주르레마을,33.45039000000001,126.48651000000001,1014,157,1171,965,155,1120,제주특별자치도 제주시 노형동 291-20,제주시,206,2,126.48638,33.45003500000001
681,주르레마을,33.44968,126.48625,43,24,67,43,22,65,제주특별자치도 제주시 노형동 3762-4,제주시,206,2,126.48638,33.45003500000001
682,하귀2리,33.47878,126.39974,1205,73,1278,1193,70,1263,제주특별자치도 제주시 애월읍 하귀2리 1931-3,제주시,207,2,126.39963,33.47876
683,하귀2리,33.47874,126.39952,138,6,144,134,6,140,제주특별자치도 제주시 애월읍 하귀2리 1956-6,제주시,207,2,126.39963,33.47876
684,귀일중학교,33.48121,126.40512,1835,138,1973,1784,137,1921,제주특별자치도 제주시 애월읍 하귀2리 1384-16,제주시,1,1,126.4019414285714,33.479899999999994
688,신제주초등학교,33.48505,126.49632,8265,187,8452,8169,186,8355,제주특별자치도 제주시 연동 304,제주시,95,2,126.4964,33.484674999999996
690,광령2리입구,33.459509999999995,126.43123,10,4,14,10,4,14,제주특별자치도 제주시 애월읍 광령리 2287-2,제주시,644,4,126.43123,33.459509999999995
691,원노형,33.48598,126.48355,5649,1414,7063,5475,1292,6767,제주특별자치도 제주시 노형동 949,제주시,208,2,126.48337,33.486075
692,메종글래드제주,33.485859999999995,126.48743999999999,5797,1135,6932,5630,1049,6679,제주특별자치도 제주시 연동 253-1,제주시,209,2,126.48716999999999,33.485969999999995
693,봉개워터파크,33.4864,126.60146999999999,327,96,423,321,96,417,제주특별자치도 제주시 봉개동 1336-4,제주시,645,4,126.60146999999999,33.4864
694,6호광장,33.511070000000004,126.5486,1716,614,2330,1682,602,2284,제주특별자치도 제주시 건입동 602-22,제주시,210,2,126.548915,33.511030000000005
695,6호광장,33.51099,126.54923000000001,21,4,25,21,4,25,제주특별자치도 제주시 화북이동 4870-2,제주시,210,2,126.548915,33.511030000000005
696,제주대학교입구,33.45673,126.55105,11866,1731,13597,11642,1640,13282,제주특별자치도 제주시 아라일동 426-10,제주시,29,1,126.53580285714285,33.4833
698,당동,33.46856,126.3841,212,1,213,211,1,212,제주특별자치도 제주시 애월읍 수산리 1778-2,제주시,646,4,126.3841,33.46856
700,하귀하나로마트,33.4848,126.41106,12399,187,12586,12296,175,12471,제주특별자치도 제주시 애월읍 하귀1리 549-16,제주시,2,1,126.40150375000002,33.478381250000005
702,금악리,33.35743,126.29466000000001,115,16,131,114,15,129,제주특별자치도 제주시 한림읍 금악리 1896-7,제주시,41,1,126.41387999999999,33.42416142857142
703,평대,33.528690000000005,126.83915,24,22,46,24,22,46,제주특별자치도 제주시 구좌읍 평대리 1716-6,제주시,30,1,126.64079625,33.50402750000001
707,만장굴입구,33.54918,126.77826999999999,60,6,66,60,6,66,제주특별자치도 제주시 구좌읍 월정리 1841-3,제주시,211,2,126.77858499999999,33.549414999999996
708,선인동,33.48527,126.69963,130,15,145,130,15,145,제주특별자치도 제주시 조천읍 선흘리 3980-1,제주시,31,1,126.57869714285714,33.49127857142857
709,승준농원,33.44838,126.40645,18,6,24,18,6,24,제주특별자치도 제주시 애월읍 유수암리 502-5,제주시,212,2,126.406335,33.448415
710,승준농원,33.44845,126.40621999999999,5,11,16,5,10,15,제주특별자치도 제주시 애월읍 유수암리 503-1,제주시,212,2,126.406335,33.448415
711,항몽유적지,33.452329999999996,126.40825,86,39,125,82,39,121,제주특별자치도 제주시 애월읍 상귀리 1012,제주시,213,2,126.40841999999999,33.45238
712,항몽유적지,33.45243,126.40858999999999,56,68,124,56,67,123,제주특별자치도 제주시 애월읍 상귀리 1010-2,제주시,213,2,126.40841999999999,33.45238
713,예원동민회관앞,33.45898,126.39941,126,1,127,126,1,127,제주특별자치도 제주시 애월읍 수산리 34-1,제주시,647,4,126.39941,33.45898
716,소길리사무소,33.43995,126.37975,347,31,378,344,27,371,제주특별자치도 제주시 애월읍 소길리 627-2,제주시,648,4,126.37975,33.43995
717,소길리,33.44121,126.37913999999999,511,10,521,511,10,521,제주특별자치도 제주시 애월읍 장전리 1638-2,제주시,649,4,126.37913999999999,33.44121
718,유수암상동경로당,33.422940000000004,126.40505,163,18,181,154,17,171,제주특별자치도 제주시 애월읍 유수암리 1060-10,제주시,214,2,126.405325,33.423185000000004
719,유수암리사무소,33.44143,126.40328999999998,598,16,614,596,15,611,제주특별자치도 제주시 애월읍 유수암리 3234,제주시,215,2,126.40321999999999,33.441415
721,유수암천,33.44313,126.40012,83,2,85,83,2,85,제주특별자치도 제주시 애월읍 유수암리 1978-1,제주시,650,4,126.40012,33.44313
723,용흥리상동,33.45592,126.37002,395,2,397,393,2,395,제주특별자치도 제주시 애월읍 신엄리 1873-14,제주시,651,4,126.37002,33.45592
728,명월하동,33.39607,126.26078999999999,185,26,211,182,26,208,제주특별자치도 제주시 한림읍 명월리 2087-5,제주시,19,3,126.41712714285715,33.471355714285714
729,명월리,33.38705,126.26647,729,41,770,721,40,761,제주특별자치도 제주시 한림읍 명월리 1767-1,제주시,216,2,126.26648,33.3869
730,명월리,33.38942,126.26597,5,7,12,5,7,12,제주특별자치도 제주시 한림읍 명월리 2227,제주시,217,2,126.26604,33.389655000000005
731,명월리,33.38989,126.26611000000001,142,53,195,138,53,191,제주특별자치도 제주시 한림읍 명월리 2223,제주시,217,2,126.26604,33.389655000000005
732,남문동,33.39655,126.26348999999999,311,9,320,310,9,319,제주특별자치도 제주시 한림읍 동명리 2216-1,제주시,218,2,126.26343,33.39657
733,명월하동,33.39659,126.26337,18,9,27,17,9,26,제주특별자치도 제주시 한림읍 명월리 2237,제주시,218,2,126.26343,33.39657
736,명월하동,33.397259999999996,126.25981000000002,25,4,29,25,4,29,제주특별자치도 제주시 한림읍 옹포리 983,제주시,19,3,126.41712714285715,33.471355714285714
737,한림고등학교,33.39918,126.25841000000001,523,55,578,512,55,567,제주특별자치도 제주시 한림읍 옹포리 983,제주시,219,2,126.25849,33.399164999999996
738,한림고등학교,33.39915,126.25856999999999,3103,547,3650,2911,505,3416,제주특별자치도 제주시 한림읍 옹포리 819-3,제주시,219,2,126.25849,33.399164999999996
745,알진오름입구,33.47691,126.78413,25,3,28,24,3,27,제주특별자치도 제주시 구좌읍 송당리 895-1,제주시,220,2,126.78415,33.477075
746,알진오름입구,33.47724,126.78416999999999,50,16,66,49,16,65,제주특별자치도 제주시 구좌읍 송당리 895-2,제주시,220,2,126.78415,33.477075
747,비자림,33.493179999999995,126.81034,1265,1850,3115,1213,1778,2991,제주특별자치도 제주시 구좌읍 평대리 3344,제주시,221,2,126.810385,33.49326
748,비자림,33.49334,126.81043000000001,1599,917,2516,1560,903,2463,제주특별자치도 제주시 구좌읍 평대리 3187,제주시,221,2,126.810385,33.49326
749,조수리,33.33576,126.22831000000001,547,46,593,542,46,588,제주특별자치도 제주시 한경면 조수리 315,제주시,222,2,126.228555,33.33577
750,조수1리,33.33783,126.2279,14,4,18,14,4,18,제주특별자치도 제주시 한경면 조수리 437-10,제주시,223,2,126.22794999999999,33.337815
751,제주서부신협,33.32703,126.25301999999999,78,10,88,77,6,83,제주특별자치도 제주시 한경면 저지리 1521-21,제주시,32,1,126.4152257142857,33.42904285714286
752,조수1리중동,33.33415,126.22673999999999,158,4,162,156,4,160,제주특별자치도 제주시 한경면 조수리 1455-2,제주시,224,2,126.22686999999999,33.334175
753,한원리,33.334,126.20038000000001,1,5,6,1,5,6,제주특별자치도 제주시 한경면 두모리 1360-4,제주시,225,2,126.2004,33.334050000000005
754,한원리,33.3341,126.20042,105,3,108,105,3,108,제주특별자치도 제주시 한경면 두모리 731-1,제주시,225,2,126.2004,33.334050000000005
755,한경면사무소,33.34993,126.18388,396,22,418,394,20,414,제주특별자치도 제주시 한경면 신창리 252-3,제주시,33,1,126.30488375000002,33.38845875
757,신창상동,33.3482,126.18753000000001,19,2,21,19,2,21,제주특별자치도 제주시 한경면 신창리 1481,제주시,652,4,126.18753000000001,33.3482
760,한원리,33.33553,126.19715,377,6,383,374,6,380,제주특별자치도 제주시 한경면 두모리 1453-4,제주시,226,2,126.19691499999999,33.336015
761,낙천리,33.32597,126.22701,290,22,312,287,21,308,제주특별자치도 제주시 한경면 낙천리 1972,제주시,227,2,126.22708500000002,33.326015
762,조수1리,33.33578,126.2288,206,40,246,204,37,241,제주특별자치도 제주시 한경면 조수리 317-7,제주시,222,2,126.228555,33.33577
764,조수1리,33.33628,126.23243000000001,239,4,243,237,4,241,제주특별자치도 제주시 한경면 조수리 326-13,제주시,228,2,126.2326,33.336355
765,조수1리,33.33643,126.23277,182,2,184,182,2,184,제주특별자치도 제주시 한경면 조수리 4146,제주시,228,2,126.2326,33.336355
766,저지리수동,33.33682,126.23623,11,1,12,11,1,12,제주특별자치도 제주시 한경면 저지리 1215-2,제주시,229,2,126.23624000000001,33.33686
767,저지리수동,33.3369,126.23625,33,4,37,32,4,36,제주특별자치도 제주시 한경면 저지리 1215-4,제주시,229,2,126.23624000000001,33.33686
769,저지리수동,33.33745,126.23879,135,27,162,134,27,161,제주특별자치도 제주시 한경면 저지리 1313-1,제주시,653,4,126.23879,33.33745
770,평화동,33.309509999999996,126.25943000000001,121,14,135,121,14,135,제주특별자치도 제주시 한경면 청수리 3389,제주시,654,4,126.25943000000001,33.309509999999996
772,청수리,33.306909999999995,126.25842,34,10,44,33,10,43,제주특별자치도 제주시 한경면 청수리 188-2,제주시,230,2,126.25837,33.30687999999999
773,청수리,33.30685,126.25832,65,3,68,65,3,68,제주특별자치도 제주시 한경면 청수리 154-2,제주시,230,2,126.25837,33.30687999999999
775,산양곶자왈,33.2908,126.2508,46,10,56,46,10,56,제주특별자치도 제주시 한경면 청수리 955-2,제주시,231,2,126.25082499999999,33.29076
777,산양리,33.29575,126.23398,303,7,310,303,6,309,제주특별자치도 제주시 한경면 낙천리 810-2,제주시,655,4,126.23398,33.29575
778,조수2리웃동네,33.29677,126.21996999999999,86,4,90,86,4,90,제주특별자치도 제주시 한경면 조수리 3771-1,제주시,232,2,126.21978999999999,33.296814999999995
779,조수2리윗동네,33.296859999999995,126.21961,147,6,153,147,6,153,제주특별자치도 제주시 한경면 조수리 3739-12,제주시,232,2,126.21978999999999,33.296814999999995
780,조수2리,33.29585,126.21763,41,4,45,41,3,44,제주특별자치도 제주시 한경면 조수리 4007-6,제주시,61,3,126.53408285714285,33.43949428571429
782,조수2리,33.29397,126.2145,69,4,73,69,4,73,제주특별자치도 제주시 한경면 조수리 3959-2,제주시,61,3,126.53408285714285,33.43949428571429
785,칠전동,33.29773,126.19465,31,1,32,31,1,32,제주특별자치도 제주시 한경면 고산리 1717-4,제주시,656,4,126.19465,33.29773
786,고산환승정류장(고산1리),33.30073,126.18043999999999,5297,302,5599,5217,292,5509,제주특별자치도 제주시 한경면 고산리 2919-8,제주시,34,1,126.291986,33.375851
787,한장동,33.2904,126.16763,78,5,83,78,5,83,제주특별자치도 제주시 한경면 고산리 3822-2,제주시,233,2,126.167575,33.29041
788,한장동,33.290420000000005,126.16752,31,19,50,30,18,48,제주특별자치도 제주시 한경면 고산리 3817-4,제주시,233,2,126.167575,33.29041
793,구시장터,33.435179999999995,126.32503,547,8,555,546,8,554,제주특별자치도 제주시 애월읍 납읍리 2384-12,제주시,657,4,126.32503,33.435179999999995
794,구몰리동,33.42473,126.31562,786,12,798,782,11,793,제주특별자치도 제주시 애월읍 봉성리 3408-4,제주시,234,2,126.31557999999998,33.42476
795,금능석물원,33.385909999999996,126.22633,2860,586,3446,2780,563,3343,제주특별자치도 제주시 한림읍 금능리 1282-4,제주시,235,2,126.226305,33.38597
796,조수1리,33.3378,126.228,345,62,407,340,61,401,제주특별자치도 제주시 한경면 조수리 437-13,제주시,223,2,126.22794999999999,33.337815
797,조수1리중동,33.3342,126.227,40,13,53,40,13,53,제주특별자치도 제주시 한경면 조수리 1477-5,제주시,224,2,126.22686999999999,33.334175
798,낙천리,33.32606,126.22716000000001,224,11,235,222,11,233,제주특별자치도 제주시 한경면 낙천리 1973-3,제주시,227,2,126.22708500000002,33.326015
800,복호동입구,33.3365,126.19668,622,9,631,581,9,590,제주특별자치도 제주시 한경면 두모리 3023,제주시,226,2,126.19691499999999,33.336015
801,신창리농산물종합유통센터,33.34664,126.19091999999999,213,18,231,211,18,229,제주특별자치도 제주시 한경면 신창리 1481,제주시,658,4,126.19091999999999,33.34664
802,한경면사무소,33.34985,126.18373000000001,966,33,999,952,31,983,제주특별자치도 제주시 한경면 신창리 256,제주시,33,1,126.30488375000002,33.38845875
803,목선동,33.48999,126.71828000000001,251,26,277,249,25,274,제주특별자치도 제주시 조천읍 선흘리 337-49,제주시,35,1,126.58674142857141,33.49185714285714
804,산남내,33.471059999999994,126.77588,167,23,190,166,22,188,제주특별자치도 제주시 구좌읍 송당리 1572-11,제주시,36,1,126.68651375,33.4751675
805,송당초등학교,33.471779999999995,126.77986999999999,673,181,854,650,177,827,제주특별자치도 제주시 구좌읍 송당리 1271-1,제주시,236,2,126.77955,33.47181
806,신선동,33.51222,126.69925,302,13,315,301,13,314,제주특별자치도 제주시 조천읍 선흘리 2503-1,제주시,237,2,126.698975,33.512249999999995
809,어음2리사무소,33.40122,126.33663,756,14,770,747,14,761,제주특별자치도 제주시 애월읍 어음리 3010-1,제주시,659,4,126.33663,33.40122
815,부면동,33.41603,126.33267,437,13,450,435,12,447,제주특별자치도 제주시 애월읍 어음리 3627-2,제주시,660,4,126.33267,33.41603
822,동명리,33.4098,126.26568999999999,2454,187,2641,2415,182,2597,제주특별자치도 제주시 한림읍 동명리 1591-16,제주시,238,2,126.26587,33.40952
823,한림2리,33.409240000000004,126.26605,5227,257,5484,5152,250,5402,제주특별자치도 제주시 한림읍 동명리 2251,제주시,238,2,126.26587,33.40952
824,한림발전소,33.4017,126.27083999999999,15,2,17,15,2,17,제주특별자치도 제주시 한림읍 동명리 666-2,제주시,239,2,126.27107999999998,33.401655
825,한림발전소,33.40161,126.27131999999999,23,1,24,23,1,24,제주특별자치도 제주시 한림읍 동명리 656-1,제주시,239,2,126.27107999999998,33.401655
827,한천동,33.39465,126.2746,88,2,90,88,2,90,제주특별자치도 제주시 한림읍 동명리 820-1,제주시,661,4,126.2746,33.39465
830,송당상동,33.467209999999994,126.77311999999999,135,10,145,135,9,144,제주특별자치도 제주시 구좌읍 송당리 1579-5,제주시,240,2,126.77294499999999,33.466795
831,송당상동,33.46638,126.77277,171,28,199,170,27,197,제주특별자치도 제주시 구좌읍 송당리 1882-2,제주시,240,2,126.77294499999999,33.466795
832,만장굴,33.53098,126.77188000000001,10,13,23,9,12,21,제주특별자치도 제주시 구좌읍 월정리 산 37,제주시,662,4,126.77188000000001,33.53098
835,혜정원아가의집,33.51625,126.67783999999999,397,14,411,397,11,408,제주특별자치도 제주시 조천읍 함덕리 52-5,제주시,663,4,126.67783999999999,33.51625
839,선인동,33.48583,126.69973,248,40,288,243,37,280,제주특별자치도 제주시 조천읍 선흘리 2092-1,제주시,31,1,126.57869714285714,33.49127857142857
840,선인동,33.4859,126.69963,379,58,437,371,53,424,제주특별자치도 제주시 조천읍 선흘리 2092-1,제주시,31,1,126.57869714285714,33.49127857142857
841,양잠단지,33.4588,126.70291999999999,99,14,113,99,14,113,제주특별자치도 제주시 조천읍 선흘리 1944-21,제주시,241,2,126.70306500000001,33.458164999999994
842,선흘2리,33.45835,126.71153000000001,70,17,87,70,17,87,제주특별자치도 제주시 조천읍 선흘리 469-6,제주시,242,2,126.711615,33.45843
843,선흘2리,33.45851,126.7117,369,70,439,367,68,435,제주특별자치도 제주시 조천읍 선흘리 470-2,제주시,242,2,126.711615,33.45843
845,대흘2리,33.51155,126.67299999999999,242,10,252,242,10,252,제주특별자치도 제주시 조천읍 대흘리 2787,제주시,243,2,126.67309,33.511624999999995
846,대흘2리,33.5117,126.67318,1,2,3,1,2,3,제주특별자치도 제주시 조천읍 대흘리 120-3,제주시,243,2,126.67309,33.511624999999995
847,대흘2리,33.51267,126.67643000000001,382,71,453,380,71,451,제주특별자치도 제주시 조천읍 대흘리 산 6-5,제주시,244,2,126.67644000000001,33.512775
848,대흘2리새동네,33.512879999999996,126.67645,228,11,239,228,11,239,제주특별자치도 제주시 조천읍 대흘리 산 6-5,제주시,244,2,126.67644000000001,33.512775
857,금붕사,33.50075,126.8908,18,1,19,17,1,18,제주특별자치도 제주시 구좌읍 종달리 1659-44,제주시,245,2,126.89065500000001,33.500704999999996
858,동복리휴게소,33.5535,126.70765,906,248,1154,877,232,1109,제주특별자치도 제주시 구좌읍 동복리 1759,제주시,246,2,126.70765,33.553415
859,동성동,33.55577,126.75453,2325,554,2879,2265,529,2794,제주특별자치도 제주시 구좌읍 김녕리 1206-4,제주시,247,2,126.75453,33.5557
860,구좌보건소,33.51992,126.85982,171,22,193,166,21,187,제주특별자치도 제주시 구좌읍 세화리 1361,제주시,37,1,126.77774749999999,33.52082
861,종달리,33.49495,126.89617,592,232,824,573,227,800,제주특별자치도 제주시 구좌읍 종달리 4982,제주시,248,2,126.89619,33.495035
862,하도리서문동,33.51983,126.87131000000001,293,36,329,291,36,327,제주특별자치도 제주시 구좌읍 하도리 3281-4,제주시,249,2,126.87132,33.519925
863,세화환승정류장(세화리),33.523379999999996,126.85556000000001,9802,1714,11516,9608,1649,11257,제주특별자치도 제주시 구좌읍 세화리 1421-15,제주시,37,3,126.77774749999999,33.52082
865,용당리,33.3346,126.182,1170,21,1191,1156,21,1177,제주특별자치도 제주시 한경면 용수리 1025,제주시,250,2,126.181885,33.333945
866,용수리충혼묘지,33.320859999999996,126.17811999999999,266,85,351,264,75,339,제주특별자치도 제주시 한경면 용수리 4719-1,제주시,251,2,126.17832999999999,33.320935
867,신흥동,33.34061,126.18206,267,16,283,267,15,282,제주특별자치도 제주시 한경면 용수리 1242-6,제주시,252,2,126.18222,33.34062
868,구한경의원앞,33.34385,126.18241,337,58,395,324,58,382,제주특별자치도 제주시 한경면 신창리 660-4,제주시,253,2,126.182545,33.34396
869,신창중학교,33.34737,126.18271000000001,427,32,459,417,31,448,제주특별자치도 제주시 한경면 신창리 492-1,제주시,254,2,126.18275,33.34748999999999
870,판포리상동,33.36768,126.20419,129,73,202,123,72,195,제주특별자치도 제주시 한경면 판포리 3182,제주시,255,2,126.20435,33.367665
871,곽지모물,33.45319,126.30875,34,22,56,32,22,54,제주특별자치도 제주시 애월읍 곽지리 1549-4,제주시,2,3,126.40150375000002,33.478381250000005
872,자운당,33.4676,126.3568,575,167,742,558,156,714,제주특별자치도 제주시 애월읍 신엄리 3064-4,제주시,47,1,126.44603000000001,33.468295000000005
873,금붕사,33.500659999999996,126.89051,64,21,85,59,20,79,제주특별자치도 제주시 구좌읍 종달리 1659-45,제주시,245,2,126.89065500000001,33.500704999999996
874,제일교동문시장입구,33.51235,126.53175,4394,228,4622,4370,225,4595,제주특별자치도 제주시 일도이동 1050-1,제주시,16,1,126.51379375,33.50224
875,신산로,33.507909999999995,126.53375,2300,333,2633,2265,324,2589,제주특별자치도 제주시 일도이동 823-3,제주시,256,2,126.533905,33.507925
876,문예회관,33.50495,126.53568999999999,903,54,957,891,54,945,제주특별자치도 제주시 일도이동 852,제주시,257,2,126.53566,33.505215
877,용당리,33.333290000000005,126.18177,396,18,414,386,18,404,제주특별자치도 제주시 한경면 용수리 4719-1,제주시,250,2,126.181885,33.333945
878,신창환승정류장(한경면사무소),33.35053,126.18333999999999,2329,154,2483,2271,149,2420,제주특별자치도 제주시 한경면 두모리 3023-8,제주시,33,1,126.30488375000002,33.38845875
879,남조로검문소,33.46887,126.65976,109,92,201,103,86,189,제주특별자치도 제주시 조천읍 와흘리 산 12-9,제주시,12,3,126.55788625000001,33.49230625
881,대흘초등학교,33.49902,126.65745,150,1,151,145,1,146,제주특별자치도 제주시 조천읍 대흘리 1655-4,제주시,664,4,126.65745,33.49902
882,대흘리,33.49822,126.65906000000001,70,11,81,66,11,77,제주특별자치도 제주시 조천읍 대흘리 1602-3,제주시,38,1,126.54743142857144,33.496007142857145
883,대흘리,33.49827,126.65895,177,7,184,158,6,164,제주특별자치도 제주시 조천읍 대흘리 1649-1,제주시,38,1,126.54743142857144,33.496007142857145
884,제일농장앞,33.49438,126.6638,22,3,25,20,3,23,제주특별자치도 제주시 조천읍 대흘리 1047-3,제주시,258,2,126.66403,33.494344999999996
885,제일농장앞,33.49431,126.66426000000001,232,8,240,224,8,232,제주특별자치도 제주시 조천읍 대흘리 1029-2,제주시,258,2,126.66403,33.494344999999996
886,제일농장,33.49305,126.66832,140,12,152,137,12,149,제주특별자치도 제주시 조천읍 대흘리 1075-12,제주시,259,2,126.66834499999999,33.492935
888,와산리,33.49192,126.6801,80,10,90,79,8,87,제주특별자치도 제주시 조천읍 와산리 1077-3,제주시,665,4,126.6801,33.49192
889,와산리,33.49152,126.6822,965,35,1000,960,32,992,제주특별자치도 제주시 조천읍 와산리 966-4,제주시,260,2,126.68223,33.491405
890,목선동,33.4897,126.71815,58,7,65,58,7,65,제주특별자치도 제주시 조천읍 선흘리 338-3,제주시,35,1,126.58674142857141,33.49185714285714
891,선흘목선동,33.48944,126.71838999999999,69,36,105,65,35,100,제주특별자치도 제주시 조천읍 선흘리 338-2,제주시,35,1,126.58674142857141,33.49185714285714
892,상덕천,33.4837,126.74663000000001,145,8,153,143,8,151,제주특별자치도 제주시 구좌읍 덕천리 1188,제주시,261,2,126.746775,33.48368
893,상덕천마을입구,33.48366,126.74691999999999,109,13,122,108,11,119,제주특별자치도 제주시 구좌읍 덕천리 1230-2,제주시,261,2,126.746775,33.48368
894,상덕천리,33.48108,126.75143999999999,55,7,62,55,6,61,제주특별자치도 제주시 구좌읍 덕천리 1316-10,제주시,262,2,126.75148999999999,33.481135
895,상덕천리,33.481190000000005,126.75153999999999,65,6,71,65,5,70,제주특별자치도 제주시 구좌읍 덕천리 1289-2,제주시,262,2,126.75148999999999,33.481135
896,웃송당,33.47129,126.77146,205,7,212,205,7,212,제주특별자치도 제주시 구좌읍 송당리 2791,제주시,263,2,126.77158,33.471155
897,웃송당,33.47102,126.7717,192,6,198,188,6,194,제주특별자치도 제주시 구좌읍 송당리 1655-1,제주시,263,2,126.77158,33.471155
898,산남내,33.47094,126.77588999999999,445,17,462,442,17,459,제주특별자치도 제주시 구좌읍 송당리 1572-13,제주시,36,1,126.68651375,33.4751675
899,송당초등학교,33.47184,126.77923,678,73,751,670,73,743,제주특별자치도 제주시 구좌읍 송당리 1272-1,제주시,236,2,126.77955,33.47181
900,송당로타리,33.47157,126.78397,2430,794,3224,2382,783,3165,제주특별자치도 제주시 구좌읍 송당리 1375-2,제주시,264,2,126.784075,33.471585000000005
901,송당로타리,33.4716,126.78418,2386,931,3317,2311,876,3187,제주특별자치도 제주시 구좌읍 송당리 1379-12,제주시,264,2,126.784075,33.471585000000005
902,산양리,33.29368,126.23326000000002,132,18,150,131,18,149,제주특별자치도 제주시 한경면 청수리 3259-8,제주시,39,1,126.32776000000001,33.39511
903,산양리,33.293820000000004,126.23347,24,1,25,24,1,25,제주특별자치도 제주시 한경면 청수리 3331-5,제주시,39,1,126.32776000000001,33.39511
904,수룡동,33.30833,126.23871000000001,275,2,277,273,2,275,제주특별자치도 제주시 한경면 낙천리 462-6,제주시,265,2,126.23862000000001,33.308279999999996
905,수룡동,33.30823,126.23853000000001,283,2,285,283,2,285,제주특별자치도 제주시 한경면 낙천리 452-10,제주시,265,2,126.23862000000001,33.308279999999996
906,청수리,33.32114,126.24456,593,25,618,588,17,605,제주특별자치도 제주시 한경면 청수리 1638-2,제주시,40,1,126.36481875,33.41299125
907,청수리,33.32121,126.24446,132,11,143,131,8,139,제주특별자치도 제주시 한경면 청수리 1639-2,제주시,40,1,126.36481875,33.41299125
909,저청중학교,33.32582,126.2521,38,1,39,38,1,39,제주특별자치도 제주시 한경면 청수리 416-2,제주시,666,4,126.2521,33.32582
910,상명,33.36007,126.26975,377,2,379,376,2,378,제주특별자치도 제주시 한림읍 상명리 1599-3,제주시,266,2,126.2699,33.360150000000004
911,상명리,33.36023,126.27005,55,4,59,55,3,58,제주특별자치도 제주시 한림읍 상명리 2361,제주시,266,2,126.2699,33.360150000000004
914,조성동입구,33.35773,126.2737,12,2,14,11,2,13,제주특별자치도 제주시 한림읍 상명리 1026-2,제주시,267,2,126.27406500000001,33.357569999999996
915,상명리,33.357409999999994,126.27443000000001,499,7,506,494,7,501,제주특별자치도 제주시 한림읍 상명리 1025-1,제주시,267,2,126.27406500000001,33.357569999999996
916,월림리,33.35492,126.26172,3,3,6,3,3,6,제주특별자치도 제주시 한림읍 상명리 2138-2,제주시,53,3,126.58769124999998,33.44820375
919,예향원,33.35304,126.25927,163,1,164,162,1,163,제주특별자치도 제주시 한림읍 월림리 2361,제주시,667,4,126.25927,33.35304
920,월림삼거리,33.349909999999994,126.25606,70,3,73,69,3,72,제주특별자치도 제주시 한림읍 월림리 285-4,제주시,268,2,126.25613000000001,33.349965
921,월림삼거리,33.35002,126.2562,950,24,974,941,23,964,제주특별자치도 제주시 한림읍 월림리 2350-3,제주시,268,2,126.25613000000001,33.349965
923,월림리,33.34618,126.25583,28,1,29,28,1,29,제주특별자치도 제주시 한림읍 월림리 464-4,제주시,53,3,126.58769124999998,33.44820375
924,저지리성전동,33.3413,126.25698,219,2,221,218,2,220,제주특별자치도 제주시 한경면 저지리 산 13-7,제주시,668,4,126.25698,33.3413
926,저지리,33.33497,126.25655,70,12,82,70,10,80,제주특별자치도 제주시 한경면 저지리 1798-2,제주시,269,2,126.256795,33.335134999999994
927,저지오름,33.3335,126.25638000000001,269,47,316,264,41,305,제주특별자치도 제주시 한경면 저지리 1844-4,제주시,270,2,126.25643000000001,33.333455
928,저지오름,33.33341,126.25648000000001,411,80,491,402,80,482,제주특별자치도 제주시 한경면 저지리 1790-2,제주시,270,2,126.25643000000001,33.333455
929,저지남동,33.3301,126.25515,95,19,114,93,19,112,제주특별자치도 제주시 한경면 저지리 1711-8,제주시,271,2,126.25519,33.330055
930,저지리,33.330009999999994,126.25523000000001,207,16,223,205,16,221,제주특별자치도 제주시 한경면 저지리 1711-7,제주시,271,2,126.25519,33.330055
931,제주서부신협,33.327420000000004,126.25352,398,17,415,391,17,408,제주특별자치도 제주시 한경면 저지리 1505-1,제주시,32,1,126.4152257142857,33.42904285714286
932,명리동,33.31926,126.26783999999999,41,12,53,40,12,52,제주특별자치도 제주시 한경면 저지리 3022-7,제주시,272,2,126.267935,33.319295
933,명리동,33.31933,126.26803000000001,270,7,277,270,6,276,제주특별자치도 제주시 한경면 저지리 3258,제주시,272,2,126.267935,33.319295
934,명리동,33.31773,126.26978000000001,270,24,294,270,23,293,제주특별자치도 제주시 한경면 저지리 3007-2,제주시,273,2,126.26977500000001,33.317655
935,명리동,33.31758,126.26977,40,23,63,40,23,63,제주특별자치도 제주시 한경면 저지리 3258,제주시,273,2,126.26977500000001,33.317655
936,이시돌삼거리,33.34467,126.31671000000001,133,36,169,128,34,162,제주특별자치도 제주시 한림읍 금악리 411-1,제주시,274,2,126.31683000000001,33.344685
937,금악리,33.35763,126.29491999999999,1343,52,1395,1338,51,1389,제주특별자치도 제주시 한림읍 금악리 2117,제주시,41,1,126.41387999999999,33.42416142857142
938,금악초등학교,33.35719,126.29571000000001,524,19,543,522,19,541,제주특별자치도 제주시 한림읍 금악리 1898-2,제주시,41,1,126.41387999999999,33.42416142857142
941,금악,33.361999999999995,126.2928,182,2,184,182,2,184,제주특별자치도 제주시 한림읍 금악리 2204-10,제주시,669,4,126.2928,33.361999999999995
943,금악리,33.36658,126.28713,25,2,27,25,1,26,제주특별자치도 제주시 한림읍 금악리 2850-8,제주시,670,4,126.28713,33.36658
946,고림동,33.37415,126.28476,42,2,44,41,2,43,제주특별자치도 제주시 한림읍 명월리 417-12,제주시,671,4,126.28476,33.37415
948,문수동,33.38559,126.28357,345,3,348,345,3,348,제주특별자치도 제주시 한림읍 동명리 175-1,제주시,672,4,126.28357,33.38559
964,미듬아파트,33.41875,126.26873,363,16,379,362,15,377,제주특별자치도 제주시 한림읍 대림리 1853-4,제주시,275,2,126.26878,33.418725
965,미듬아파트,33.4187,126.26883000000001,2734,24,2758,2703,23,2726,제주특별자치도 제주시 한림읍 대림리 1771-5,제주시,275,2,126.26878,33.418725
966,한림오일시장,33.42051,126.27277,1086,21,1107,1072,20,1092,제주특별자치도 제주시 한림읍 대림리 1718-3,제주시,276,2,126.27318,33.420655
967,한림오일시장,33.4208,126.27358999999998,1647,12,1659,1635,11,1646,제주특별자치도 제주시 한림읍 대림리 1714,제주시,276,2,126.27318,33.420655
968,대림사거리,33.42216,126.27776000000001,597,29,626,595,29,624,제주특별자치도 제주시 한림읍 대림리 444-2,제주시,13,3,126.43331250000001,33.481816249999994
969,대림사거리,33.42218,126.27881000000001,222,16,238,221,16,237,제주특별자치도 제주시 한림읍 대림리 1413-4,제주시,13,3,126.43331250000001,33.481816249999994
970,대림리사무소,33.42252,126.28062,333,12,345,330,12,342,제주특별자치도 제주시 한림읍 대림리 766-6,제주시,277,2,126.281045,33.422574999999995
971,대림리사무소,33.42263,126.28147,234,3,237,233,2,235,제주특별자치도 제주시 한림읍 대림리 763-7,제주시,277,2,126.281045,33.422574999999995
972,대림입전동,33.42218,126.28336000000002,173,2,175,170,1,171,제주특별자치도 제주시 한림읍 대림리 752-2,제주시,278,2,126.28344000000001,33.42209
973,대림입전동,33.422,126.28352,337,9,346,336,8,344,제주특별자치도 제주시 한림읍 대림리 752-9,제주시,278,2,126.28344000000001,33.42209
974,귀덕3리,33.4182,126.29202,365,2,367,363,2,365,제주특별자치도 제주시 한림읍 귀덕리 2147-4,제주시,279,2,126.29216,33.418099999999995
975,귀덕3리,33.418,126.2923,248,3,251,240,3,243,제주특별자치도 제주시 한림읍 귀덕리 2217-3,제주시,279,2,126.29216,33.418099999999995
976,귀덕3리,33.418929999999996,126.29618,665,19,684,659,19,678,제주특별자치도 제주시 한림읍 귀덕리 2074-9,제주시,280,2,126.29619,33.41897
977,귀덕3리,33.41901,126.2962,638,23,661,636,23,659,제주특별자치도 제주시 한림읍 귀덕리 2074-1,제주시,280,2,126.29619,33.41897
979,도림사,33.41823,126.30245,127,3,130,126,3,129,제주특별자치도 제주시 애월읍 봉성리 3946-8,제주시,673,4,126.30245,33.41823
980,봉성리서성동,33.41721,126.31071999999999,466,15,481,465,15,480,제주특별자치도 제주시 애월읍 봉성리 4097-5,제주시,281,2,126.31071999999999,33.417294999999996
981,봉성리서성동,33.41738,126.31071999999999,538,11,549,537,11,548,제주특별자치도 제주시 애월읍 봉성리 4106-2,제주시,281,2,126.31071999999999,33.417294999999996
982,봉성하나로마트,33.4189,126.31245,2188,26,2214,2154,21,2175,제주특별자치도 제주시 애월읍 봉성리 4123-3,제주시,42,1,126.44627714285716,33.456517142857145
983,봉성하나로마트,33.41922,126.31257,3639,63,3702,3600,62,3662,제주특별자치도 제주시 애월읍 봉성리 3820-2,제주시,42,1,126.44627714285716,33.456517142857145
984,구몰리동,33.42479,126.31553999999998,292,4,296,290,2,292,제주특별자치도 제주시 애월읍 봉성리 3408-8,제주시,234,2,126.31557999999998,33.42476
986,납읍리섯잣길,33.43705,126.32758000000001,604,6,610,604,5,609,제주특별자치도 제주시 애월읍 납읍리 2188-3,제주시,282,2,126.32748000000001,33.43689
987,납읍리,33.43891,126.32895,1023,14,1037,1022,12,1034,제주특별자치도 제주시 애월읍 납읍리 1569-14,제주시,283,2,126.329195,33.439175000000006
988,납읍리사무소,33.439440000000005,126.32943999999999,3192,42,3234,3168,41,3209,제주특별자치도 제주시 애월읍 납읍리 1754-3,제주시,283,2,126.329195,33.439175000000006
989,원동입구,33.445009999999996,126.33591000000001,45,5,50,44,5,49,제주특별자치도 제주시 애월읍 납읍리 1891-7,제주시,674,4,126.33591000000001,33.445009999999996
990,상가리서동,33.45013,126.34097,383,22,405,378,22,400,제주특별자치도 제주시 애월읍 상가리 1749-5,제주시,284,2,126.340855,33.4503
991,상가리서동,33.45047,126.34074,225,2,227,223,2,225,제주특별자치도 제주시 애월읍 상가리 1765-5,제주시,284,2,126.340855,33.4503
992,상가리,33.45174,126.34188999999999,626,20,646,620,19,639,제주특별자치도 제주시 애월읍 상가리 1794-9,제주시,675,4,126.34188999999999,33.45174
993,하가입구,33.4523,126.3442,309,43,352,309,41,350,제주특별자치도 제주시 애월읍 하가리 1591-5,제주시,285,2,126.34424,33.452155
994,상가리보건진료소,33.452009999999994,126.34428,1246,77,1323,1241,75,1316,제주특별자치도 제주시 애월읍 상가리 1805-4,제주시,285,2,126.34424,33.452155
995,상가리동동,33.45208,126.34728,840,55,895,836,53,889,제주특별자치도 제주시 애월읍 상가리 1156-4,제주시,286,2,126.34693999999999,33.452095
996,하가리오당빌레,33.453179999999996,126.35085,517,57,574,514,56,570,제주특별자치도 제주시 애월읍 하가리 792-1,제주시,287,2,126.35083499999999,33.453255
997,하가리오당빌레,33.45333,126.35082,199,13,212,197,13,210,제주특별자치도 제주시 애월읍 하가리 848-4,제주시,287,2,126.35083499999999,33.453255
998,존손이굴,33.45217,126.36228999999999,18,3,21,18,3,21,제주특별자치도 제주시 애월읍 하가리 190-4,제주시,288,2,126.36213,33.4523
999,용흥리,33.452059999999996,126.36886000000001,131,5,136,130,5,135,제주특별자치도 제주시 애월읍 신엄리 1951-6,제주시,289,2,126.36922000000001,33.45189
1000,용흥리,33.45172,126.36958,1164,65,1229,1154,63,1217,제주특별자치도 제주시 애월읍 신엄리 3208,제주시,289,2,126.36922000000001,33.45189
1001,흥국사,33.45244,126.3781,56,2,58,55,2,57,제주특별자치도 제주시 애월읍 신엄리 118-1,제주시,290,2,126.37826,33.452535
1002,흥국사,33.45263,126.37841999999999,16,2,18,16,2,18,제주특별자치도 제주시 애월읍 장전리 1382-1,제주시,290,2,126.37826,33.452535
1003,장전알동네,33.4523,126.38545,326,9,335,325,9,334,제주특별자치도 제주시 애월읍 장전리 1174-5,제주시,291,2,126.385535,33.452025
1004,장전알동네,33.45175,126.38561999999999,450,11,461,449,11,460,제주특별자치도 제주시 애월읍 장전리 1123-3,제주시,291,2,126.385535,33.452025
1005,장전리사무소,33.45088,126.38845,3263,53,3316,3222,52,3274,제주특별자치도 제주시 애월읍 장전리 1797,제주시,292,2,126.38833000000001,33.450935
1006,알뱅듸왓,33.450540000000004,126.39052,195,8,203,194,8,202,제주특별자치도 제주시 애월읍 장전리 381-5,제주시,43,1,126.41751714285714,33.46041714285714
1007,알뱅듸왓,33.45035,126.39065,1225,31,1256,1206,31,1237,제주특별자치도 제주시 애월읍 장전리 1797,제주시,43,1,126.41751714285714,33.46041714285714
1008,장전리동가름,33.45264,126.39523,152,6,158,149,6,155,제주특별자치도 제주시 애월읍 장전리 240-4,제주시,293,2,126.395275,33.45259
1009,장전리동가름,33.45254,126.39532,935,23,958,923,23,946,제주특별자치도 제주시 애월읍 장전리 190-11,제주시,293,2,126.395275,33.45259
1010,예원동,33.4561,126.40335,320,9,329,319,9,328,제주특별자치도 제주시 애월읍 상귀리 1100-1,제주시,49,3,126.67595750000001,33.484984999999995
1011,극락사,33.45653,126.40695,106,7,113,106,7,113,제주특별자치도 제주시 애월읍 상귀리 789-8,제주시,294,2,126.40686,33.456435
1012,극락사,33.456340000000004,126.40677,374,23,397,365,20,385,제주특별자치도 제주시 애월읍 상귀리 789-5,제주시,294,2,126.40686,33.456435
1013,세화환승정류장(세화리),33.52325,126.8566,20085,4651,24736,19598,4403,24001,제주특별자치도 제주시 구좌읍 세화리 1465-6,제주시,37,3,126.77774749999999,33.52082
1014,세화리시장2동,33.5236,126.85361,6272,659,6931,6195,628,6823,제주특별자치도 제주시 구좌읍 세화리 1524-5,제주시,295,2,126.85343,33.52355
1015,세화리시장2동,33.5235,126.85325,1969,376,2345,1936,364,2300,제주특별자치도 제주시 구좌읍 세화리 1531-3,제주시,295,2,126.85343,33.52355
1016,하덕천,33.502629999999996,126.77111000000001,101,43,144,101,41,142,제주특별자치도 제주시 구좌읍 덕천리 283-1,제주시,44,1,126.58267,33.47515857142857
1017,덕천리,33.50244,126.77078,551,78,629,546,70,616,제주특별자치도 제주시 구좌읍 덕천리 233,제주시,44,1,126.58267,33.47515857142857
1018,선흘,33.511559999999996,126.70523,169,26,195,167,26,193,제주특별자치도 제주시 조천읍 선흘리 1207-2,제주시,296,2,126.705175,33.51161999999999
1019,선흘1리,33.51168,126.70512,1493,89,1582,1488,85,1573,제주특별자치도 제주시 조천읍 선흘리 4199,제주시,296,2,126.705175,33.51161999999999
1020,신선동,33.51228,126.6987,27,6,33,27,6,33,제주특별자치도 제주시 조천읍 선흘리 2836-2,제주시,237,2,126.698975,33.512249999999995
1021,낙선동,33.51455,126.69341999999999,17,3,20,17,3,20,제주특별자치도 제주시 조천읍 선흘리 3383-2,제주시,297,2,126.693475,33.514610000000005
1022,낙선동,33.51467,126.69353000000001,540,23,563,534,23,557,제주특별자치도 제주시 조천읍 선흘리 3386-1,제주시,297,2,126.693475,33.514610000000005
1025,유수암리,33.42781,126.41093000000001,12,4,16,11,4,15,제주특별자치도 제주시 애월읍 유수암리 3234,제주시,298,2,126.410615,33.427459999999996
1026,교래사거리,33.43335,126.67172,834,253,1087,817,237,1054,제주특별자치도 제주시 조천읍 교래리 산 60-13,제주시,45,1,126.55458375,33.445024999999994
1027,교래사거리,33.43325,126.67178,614,399,1013,582,377,959,제주특별자치도 제주시 조천읍 교래리 산 60-13,제주시,45,1,126.55458375,33.445024999999994
1029,고평동,33.4749,126.65626999999999,81,8,89,81,8,89,제주특별자치도 제주시 조천읍 와흘리 67-1,제주시,676,4,126.65626999999999,33.4749
1030,먼나먼루,33.487759999999994,126.65023000000001,12,3,15,12,3,15,제주특별자치도 제주시 조천읍 와흘리 385-2,제주시,677,4,126.65023000000001,33.487759999999994
1033,대흘1리,33.498459999999994,126.6541,61,20,81,59,20,79,제주특별자치도 제주시 조천읍 대흘리 2296-8,제주시,299,2,126.65401,33.498504999999994
1034,대흘1리,33.49855,126.65392,557,19,576,551,19,570,제주특별자치도 제주시 조천읍 대흘리 2297-3,제주시,299,2,126.65401,33.498504999999994
1035,탐라도뚜리농장,33.502359999999996,126.64238,238,6,244,237,6,243,제주특별자치도 제주시 조천읍 와흘리 2814,제주시,300,2,126.64215,33.502245
1036,탐라도뚜리농장,33.50213,126.64192,19,6,25,19,5,24,제주특별자치도 제주시 조천읍 와흘리 1336-3,제주시,300,2,126.64215,33.502245
1037,와흘리,33.503029999999995,126.63628,1101,13,1114,1095,13,1108,제주특별자치도 제주시 조천읍 와흘리 1260-5,제주시,678,4,126.63628,33.503029999999995
1038,와흘,33.50308,126.63506000000001,111,13,124,109,13,122,제주특별자치도 제주시 조천읍 와흘리 1456-2,제주시,679,4,126.63506000000001,33.50308
1039,새가름마을,33.50482,126.62881999999999,628,4,632,622,4,626,제주특별자치도 제주시 조천읍 와흘리 2601-9,제주시,680,4,126.62881999999999,33.50482
1041,동회천,33.50465,126.61338,993,66,1059,982,64,1046,제주특별자치도 제주시 회천동 2326-1,제주시,301,2,126.613415,33.504599999999996
1042,남조로검문소,33.46968,126.66118,226,97,323,219,95,314,제주특별자치도 제주시 조천읍 대흘리 1235-11,제주시,12,3,126.55788625000001,33.49230625
1043,세미마을,33.470009999999995,126.66362,263,19,282,258,19,277,제주특별자치도 제주시 조천읍 대흘리 1197-33,제주시,36,3,126.68651375,33.4751675
1044,세미마을,33.46985,126.66462,48,14,62,47,13,60,제주특별자치도 제주시 조천읍 대흘리 1197-35,제주시,36,3,126.68651375,33.4751675
1045,대흘교차로,33.46898,126.6764,169,11,180,166,9,175,제주특별자치도 제주시 조천읍 대흘리 1209-2,제주시,15,3,126.53399874999998,33.49357875
1046,대흘교차로,33.46842,126.67971999999999,35,10,45,34,10,44,제주특별자치도 제주시 조천읍 와산리 산 27-1,제주시,15,3,126.53399874999998,33.49357875
1047,선흘2리입구,33.458859999999994,126.70153,638,31,669,629,31,660,제주특별자치도 제주시 조천읍 선흘리 1942-8,제주시,302,2,126.70148,33.458635
1048,선흘2리입구,33.45841,126.70143,71,31,102,70,29,99,제주특별자치도 제주시 조천읍 선흘리 1941-6,제주시,302,2,126.70148,33.458635
1049,거문오름입구,33.45304,126.709,21,5,26,19,5,24,제주특별자치도 제주시 조천읍 선흘리 1848-3,제주시,303,2,126.709175,33.45263
1050,거문오름입구,33.452220000000004,126.70935,3,2,5,3,2,5,제주특별자치도 제주시 조천읍 선흘리 1869-4,제주시,303,2,126.709175,33.45263
1051,대천환승정류장(제주방향),33.43642,126.73489,1612,670,2282,1565,633,2198,제주특별자치도 제주시 구좌읍 송당리 2601-4,제주시,304,2,126.7347,33.4358
1052,성연목장,33.422340000000005,126.7568,102,21,123,99,21,120,제주특별자치도 제주시 구좌읍 송당리 산 262-1,제주시,305,2,126.756885,33.422445
1053,성연목장,33.42255,126.75697,82,10,92,80,10,90,제주특별자치도 제주시 구좌읍 송당리 산 262-1,제주시,305,2,126.756885,33.422445
1056,대성목장,33.43071,126.74753,23,6,29,23,4,27,제주특별자치도 제주시 구좌읍 송당리 산 286-3,제주시,306,2,126.747605,33.430795
1057,대성목장,33.43088,126.74768,73,31,104,69,31,100,제주특별자치도 제주시 구좌읍 송당리 산 286-3,제주시,306,2,126.747605,33.430795
1058,대천환승정류장(표선방향),33.43537,126.73714,847,350,1197,821,339,1160,제주특별자치도 제주시 구좌읍 송당리 2635-6,제주시,46,1,126.62861222222222,33.44766888888889
1059,대천환승정류장(교래방향),33.435179999999995,126.73451000000001,622,359,981,603,348,951,제주특별자치도 제주시 구좌읍 송당리 2614-2,제주시,304,2,126.7347,33.4358
1060,대천환승정류장(세화방향),33.43615,126.73704,1157,799,1956,1121,771,1892,제주특별자치도 제주시 구좌읍 송당리 산 126-7,제주시,46,1,126.62861222222222,33.44766888888889
1061,탐라승마장,33.43405,126.7178,80,16,96,50,15,65,제주특별자치도 제주시 조천읍 교래리 산 10-4,제주시,66,3,126.6356425,33.44581
1062,탐라승마장,33.43362,126.71682,15,6,21,14,6,20,제주특별자치도 제주시 조천읍 교래리 42-2,제주시,66,3,126.6356425,33.44581
1063,산굼부리,33.435320000000004,126.68933,463,447,910,391,419,810,제주특별자치도 제주시 조천읍 교래리 165-2,제주시,307,2,126.68908499999999,33.435345
1064,산굼부리,33.43537,126.68883999999998,1386,1210,2596,1111,1078,2189,제주특별자치도 제주시 조천읍 교래리 165-2,제주시,307,2,126.68908499999999,33.435345
1065,교래리,33.436859999999996,126.67786000000001,69,34,103,66,34,100,제주특별자치도 제주시 조천읍 교래리 827,제주시,4,3,126.57949375000001,33.455851249999995
1066,교래리보건소,33.43626,126.6762,850,99,949,825,93,918,제주특별자치도 제주시 조천읍 교래리 481-2,제주시,308,2,126.676445,33.436454999999995
1069,구엄리,33.474540000000005,126.37619,1463,221,1684,1419,212,1631,제주특별자치도 제주시 애월읍 구엄리 1080-7,제주시,309,2,126.37621999999999,33.47443
1070,구엄리,33.47432,126.37625,3917,341,4258,3858,324,4182,제주특별자치도 제주시 애월읍 구엄리 1078-12,제주시,309,2,126.37621999999999,33.47443
1071,중엄리,33.47355,126.37338999999999,2590,359,2949,2557,346,2903,제주특별자치도 제주시 애월읍 신엄리 757-6,제주시,310,2,126.37352999999999,33.473505
1072,중엄리,33.473459999999996,126.37366999999999,6765,435,7200,6673,426,7099,제주특별자치도 제주시 애월읍 신엄리 756-8,제주시,310,2,126.37352999999999,33.473505
1073,신엄리,33.47177,126.36806999999999,2721,336,3057,2666,324,2990,제주특별자치도 제주시 애월읍 신엄리 3208,제주시,311,2,126.3681,33.471685
1074,신엄리,33.4716,126.36813000000001,8249,337,8586,8130,325,8455,제주특별자치도 제주시 애월읍 신엄리 1305-9,제주시,311,2,126.3681,33.471685
1075,자운당,33.467420000000004,126.35694,1625,231,1856,1576,215,1791,제주특별자치도 제주시 애월읍 하가리 1633,제주시,47,1,126.44603000000001,33.468295000000005
1076,고내리애월119센터,33.46629,126.34943,2129,162,2291,2097,156,2253,제주특별자치도 제주시 애월읍 고내리 1365,제주시,312,2,126.34907000000001,33.46626
1077,애월119센터,33.466229999999996,126.34871000000001,1062,111,1173,1040,109,1149,제주특별자치도 제주시 애월읍 고내리 207-4,제주시,312,2,126.34907000000001,33.46626
1078,고내리,33.46246,126.33805,2368,597,2965,2309,581,2890,제주특별자치도 제주시 애월읍 고내리 663-3,제주시,1,3,126.4019414285714,33.479899999999994
1079,고내리,33.46315,126.3389,1553,850,2403,1475,838,2313,제주특별자치도 제주시 애월읍 고내리 1038-1,제주시,1,3,126.4019414285714,33.479899999999994
1080,애월고등학교,33.46262,126.33447,3026,386,3412,2950,369,3319,제주특별자치도 제주시 애월읍 고내리 1370,제주시,313,2,126.33451,33.462525
1081,애월고등학교,33.46243,126.33455,10693,721,11414,10396,691,11087,제주특별자치도 제주시 애월읍 애월리 4-3,제주시,313,2,126.33451,33.462525
1082,애월읍사무소,33.462579999999996,126.33033999999999,2306,88,2394,2245,86,2331,제주특별자치도 제주시 애월읍 애월리 343-5,제주시,43,3,126.41751714285714,33.46041714285714
1083,애월읍사무소,33.46308,126.32902,638,172,810,614,163,777,제주특별자치도 제주시 애월읍 애월리 353-2,제주시,43,3,126.41751714285714,33.46041714285714
1084,애월중학교,33.46358,126.32522,14,1,15,13,1,14,제주특별자치도 제주시 애월읍 애월리 458-1,제주시,44,3,126.58267,33.47515857142857
1085,애월중학교,33.46353,126.32416,5424,212,5636,5281,208,5489,제주특별자치도 제주시 애월읍 애월리 548,제주시,44,3,126.58267,33.47515857142857
1086,애월리,33.46439,126.32068999999998,5341,602,5943,5214,573,5787,제주특별자치도 제주시 애월읍 애월리 1715-19,제주시,314,2,126.32084499999999,33.464275
1087,애월환승정류장(애월리),33.46444,126.31983000000001,7746,1335,9081,7612,1276,8888,제주특별자치도 제주시 애월읍 애월리 1584-1,제주시,45,3,126.55458375,33.445024999999994
1088,신설동,33.46431,126.31636999999999,879,180,1059,850,176,1026,제주특별자치도 제주시 애월읍 애월리 2115-5,제주시,315,2,126.316035,33.46432
1089,신설동,33.46433,126.3157,13,2,15,13,2,15,제주특별자치도 제주시 애월읍 애월리 2020-1,제주시,315,2,126.316035,33.46432
1090,한담동,33.46264,126.31268999999999,3164,2591,5755,2984,2482,5466,제주특별자치도 제주시 애월읍 애월리 2628,제주시,316,2,126.312735,33.462535
1091,한담동,33.46243,126.31278,10492,6766,17258,9697,6405,16102,제주특별자치도 제주시 애월읍 애월리 2154-2,제주시,316,2,126.312735,33.462535
1092,곽지모물,33.45169,126.30892,2254,1096,3350,2148,1049,3197,제주특별자치도 제주시 애월읍 곽지리 1538-1,제주시,2,3,126.40150375000002,33.478381250000005
1093,곽지해수욕장,33.44843,126.30746,2482,1156,3638,2352,1126,3478,제주특별자치도 제주시 애월읍 곽지리 1668-3,제주시,317,2,126.307515,33.448315
1094,곽지해수욕장,33.4482,126.30757,5628,1453,7081,5440,1401,6841,제주특별자치도 제주시 애월읍 곽지리 2495,제주시,317,2,126.307515,33.448315
1095,금빛신협,33.44655,126.3058,3172,528,3700,3105,512,3617,제주특별자치도 제주시 애월읍 곽지리 2046-2,제주시,9,3,126.47283285714285,33.49399571428571
1096,금빛신협,33.44578,126.30467,1370,337,1707,1330,327,1657,제주특별자치도 제주시 애월읍 곽지리 2060-3,제주시,9,3,126.47283285714285,33.49399571428571
1097,금성리,33.444959999999995,126.30238999999999,693,65,758,685,61,746,제주특별자치도 제주시 애월읍 금성리 444-3,제주시,10,3,126.47669142857141,33.496474285714285
1098,금성리,33.4445,126.30143000000001,1803,142,1945,1787,136,1923,제주특별자치도 제주시 애월읍 금성리 601-3,제주시,10,3,126.47669142857141,33.496474285714285
1099,하동복지회관,33.44421,126.29678999999999,518,137,655,503,134,637,제주특별자치도 제주시 한림읍 귀덕리 4174,제주시,318,2,126.29677999999998,33.444289999999995
1100,하동복지회관,33.44437,126.29677,558,109,667,551,106,657,제주특별자치도 제주시 한림읍 귀덕리 903-4,제주시,318,2,126.29677999999998,33.444289999999995
1101,귀덕초등학교,33.44372,126.29413999999998,2445,486,2931,2347,440,2787,제주특별자치도 제주시 한림읍 귀덕리 1179-6,제주시,681,4,126.29413999999998,33.44372
1102,귀덕1리,33.443509999999996,126.29275,1334,226,1560,1298,219,1517,제주특별자치도 제주시 한림읍 귀덕리 1026-4,제주시,682,4,126.29275,33.443509999999996
1103,사동복지회관,33.442209999999996,126.29005,1026,155,1181,1004,148,1152,제주특별자치도 제주시 한림읍 귀덕리 4174,제주시,27,3,126.40820142857142,33.47559285714285
1104,사동복지회관,33.44187,126.28872,401,62,463,391,62,453,제주특별자치도 제주시 한림읍 귀덕리 3028-3,제주시,27,3,126.40820142857142,33.47559285714285
1105,초록마을,33.441179999999996,126.28666000000001,453,89,542,430,86,516,제주특별자치도 제주시 한림읍 귀덕리 2962-8,제주시,65,3,126.42995666666667,33.62573555555556
1106,초록마을,33.440979999999996,126.2856,349,32,381,341,29,370,제주특별자치도 제주시 한림읍 귀덕리 4174,제주시,65,3,126.42995666666667,33.62573555555556
1107,귀덕새마을금고,33.43994,126.28327,842,111,953,831,107,938,제주특별자치도 제주시 한림읍 귀덕리 3253-7,제주시,8,3,126.43528,33.484955
1108,귀덕새마을금고,33.43974,126.28236000000001,813,83,896,804,79,883,제주특별자치도 제주시 한림읍 귀덕리 3329-5,제주시,8,3,126.43528,33.484955
1109,귀덕2리,33.43813,126.28041,950,102,1052,937,101,1038,제주특별자치도 제주시 한림읍 귀덕리 3347-3,제주시,7,3,126.49200428571427,33.494951428571426
1110,귀덕2리,33.43732,126.27913999999998,816,78,894,810,77,887,제주특별자치도 제주시 한림읍 귀덕리 3992-1,제주시,7,3,126.49200428571427,33.494951428571426
1111,라신동,33.43527,126.27783000000001,215,19,234,210,19,229,제주특별자치도 제주시 한림읍 귀덕리 4174,제주시,319,2,126.27760500000001,33.434664999999995
1112,라신동,33.434059999999995,126.27738000000001,370,61,431,358,58,416,제주특별자치도 제주시 한림읍 귀덕리 3651-3,제주시,319,2,126.27760500000001,33.434664999999995
1113,용운동,33.43227,126.27596000000001,384,150,534,373,138,511,제주특별자치도 제주시 한림읍 수원리 262-5,제주시,320,2,126.27594,33.43211
1114,용운동,33.43195,126.27592,546,132,678,533,126,659,제주특별자치도 제주시 한림읍 대림리 1035-2,제주시,320,2,126.27594,33.43211
1115,대림입구,33.4286,126.27238999999999,271,49,320,266,46,312,제주특별자치도 제주시 한림읍 대림리 1095-23,제주시,321,2,126.272185,33.42853
1116,대림입구,33.42846,126.27198,86,39,125,84,38,122,제주특별자치도 제주시 한림읍 수원리 289,제주시,321,2,126.272185,33.42853
1117,수원리,33.426140000000004,126.26993999999999,1474,98,1572,1456,98,1554,제주특별자치도 제주시 한림읍 대림리 1591,제주시,39,3,126.32776000000001,33.39511
1118,수원리,33.42566,126.26913,928,55,983,913,55,968,제주특별자치도 제주시 한림읍 대림리 2021-8,제주시,39,3,126.32776000000001,33.39511
1119,한림2리,33.41402,126.26915,4,4,8,4,3,7,제주특별자치도 제주시 한림읍 한림리 1009-3,제주시,683,4,126.26915,33.41402
1120,한림고등학교,33.40488,126.25426999999999,861,300,1161,797,296,1093,제주특별자치도 제주시 한림읍 옹포리 983,제주시,684,4,126.25426999999999,33.40488
1121,옹포리,33.40332,126.2522,4340,523,4863,4199,511,4710,제주특별자치도 제주시 한림읍 옹포리 560-3,제주시,322,2,126.25194,33.403175000000005
1122,옹포리,33.40303,126.25168000000001,1222,394,1616,1152,385,1537,제주특별자치도 제주시 한림읍 옹포리 575,제주시,322,2,126.25194,33.403175000000005
1123,옹포사거리,33.40558,126.25598000000001,4290,1002,5292,4213,975,5188,제주특별자치도 제주시 한림읍 옹포리 983,제주시,323,2,126.25605,33.405715
1124,옹포사거리,33.40585,126.25612,1662,1153,2815,1568,1130,2698,제주특별자치도 제주시 한림읍 옹포리 983,제주시,323,2,126.25605,33.405715
1125,한림여자중학교,33.41033,126.25965,3956,650,4606,3870,639,4509,제주특별자치도 제주시 한림읍 한림리 1490-4,제주시,324,2,126.25970999999998,33.410615
1126,한림여자중학교,33.4109,126.25976999999999,2673,276,2949,2617,265,2882,제주특별자치도 제주시 한림읍 한림리 1473-6,제주시,324,2,126.25970999999998,33.410615
1127,한국통신,33.41275,126.26118000000001,4103,307,4410,4044,302,4346,제주특별자치도 제주시 한림읍 한림리 1386-13,제주시,325,2,126.26128,33.412885
1128,한국통신,33.41302,126.26138,1693,335,2028,1653,318,1971,제주특별자치도 제주시 한림읍 한림리 1582,제주시,325,2,126.26128,33.412885
1129,한림환승정류장(한림리),33.41437,126.26336,29341,2169,31510,28938,2094,31032,제주특별자치도 제주시 한림읍 한림리 1360-2,제주시,74,3,126.43390000000001,33.449625
1130,한림환승정류장(한림리),33.41453,126.26427,36280,2541,38821,35631,2429,38060,제주특별자치도 제주시 한림읍 한림리 1582,제주시,74,3,126.43390000000001,33.449625
1131,한수리,33.42224,126.2646,1351,59,1410,1328,56,1384,제주특별자치도 제주시 한림읍 한수리 839,제주시,326,2,126.26434499999999,33.422055
1132,한수리,33.42187,126.26409,388,31,419,380,31,411,제주특별자치도 제주시 한림읍 한수리 887-9,제주시,326,2,126.26434499999999,33.422055
1133,한림천주교회,33.41711,126.26491000000001,7568,342,7910,7423,334,7757,제주특별자치도 제주시 한림읍 한림리 1584,제주시,48,1,126.40944571428574,33.456941428571426
1134,한림주유소,33.416709999999995,126.26483,5738,666,6404,5609,638,6247,제주특별자치도 제주시 한림읍 한림리 1584,제주시,48,1,126.40944571428574,33.456941428571426
1135,협재리,33.39788,126.24528000000001,5067,1954,7021,4934,1904,6838,제주특별자치도 제주시 한림읍 협재리 1590-1,제주시,327,2,126.24496500000001,33.397705
1136,협재리,33.397529999999996,126.24465,989,647,1636,964,625,1589,제주특별자치도 제주시 한림읍 협재리 2872,제주시,327,2,126.24496500000001,33.397705
1137,협재해수욕장,33.39421,126.24098000000001,8603,4951,13554,8058,4769,12827,제주특별자치도 제주시 한림읍 협재리 1750-9,제주시,328,2,126.24090000000001,33.394220000000004
1138,협재해수욕장,33.39423,126.24082,2587,2182,4769,2434,2079,4513,제주특별자치도 제주시 한림읍 협재리 2447-4,제주시,328,2,126.24090000000001,33.394220000000004
1139,한림공원,33.39182,126.23908,3194,1401,4595,2919,1324,4243,제주특별자치도 제주시 한림읍 협재리 2514-15,제주시,329,2,126.23897,33.3918
1140,한림공원,33.39178,126.23886,1047,849,1896,958,804,1762,제주특별자치도 제주시 한림읍 협재리 2497-3,제주시,329,2,126.23897,33.3918
1141,금능리,33.3874,126.23226000000001,699,376,1075,678,365,1043,제주특별자치도 제주시 한림읍 금능리 2072-2,제주시,330,2,126.23230000000001,33.38731
1142,금능리,33.38722,126.23234,3616,655,4271,3537,626,4163,제주특별자치도 제주시 한림읍 금능리 2072-6,제주시,330,2,126.23230000000001,33.38731
1143,금능석물원,33.38603,126.22628,355,125,480,330,124,454,제주특별자치도 제주시 한림읍 금능리 1282-3,제주시,235,2,126.226305,33.38597
1144,월령리,33.37615,126.21781999999999,3115,679,3794,3065,663,3728,제주특별자치도 제주시 한림읍 월령리 219-3,제주시,331,2,126.21761,33.376050000000006
1145,월령리,33.37595,126.2174,461,164,625,438,162,600,제주특별자치도 제주시 한림읍 월령리 1220,제주시,331,2,126.21761,33.376050000000006
1146,판포리상동,33.36765,126.20451000000001,647,207,854,628,200,828,제주특별자치도 제주시 한경면 판포리 1634-6,제주시,255,2,126.20435,33.367665
1147,판포리,33.3648,126.20025,2952,629,3581,2752,602,3354,제주특별자치도 제주시 한경면 판포리 2864-2,제주시,67,3,126.3706425,33.434627500000005
1148,판포리,33.36457,126.19927,847,245,1092,802,233,1035,제주특별자치도 제주시 한경면 판포리 2869-4,제주시,67,3,126.3706425,33.434627500000005
1149,금등리마을,33.36175,126.19296000000001,738,36,774,713,36,749,제주특별자치도 제주시 한경면 금등리 658-7,제주시,332,2,126.19268000000001,33.361765
1150,금등리마을,33.361779999999996,126.1924,209,28,237,202,25,227,제주특별자치도 제주시 한경면 금등리 729-5,제주시,332,2,126.19268000000001,33.361765
1151,구한경의원앞,33.34407,126.18268,344,120,464,326,118,444,제주특별자치도 제주시 한경면 신창리 680-2,제주시,253,2,126.182545,33.34396
1152,신창리한경수협,33.347609999999996,126.18279,581,74,655,567,71,638,제주특별자치도 제주시 한경면 신창리 1481,제주시,254,2,126.18275,33.34748999999999
1153,신창환승정류장(한경면사무소),33.34993,126.18308,8946,1118,10064,8759,1032,9791,제주특별자치도 제주시 한경면 신창리 261-8,제주시,33,1,126.30488375000002,33.38845875
1154,두모리사무소,33.35351,126.18528,1305,69,1374,1291,69,1360,제주특별자치도 제주시 한경면 두모리 3023-8,제주시,333,2,126.185305,33.35374
1155,두모리사무소,33.353970000000004,126.18533000000001,279,17,296,277,17,294,제주특별자치도 제주시 한경면 두모리 2382-1,제주시,333,2,126.185305,33.35374
1156,신흥동,33.34063,126.18238000000001,706,13,719,697,13,710,제주특별자치도 제주시 한경면 용수리 4719-1,제주시,252,2,126.18222,33.34062
1157,용수리,33.32101,126.17853999999998,556,92,648,543,89,632,제주특별자치도 제주시 한경면 용수리 3048-4,제주시,251,2,126.17832999999999,33.320935
1158,고산1리(구출장소),33.30657,126.17855,493,73,566,488,71,559,제주특별자치도 제주시 한경면 고산리 2629-2,제주시,334,2,126.178765,33.306315
1159,고산1리(구출장소),33.306059999999995,126.17898000000001,1442,140,1582,1426,130,1556,제주특별자치도 제주시 한경면 고산리 3993,제주시,334,2,126.178765,33.306315
1160,고산우체국앞,33.3038,126.1796,2973,139,3112,2929,137,3066,제주특별자치도 제주시 한경면 고산리 2208-5,제주시,335,2,126.17951,33.303435
1161,고산,33.30307,126.17942,638,59,697,632,57,689,제주특별자치도 제주시 한경면 고산리 2203-2,제주시,335,2,126.17951,33.303435
1162,고산환승정류장(고산1리고산성당앞),33.3009,126.18043,7713,801,8514,7539,749,8288,제주특별자치도 제주시 한경면 고산리 2865-5,제주시,34,1,126.291986,33.375851
1163,고산1리육거리,33.30087,126.17971999999999,145,25,170,143,24,167,제주특별자치도 제주시 한경면 고산리 3993,제주시,34,1,126.291986,33.375851
1164,화전마을,33.35201,126.36003000000001,1728,261,1989,1696,250,1946,제주특별자치도 제주시 애월읍 봉성리 산 35-9,제주시,81,3,126.479065,33.4204475
1165,화전마을,33.35143,126.35902,385,164,549,371,163,534,제주특별자치도 제주시 한림읍 금악리 산 31-15,제주시,81,3,126.479065,33.4204475
1166,엘리시안CC,33.38017,126.37142,200,1,201,198,1,199,제주특별자치도 제주시 애월읍 어음리 산 187,제주시,685,4,126.37142,33.38017
1167,국학원,33.3889,126.37368000000001,322,128,450,304,123,427,제주특별자치도 제주시 애월읍 어음리 산 3,제주시,6,3,126.468044,33.475798999999995
1168,렛츠런파크,33.40997,126.39263000000001,1869,41,1910,1846,37,1883,제주특별자치도 제주시 애월읍 소길리 산 186-1,제주시,336,2,126.39303000000001,33.410195
1169,렛츠런파크,33.41042,126.39343000000001,8497,92,8589,8406,90,8496,제주특별자치도 제주시 애월읍 소길리 산 186-1,제주시,336,2,126.39303000000001,33.410195
1170,고성2리,33.43616,126.42416000000001,3157,78,3235,3105,75,3180,제주특별자치도 제주시 애월읍 고성리 920-3,제주시,337,2,126.42409500000001,33.43655
1171,제주공룡원,33.443290000000005,126.43186000000001,757,165,922,734,156,890,제주특별자치도 제주시 애월읍 광령리 2675-2,제주시,338,2,126.431745,33.443625
1172,산이굴,33.44396,126.43163,196,82,278,192,77,269,제주특별자치도 제주시 애월읍 광령리 2663-1,제주시,338,2,126.431745,33.443625
1173,고성2리,33.43694,126.42403,496,24,520,485,24,509,제주특별자치도 제주시 애월읍 고성리 914-6,제주시,337,2,126.42409500000001,33.43655
1174,국학원,33.38753,126.37263,176,100,276,170,93,263,제주특별자치도 제주시 애월읍 어음리 산 72-4,제주시,6,3,126.468044,33.475798999999995
1175,어음2리입구,33.38025,126.37048,112,11,123,112,11,123,제주특별자치도 제주시 애월읍 어음리 산 68-3,제주시,686,4,126.37048,33.38025
1176,하도리창흥동,33.50877,126.88738000000001,740,214,954,718,209,927,제주특별자치도 제주시 구좌읍 하도리 산 10-1,제주시,339,2,126.88720500000001,33.50866499999999
1177,하도리창흥동,33.508559999999996,126.88703000000001,176,118,294,166,111,277,제주특별자치도 제주시 구좌읍 하도리 산 10-5,제주시,339,2,126.88720500000001,33.50866499999999
1178,하도리동동,33.51605,126.88448000000001,1006,102,1108,1001,82,1083,제주특별자치도 제주시 구좌읍 하도리 1299-5,제주시,340,2,126.88434500000001,33.51599
1179,하도리동동,33.51593,126.88421000000001,261,53,314,257,53,310,제주특별자치도 제주시 구좌읍 하도리 1209-2,제주시,340,2,126.88434500000001,33.51599
1180,하도리,33.51793,126.88271999999999,2689,411,3100,2664,393,3057,제주특별자치도 제주시 구좌읍 하도리 1314-2,제주시,341,2,126.882655,33.517849999999996
1181,하도리,33.51777,126.88259,674,193,867,665,186,851,제주특별자치도 제주시 구좌읍 하도리 1313-3,제주시,341,2,126.882655,33.517849999999996
1182,하도초등학교,33.51812,126.87902,709,31,740,692,31,723,제주특별자치도 제주시 구좌읍 하도리 2251-6,제주시,342,2,126.87903,33.518010000000004
1183,하도초등학교,33.5179,126.87903999999999,219,24,243,217,24,241,제주특별자치도 제주시 구좌읍 하도리 2251-5,제주시,342,2,126.87903,33.518010000000004
1184,하도리면수동,33.52065,126.86867,253,105,358,251,103,354,제주특별자치도 제주시 구좌읍 하도리 3309-5,제주시,343,2,126.86838499999999,33.520835000000005
1185,하도리면수동,33.52102,126.8681,974,91,1065,967,90,1057,제주특별자치도 제주시 구좌읍 하도리 3309-6,제주시,343,2,126.86838499999999,33.520835000000005
1186,해녀박물관입구,33.52114,126.86385,2180,756,2936,2109,729,2838,제주특별자치도 제주시 구좌읍 상도리 471-33,제주시,49,1,126.67595750000001,33.484984999999995
1187,해녀박물관입구,33.521029999999996,126.86376000000001,1191,679,1870,1143,665,1808,제주특별자치도 제주시 구좌읍 상도리 471-33,제주시,49,1,126.67595750000001,33.484984999999995
1188,세화리구좌농협,33.52095,126.85986000000001,3057,278,3335,2990,262,3252,제주특별자치도 제주시 구좌읍 세화리 1366-2,제주시,37,1,126.77774749999999,33.52082
1189,세화리구좌농협,33.52107,126.85958000000001,3410,520,3930,3337,506,3843,제주특별자치도 제주시 구좌읍 세화리 1366-4,제주시,37,1,126.77774749999999,33.52082
1190,구좌보건소,33.519859999999994,126.85968999999999,274,51,325,270,48,318,제주특별자치도 제주시 구좌읍 세화리 1332,제주시,37,1,126.77774749999999,33.52082
1191,세화고등학교,33.5168,126.863,583,7,590,558,7,565,제주특별자치도 제주시 구좌읍 세화리 3637,제주시,344,2,126.86326500000001,33.516665
1192,상도리세화고등학교,33.516529999999996,126.86353000000001,581,10,591,567,9,576,제주특별자치도 제주시 구좌읍 상도리 524-1,제주시,344,2,126.86326500000001,33.516665
1193,상도마을회관,33.51487,126.86532,29,15,44,25,12,37,제주특별자치도 제주시 구좌읍 상도리 589,제주시,345,2,126.865725,33.51466
1194,상도마을회관,33.51445,126.86613,299,16,315,285,15,300,제주특별자치도 제주시 구좌읍 상도리 1401,제주시,345,2,126.865725,33.51466
1195,종달리,33.49512,126.89621000000001,1980,345,2325,1941,338,2279,제주특별자치도 제주시 구좌읍 종달리 1714-4,제주시,248,2,126.89619,33.495035
1196,종달초등학교,33.4929,126.89648000000001,4105,1078,5183,4027,1063,5090,제주특별자치도 제주시 구좌읍 종달리 1782-3,제주시,346,2,126.896375,33.492639999999994
1197,종달초등학교,33.49238,126.89627,1560,533,2093,1517,519,2036,제주특별자치도 제주시 구좌읍 종달리 1903-1,제주시,346,2,126.896375,33.492639999999994
1198,평대리동동,33.524390000000004,126.84971000000002,1422,135,1557,1402,130,1532,제주특별자치도 제주시 구좌읍 평대리 419-2,제주시,347,2,126.84960500000001,33.524355
1199,평대리동동,33.52432,126.8495,421,122,543,417,120,537,제주특별자치도 제주시 구좌읍 평대리 355-10,제주시,347,2,126.84960500000001,33.524355
1200,평대리사무소,33.52787,126.84331,1199,409,1608,1186,397,1583,제주특별자치도 제주시 구좌읍 평대리 749-1,제주시,68,3,126.6912025,33.51858
1201,평대리사무소,33.52834,126.84228,931,389,1320,912,376,1288,제주특별자치도 제주시 구좌읍 평대리 3344,제주시,68,3,126.6912025,33.51858
1202,평대초등학교,33.52884,126.83878999999999,505,365,870,492,356,848,제주특별자치도 제주시 구좌읍 평대리 1727-1,제주시,30,1,126.64079625,33.50402750000001
1203,평대초등학교,33.52957,126.83922,1682,712,2394,1652,691,2343,제주특별자치도 제주시 구좌읍 평대리 647-3,제주시,30,1,126.64079625,33.50402750000001
1204,평대초등학교,33.529759999999996,126.83878,72,5,77,71,5,76,제주특별자치도 제주시 구좌읍 평대리 1720-6,제주시,30,1,126.64079625,33.50402750000001
1205,평대리서동,33.530770000000004,126.83778000000001,718,262,980,700,260,960,제주특별자치도 제주시 구좌읍 평대리 1841-1,제주시,348,2,126.83768,33.530775000000006
1206,평대리서동,33.53078,126.83758,685,182,867,663,178,841,제주특별자치도 제주시 구좌읍 평대리 3344,제주시,348,2,126.83768,33.530775000000006
1207,계룡동,33.53362,126.83389,558,197,755,551,192,743,제주특별자치도 제주시 구좌읍 평대리 2033-16,제주시,349,2,126.83367,33.534009999999995
1208,계룡동,33.5344,126.83345,863,354,1217,833,347,1180,제주특별자치도 제주시 구좌읍 한동리 37-2,제주시,349,2,126.83367,33.534009999999995
1209,한동리,33.53717,126.82958,1513,216,1729,1490,213,1703,제주특별자치도 제주시 구좌읍 한동리 1195-3,제주시,350,2,126.829515,33.537135000000006
1210,한동리,33.5371,126.82945,1803,155,1958,1791,146,1937,제주특별자치도 제주시 구좌읍 한동리 1186-2,제주시,350,2,126.829515,33.537135000000006
1211,한동리서동,33.53873,126.82722,1939,321,2260,1883,315,2198,제주특별자치도 제주시 구좌읍 한동리 1161-3,제주시,351,2,126.82707500000001,33.53875
1212,한동리서동,33.53877,126.82693,1493,231,1724,1460,223,1683,제주특별자치도 제주시 구좌읍 한동리 4848,제주시,351,2,126.82707500000001,33.53875
1213,구좌중앙초등학교,33.55117,126.79858,2421,1208,3629,2306,1156,3462,제주특별자치도 제주시 구좌읍 월정리 1894,제주시,352,2,126.79878,33.551175
1214,구좌중앙초등학교,33.55118,126.79898,2568,2081,4649,2417,1999,4416,제주특별자치도 제주시 구좌읍 월정리 130-11,제주시,352,2,126.79878,33.551175
1215,행원리,33.55337,126.80771000000001,2653,377,3030,2612,363,2975,제주특별자치도 제주시 구좌읍 행원리 727-1,제주시,353,2,126.807995,33.55315
1216,행원리,33.552929999999996,126.80828000000001,2077,289,2366,2034,275,2309,제주특별자치도 제주시 구좌읍 행원리 811-7,제주시,353,2,126.807995,33.55315
1217,행원농공단지,33.54936,126.8141,249,28,277,242,28,270,제주특별자치도 제주시 구좌읍 행원리 438-3,제주시,354,2,126.81424,33.54933
1218,행원농공단지,33.5493,126.81438,896,53,949,888,51,939,제주특별자치도 제주시 구좌읍 행원리 3554,제주시,354,2,126.81424,33.54933
1219,월정리,33.5519,126.79105,3143,1912,5055,2951,1820,4771,제주특별자치도 제주시 구좌읍 월정리 306-3,제주시,355,2,126.7911,33.551825
1220,월정리,33.55175,126.79115,1572,1381,2953,1494,1320,2814,제주특별자치도 제주시 구좌읍 월정리 214-5,제주시,355,2,126.7911,33.551825
1221,만장굴입구,33.54965,126.7789,526,602,1128,496,573,1069,제주특별자치도 제주시 구좌읍 월정리 1821-4,제주시,211,2,126.77858499999999,33.549414999999996
1222,만장굴입구,33.54925,126.7773,691,1017,1708,661,994,1655,제주특별자치도 제주시 구좌읍 월정리 1840-3,제주시,687,4,126.7773,33.54925
1223,지경곰,33.55198,126.76855,226,146,372,217,144,361,제주특별자치도 제주시 구좌읍 김녕리 2117,제주시,356,2,126.768365,33.552135
1224,지경곰,33.55229,126.76818,265,165,430,258,156,414,제주특별자치도 제주시 구좌읍 김녕리 2117,제주시,356,2,126.768365,33.552135
1225,김녕해수욕장,33.555820000000004,126.76029,1372,835,2207,1303,804,2107,제주특별자치도 제주시 구좌읍 김녕리 497-2,제주시,11,3,126.58891571428572,33.522305714285714
1226,김녕해수욕장,33.55617,126.75931000000001,636,672,1308,606,646,1252,제주특별자치도 제주시 구좌읍 김녕리 501-2,제주시,11,3,126.58891571428572,33.522305714285714
1227,동성동,33.55563,126.75453,1251,363,1614,1217,347,1564,제주특별자치도 제주시 구좌읍 김녕리 2121,제주시,247,2,126.75453,33.5557
1228,김녕환승정류장(김녕초등학교),33.55503,126.75125,11553,3802,15355,11188,3596,14784,제주특별자치도 제주시 구좌읍 김녕리 2121,제주시,357,2,126.75126,33.554965
1229,김녕환승정류장(김녕초등학교),33.5549,126.75126999999999,5075,1216,6291,4973,1157,6130,제주특별자치도 제주시 구좌읍 김녕리 1691-2,제주시,357,2,126.75126,33.554965
1230,김녕리,33.55422,126.74795,1527,522,2049,1503,502,2005,제주특별자치도 제주시 구좌읍 김녕리 6194,제주시,358,2,126.74753000000001,33.5543
1231,김녕리,33.55438,126.74711,4788,273,5061,4736,249,4985,제주특별자치도 제주시 구좌읍 김녕리 3607,제주시,358,2,126.74753000000001,33.5543
1232,남흘동,33.55535,126.74328,548,91,639,548,91,639,제주특별자치도 제주시 구좌읍 김녕리 6194,제주시,359,2,126.743105,33.55539
1233,남흘동,33.55543,126.74293,1685,178,1863,1649,170,1819,제주특별자치도 제주시 구좌읍 김녕리 6194,제주시,359,2,126.743105,33.55539
1234,동복리,33.553020000000004,126.71265,4471,346,4817,4401,335,4736,제주특별자치도 제주시 구좌읍 동복리 1759,제주시,360,2,126.71261,33.55297
1235,동복리,33.55292,126.71257,1230,316,1546,1192,309,1501,제주특별자치도 제주시 구좌읍 동복리 1484-3,제주시,360,2,126.71261,33.55297
1236,동복리휴게소,33.553329999999995,126.70765,134,114,248,128,106,234,제주특별자치도 제주시 구좌읍 동복리 1685-4,제주시,246,2,126.70765,33.553415
1237,북촌다려마을,33.55145,126.70148,255,149,404,247,147,394,제주특별자치도 제주시 조천읍 북촌리 361-2,제주시,25,3,126.55256857142857,33.50196285714286
1238,북촌다려마을,33.55107,126.70022,728,190,918,702,183,885,제주특별자치도 제주시 조천읍 북촌리 388-5,제주시,25,3,126.55256857142857,33.50196285714286
1239,북촌리,33.548120000000004,126.69503,7290,490,7780,7129,480,7609,제주특별자치도 제주시 조천읍 북촌리 632-1,제주시,50,1,126.62230625,33.503832499999994
1240,북촌리,33.54797,126.69523000000001,707,216,923,657,205,862,제주특별자치도 제주시 조천읍 북촌리 634-3,제주시,50,1,126.62230625,33.503832499999994
1241,북촌리해동,33.54475,126.68695,191,99,290,186,91,277,제주특별자치도 제주시 조천읍 북촌리 1636-5,제주시,26,3,126.56073375000001,33.4921825
1242,북촌리해동,33.54418,126.68547,1232,264,1496,1198,239,1437,제주특별자치도 제주시 조천읍 북촌리 2688,제주시,26,3,126.56073375000001,33.4921825
1243,911의원,33.540620000000004,126.6784,222,43,265,206,42,248,제주특별자치도 제주시 조천읍 함덕리 261-24,제주시,361,2,126.67824,33.540655
1244,911의원,33.540690000000005,126.67808000000001,455,37,492,445,37,482,제주특별자치도 제주시 조천읍 함덕리 261-10,제주시,361,2,126.67824,33.540655
1245,1100고지휴게소,33.357820000000004,126.46293999999999,155,51,206,150,49,199,제주특별자치도 서귀포시 색달동 산 1-2,서귀포시,0,2,126.51989499999999,33.295381250000005
1246,한라산둘레길(천아숲길입구),33.4095,126.47705,86,4,90,79,4,83,제주특별자치도 제주시 해안동 산 219-10,제주시,362,2,126.477115,33.409425
1247,충혼묘지,33.4182,126.48995,188,27,215,182,19,201,제주특별자치도 제주시 노형동 산 17-3,제주시,363,2,126.48988499999999,33.418234999999996
1248,한라산둘레길(천아숲길입구),33.40935,126.47718,112,15,127,110,15,125,제주특별자치도 제주시 해안동 산 219-3,제주시,362,2,126.477115,33.409425
1249,어리목,33.39035,126.48531000000001,1512,738,2250,1367,693,2060,제주특별자치도 제주시 해안동 산 220-1,제주시,364,2,126.48532,33.390285
1250,어리목입구,33.39022,126.48533,419,226,645,360,210,570,제주특별자치도 제주시 해안동 산 220-3,제주시,364,2,126.48532,33.390285
1251,충혼묘지,33.41827,126.48982,16,7,23,16,6,22,제주특별자치도 제주시 노형동 산 17-2,제주시,363,2,126.48988499999999,33.418234999999996
1252,봉개체육공원,33.48428,126.61158,465,200,665,452,195,647,제주특별자치도 제주시 회천동 1783-4,제주시,688,4,126.61158,33.48428
1253,성판악,33.38512,126.62048999999999,5332,2219,7551,4996,2092,7088,제주특별자치도 제주시 조천읍 교래리 산 137-23,제주시,689,4,126.62048999999999,33.38512
1254,봉개교,33.496759999999995,126.58166000000001,100,3,103,100,3,103,제주특별자치도 제주시 봉개동 2735,제주시,365,2,126.581605,33.49665
1255,전원마을,33.47485,126.63871,770,130,900,765,122,887,제주특별자치도 제주시 조천읍 와흘리 2836,제주시,366,2,126.63869500000001,33.474705
1256,초록마을,33.4712,126.64496000000001,434,55,489,430,53,483,제주특별자치도 제주시 조천읍 와흘리 2871-1,제주시,65,3,126.42995666666667,33.62573555555556
1257,남조로검문소,33.46986,126.65782,678,109,787,665,103,768,제주특별자치도 제주시 조천읍 와흘리 125-3,제주시,12,3,126.55788625000001,33.49230625
1258,이기풍선교기념관,33.456559999999996,126.6627,394,50,444,389,46,435,제주특별자치도 제주시 조천읍 대흘리 산 46-2,제주시,367,2,126.66249,33.45622
1259,제주돌문화공원,33.44747,126.66402,2113,1096,3209,1830,956,2786,제주특별자치도 제주시 조천읍 교래리 산 99-1,제주시,368,2,126.664155,33.44681
1260,교래사거리,33.43408,126.67206000000002,957,355,1312,896,334,1230,제주특별자치도 제주시 조천읍 교래리 산 60-19,제주시,45,1,126.55458375,33.445024999999994
1261,교래리,33.42463,126.67568,671,66,737,649,64,713,제주특별자치도 제주시 조천읍 교래리 산 36-2,제주시,4,3,126.57949375000001,33.455851249999995
1262,제주목장,33.41741,126.67799,660,96,756,642,93,735,제주특별자치도 제주시 조천읍 교래리 산 25-3,제주시,369,2,126.677965,33.417334999999994
1263,제주목장,33.41726,126.67793999999999,141,34,175,138,32,170,제주특별자치도 제주시 조천읍 교래리 산 25-3,제주시,369,2,126.677965,33.417334999999994
1264,교래리,33.42588,126.67442,199,27,226,189,25,214,제주특별자치도 제주시 조천읍 교래리 837,제주시,4,3,126.57949375000001,33.455851249999995
1265,교래사거리,33.4344,126.67161000000002,465,193,658,436,180,616,제주특별자치도 제주시 조천읍 교래리 산 60-65,제주시,45,1,126.55458375,33.445024999999994
1266,제주돌문화공원,33.44615,126.66429,552,486,1038,495,445,940,제주특별자치도 제주시 조천읍 교래리 산 99-10,제주시,368,2,126.664155,33.44681
1267,이기풍선교기념관,33.45588,126.66228000000001,82,21,103,80,20,100,제주특별자치도 제주시 조천읍 대흘리 산 46-2,제주시,367,2,126.66249,33.45622
1268,초록마을,33.47074,126.64615,60,43,103,56,43,99,제주특별자치도 제주시 조천읍 와흘리 2948-2,제주시,65,3,126.42995666666667,33.62573555555556
1269,전원마을,33.47456,126.63868000000001,360,189,549,355,186,541,제주특별자치도 제주시 조천읍 와흘리 2819-1,제주시,366,2,126.63869500000001,33.474705
1271,봉개교,33.49654,126.58155,188,12,200,187,12,199,제주특별자치도 제주시 봉개동 2698,제주시,365,2,126.581605,33.49665
1272,제주컨트리클럽,33.4327,126.58545,213,9,222,209,9,218,제주특별자치도 제주시 영평동 2263-1,제주시,370,2,126.58525,33.432829999999996
1273,견월교,33.424009999999996,126.60813999999999,106,13,119,106,13,119,제주특별자치도 제주시 봉개동-457,제주시,371,2,126.60817999999999,33.423895
1274,교래입구,33.41938,126.61678,614,141,755,588,138,726,제주특별자치도 제주시 봉개동 산 78-19,제주시,51,1,126.5372542857143,33.463521428571426
1275,교래입구,33.41923,126.61662,823,523,1346,786,496,1282,제주특별자치도 제주시 봉개동-457,제주시,51,1,126.5372542857143,33.463521428571426
1276,견월교,33.42378,126.60821999999999,104,63,167,90,58,148,제주특별자치도 제주시 봉개동 산 78-6,제주시,371,2,126.60817999999999,33.423895
1277,제주컨트리클럽,33.432959999999994,126.58505,42,11,53,42,10,52,제주특별자치도 제주시 영평동 2263-2,제주시,370,2,126.58525,33.432829999999996
1281,와흘상동,33.49276,126.63476999999999,22,2,24,22,1,23,제주특별자치도 제주시 조천읍 와흘리 2814,제주시,690,4,126.63476999999999,33.49276
1282,장전리사무소,33.450990000000004,126.38821000000002,407,7,414,403,7,410,제주특별자치도 제주시 애월읍 장전리 362-5,제주시,292,2,126.38833000000001,33.450935
1283,납읍리섯잣길,33.43673,126.32738,2100,21,2121,2069,21,2090,제주특별자치도 제주시 애월읍 납읍리 2422-3,제주시,282,2,126.32748000000001,33.43689
1284,더럭초등학교,33.45415,126.34616000000001,252,105,357,245,100,345,제주특별자치도 제주시 애월읍 하가리 1552-2,제주시,372,2,126.346115,33.454195000000006
1286,하가리연못,33.4558,126.34839,576,84,660,567,65,632,제주특별자치도 제주시 애월읍 하가리 1369-4,제주시,373,2,126.348395,33.45595
1288,대흘초등학교,33.49897,126.6585,603,10,613,599,5,604,제주특별자치도 제주시 조천읍 대흘리 2787,제주시,38,1,126.54743142857144,33.496007142857145
1289,와산삼거리,33.49129,126.68226000000001,579,22,601,571,22,593,제주특별자치도 제주시 조천읍 와산리 980-3,제주시,260,2,126.68223,33.491405
1290,제일농장,33.49282,126.66837,126,12,138,123,12,135,제주특별자치도 제주시 조천읍 대흘리 2787,제주시,259,2,126.66834499999999,33.492935
1293,봉성하나로마트,33.41888,126.31265,490,2,492,489,2,491,제주특별자치도 제주시 애월읍 봉성리 4124-5,제주시,42,1,126.44627714285716,33.456517142857145
1294,하가리주승골,33.45774,126.35077,834,29,863,827,28,855,제주특별자치도 제주시 애월읍 하가리 941-2,제주시,374,2,126.35074499999999,33.45778
1295,하가리노인회관,33.45782,126.35072,57,1,58,57,1,58,제주특별자치도 제주시 애월읍 하가리 947-7,제주시,374,2,126.35074499999999,33.45778
1296,더럭초등학교,33.45424000000001,126.34607,20,17,37,20,17,37,제주특별자치도 제주시 애월읍 하가리 1575-1,제주시,372,2,126.346115,33.454195000000006
1298,존손이굴,33.45243,126.36197,48,6,54,48,6,54,제주특별자치도 제주시 애월읍 하가리 168-3,제주시,288,2,126.36213,33.4523
1301,이시돌하단지,33.34496,126.32243000000001,71,20,91,65,20,85,제주특별자치도 제주시 한림읍 금악리 111-1,제주시,375,2,126.322495,33.344975000000005
1302,이시돌삼거리,33.3447,126.31695,37,2,39,37,2,39,제주특별자치도 제주시 한림읍 금악리 411,제주시,274,2,126.31683000000001,33.344685
1304,동수동,33.51762,126.6225,603,4,607,598,4,602,제주특별자치도 제주시 조천읍 신촌리 1402-6,제주시,691,4,126.6225,33.51762
1311,이시돌하단지,33.34499,126.32256000000001,142,30,172,138,29,167,제주특별자치도 제주시 한림읍 금악리 119-2,제주시,375,2,126.322495,33.344975000000005
1313,상가리동동,33.45211,126.3466,370,17,387,368,15,383,제주특별자치도 제주시 애월읍 하가리 1585-1,제주시,286,2,126.34693999999999,33.452095
1316,동회천,33.50455,126.61345,33,17,50,33,17,50,제주특별자치도 제주시 회천동 2326-4,제주시,301,2,126.613415,33.504599999999996
1317,고산1리육거리,33.300959999999996,126.17948,171,27,198,168,26,194,제주특별자치도 제주시 한경면 고산리 2822-13,제주시,34,1,126.291986,33.375851
1318,산양리,33.29351,126.23348,300,11,311,300,11,311,제주특별자치도 제주시 한경면 청수리 3329-1,제주시,39,1,126.32776000000001,33.39511
1325,선린지,33.49305,126.71565,5,5,10,5,5,10,제주특별자치도 제주시 조천읍 선흘리 산 59-5,제주시,692,4,126.71565,33.49305
1326,알밤오름,33.49695,126.71281,117,38,155,116,38,154,제주특별자치도 제주시 조천읍 선흘리 334-14,제주시,376,2,126.712755,33.496865
1327,알밤오름,33.49678,126.7127,20,17,37,18,17,35,제주특별자치도 제주시 조천읍 선흘리 668,제주시,376,2,126.712755,33.496865
1328,웃가름,33.50927,126.70701000000001,247,20,267,247,18,265,제주특별자치도 제주시 조천읍 선흘리 1277-2,제주시,377,2,126.70703500000002,33.50913
1329,웃가름,33.508990000000004,126.70706000000001,35,9,44,34,9,43,제주특별자치도 제주시 조천읍 선흘리 1275-3,제주시,377,2,126.70703500000002,33.50913
1330,유수암(거문덕이),33.43105,126.4002,388,1,389,380,1,381,제주특별자치도 제주시 애월읍 유수암리 1603,제주시,378,2,126.40013,33.431
1331,유수암(거문덕이),33.43095,126.40006000000001,678,5,683,667,3,670,제주특별자치도 제주시 애월읍 유수암리 3236,제주시,378,2,126.40013,33.431
1341,조천도서관,33.53719,126.6667,24,6,30,23,3,26,제주특별자치도 제주시 조천읍 함덕리 917-1,제주시,62,3,126.5365675,33.501315000000005
1343,하가삼거리,33.4561,126.3484,101,11,112,98,11,109,제주특별자치도 제주시 애월읍 하가리 1376-2,제주시,373,2,126.348395,33.45595
1348,광령2리사무소,33.44932,126.42912,729,15,744,723,15,738,제주특별자치도 제주시 애월읍 광령리 3068-4,제주시,52,1,126.47459428571428,33.483898571428576
1349,애월신협,33.46416,126.321,6258,400,6658,6173,387,6560,제주특별자치도 제주시 애월읍 애월리 1639-2,제주시,314,2,126.32084499999999,33.464275
1353,한라도서관,33.47615,126.51472,2651,31,2682,2613,31,2644,제주특별자치도 제주시 오라이동 899-3,제주시,379,2,126.514985,33.476005
1355,제주국제공항(신제주방면),33.5061,126.49275,93750,35048,128798,91973,33263,125236,제주특별자치도 제주시 용담이동 1984-5,제주시,28,1,126.48837428571427,33.499021428571425
1356,제주절물자연휴양림,33.440259999999995,126.63018999999998,3825,338,4163,3749,322,4071,제주특별자치도 제주시 봉개동 산 78-1,제주시,380,2,126.63022,33.440479999999994
1357,한라생태숲,33.429559999999995,126.59716,438,124,562,417,116,533,제주특별자치도 제주시 용강동 산 14-2,제주시,381,2,126.596825,33.42968499999999
1358,한라생태숲,33.429809999999996,126.59648999999999,3477,201,3678,3393,198,3591,제주특별자치도 제주시 용강동 산 14-3,제주시,381,2,126.596825,33.42968499999999
1359,제주도립미술관입구,33.45454,126.4871,113,77,190,112,72,184,제주특별자치도 제주시 노형동 286-3,제주시,382,2,126.48715999999999,33.454595
1360,제주도립미술관입구,33.45465,126.48722,2440,1394,3834,2303,1325,3628,제주특별자치도 제주시 연동 2477,제주시,382,2,126.48715999999999,33.454595
1363,도깨비공원,33.46553,126.69268999999998,280,6,286,275,6,281,제주특별자치도 제주시 조천읍 선흘리 4052-3,제주시,693,4,126.69268999999998,33.46553
1364,제주삼다수,33.4214,126.67663999999999,49,13,62,47,13,60,제주특별자치도 제주시 조천읍 교래리 산 34-13,제주시,383,2,126.67668499999999,33.421504999999996
1365,제주삼다수,33.42161,126.67673,371,17,388,365,16,381,제주특별자치도 제주시 조천읍 교래리 산 34-3,제주시,383,2,126.67668499999999,33.421504999999996
1366,사려니숲길,33.42304,126.62643999999999,1064,306,1370,872,296,1168,제주특별자치도 제주시 봉개동 산 78-1,제주시,384,2,126.62611999999999,33.42306
1367,사려니숲길,33.42308,126.6258,1595,565,2160,1529,545,2074,제주특별자치도 제주시 봉개동 산 78-1,제주시,384,2,126.62611999999999,33.42306
1369,저지리알못,33.33589,126.26369,1,1,2,1,1,2,제주특별자치도 제주시 한경면 저지리 3258,제주시,694,4,126.26369,33.33589
1370,방림원,33.336890000000004,126.26733999999999,122,66,188,119,65,184,제주특별자치도 제주시 한경면 저지리 2120-200,제주시,385,2,126.26732999999999,33.336960000000005
1371,방림원,33.33703,126.26732,142,101,243,133,100,233,제주특별자치도 제주시 한경면 저지리 2120-33,제주시,385,2,126.26732999999999,33.336960000000005
1372,저지리신흥동,33.33855,126.26396000000001,68,12,80,68,12,80,제주특별자치도 제주시 한경면 저지리 2114-23,제주시,386,2,126.26406,33.338589999999996
1373,신흥동,33.33863,126.26416,169,30,199,167,29,196,제주특별자치도 제주시 한경면 저지리 2114-23,제주시,386,2,126.26406,33.338589999999996
1374,용수리마을회관,33.32529,126.16883999999999,181,21,202,181,20,201,제주특별자치도 제주시 한경면 용수리 3445-7,제주시,387,2,126.16878999999999,33.32527
1375,주구동산,33.32282,126.17026000000001,65,13,78,64,8,72,제주특별자치도 제주시 한경면 용수리 4719-1,제주시,388,2,126.17020500000001,33.322805
1377,별빛누리공원/난타공연장,33.44531,126.54847,1561,281,1842,1490,265,1755,제주특별자치도 제주시 오등동 10-34,제주시,389,2,126.54839000000001,33.445375
1378,탐라교육원,33.42587,126.53277,469,7,476,466,7,473,제주특별자치도 제주시 오라이동 산 100,제주시,695,4,126.53277,33.42587
1379,관음사등산로입구,33.42245,126.54977,86,53,139,81,52,133,제주특별자치도 제주시 오등동 산 180-2,제주시,390,2,126.5497,33.422395
1380,관음사등산로입구,33.422340000000005,126.54963000000001,79,17,96,77,16,93,제주특별자치도 제주시 오등동 산 180-2,제주시,390,2,126.5497,33.422395
1381,삼담우체국,33.50196,126.51279,94,2,96,94,2,96,제주특별자치도 제주시 용담일동 2830,제주시,391,2,126.51291499999999,33.502245
1382,미래컨벤션센터,33.506640000000004,126.51475,1436,6,1442,1433,5,1438,제주특별자치도 제주시 용담일동 2583,제주시,392,2,126.514785,33.506625
1383,삼도119센터,33.51449,126.51778,608,132,740,601,127,728,제주특별자치도 제주시 용담일동 2578,제주시,393,2,126.51783499999999,33.51453
1384,이화아파트,33.51814,126.53991,1895,99,1994,1881,91,1972,제주특별자치도 제주시 건입동 711,제주시,394,2,126.53988000000001,33.518209999999996
1385,사라봉경로당입구,33.51615,126.53853000000001,845,51,896,842,51,893,제주특별자치도 제주시 건입동 711,제주시,395,2,126.53842,33.51587000000001
1386,제주해변공연장,33.51746,126.52252,9230,673,9903,9105,650,9755,제주특별자치도 제주시 삼도이동 1192-1,제주시,396,2,126.52249499999999,33.51738
1387,사라봉경로당입구,33.51559,126.53831000000001,3658,40,3698,3633,39,3672,제주특별자치도 제주시 건입동 1047-1,제주시,395,2,126.53842,33.51587000000001
1388,이화아파트,33.51828,126.53985,3109,93,3202,3055,88,3143,제주특별자치도 제주시 건입동 711,제주시,394,2,126.53988000000001,33.518209999999996
1389,제주해변공연장,33.5173,126.52247,3047,295,3342,2997,281,3278,제주특별자치도 제주시 삼도이동 1192-2,제주시,396,2,126.52249499999999,33.51738
1390,삼도119센터,33.51457,126.51789,402,145,547,396,140,536,제주특별자치도 제주시 삼도이동 1227-1,제주시,393,2,126.51783499999999,33.51453
1391,미래컨벤션센터,33.506609999999995,126.51482,1233,15,1248,1223,15,1238,제주특별자치도 제주시 용담일동 2583,제주시,392,2,126.514785,33.506625
1392,화북휴먼시아,33.51717,126.57382,4825,33,4858,4795,32,4827,제주특별자치도 제주시 화북일동 1027,제주시,80,3,126.5587575,33.5094175
1393,화북휴먼시아,33.51737,126.57468,38139,194,38333,37845,193,38038,제주특별자치도 제주시 화북일동 29-9,제주시,80,3,126.5587575,33.5094175
1394,축산진흥원입구,33.446909999999995,126.48755,1134,75,1209,1080,68,1148,제주특별자치도 제주시 노형동 293-17,제주시,397,2,126.487495,33.446884999999995
1395,축산진흥원입구,33.44686,126.48743999999999,84,18,102,83,18,101,제주특별자치도 제주시 노형동 293-17,제주시,397,2,126.487495,33.446884999999995
1396,화북공업지역입구,33.51173,126.56453,800,1,801,797,1,798,제주특별자치도 제주시 화북이동 3713-7,제주시,696,4,126.56453,33.51173
1397,구산마을,33.483290000000004,126.53801000000001,6841,91,6932,6750,84,6834,제주특별자치도 제주시 아라일동 2612-11,제주시,398,2,126.53805,33.483215
1398,구산마을,33.48314,126.53809,1331,2,1333,1312,2,1314,제주특별자치도 제주시 아라일동 2408-9,제주시,398,2,126.53805,33.483215
1400,황세왓동산,33.49313,126.56713,36,1,37,36,1,37,제주특별자치도 제주시 영평동 1288-3,제주시,697,4,126.56713,33.49313
1407,웃드르빛센터,33.302440000000004,126.25875,13,12,25,12,12,24,제주특별자치도 제주시 한경면 청수리 147-6,제주시,698,4,126.25875,33.302440000000004
1409,산양리감귤선과장,33.30303,126.23761,5,2,7,5,2,7,제주특별자치도 제주시 한경면 낙천리 532,제주시,399,2,126.237685,33.303020000000004
1410,산양리감귤선과장,33.30301,126.23776000000001,82,2,84,82,2,84,제주특별자치도 제주시 한경면 낙천리 531-2,제주시,399,2,126.237685,33.303020000000004
1413,일성콘도미니엄,33.3851,126.2215,117,70,187,111,67,178,제주특별자치도 제주시 한림읍 금능리 2316,제주시,400,2,126.22159500000001,33.385045000000005
1414,일성콘도미니엄,33.38499,126.22169,478,117,595,454,104,558,제주특별자치도 제주시 한림읍 금능리 1869-1,제주시,400,2,126.22159500000001,33.385045000000005
1415,수원주유소,33.42371,126.26651000000001,714,45,759,698,44,742,제주특별자치도 제주시 한림읍 수원리 1027-7,제주시,401,2,126.26663,33.42372
1416,수원주유소,33.42373,126.26675,1411,66,1477,1380,63,1443,제주특별자치도 제주시 한림읍 수원리 826-20,제주시,401,2,126.26663,33.42372
1417,봉성리사무소,33.42219,126.31295,142,4,146,140,4,144,제주특별자치도 제주시 애월읍 봉성리 3808-14,제주시,402,2,126.312825,33.42219
1418,봉성리사무소,33.42219,126.3127,95,3,98,95,3,98,제주특별자치도 제주시 애월읍 봉성리 3808-6,제주시,402,2,126.312825,33.42219
1419,어음1리입구,33.41838,126.32665,7,1,8,7,1,8,제주특별자치도 제주시 애월읍 봉성리 1747-2,제주시,403,2,126.326635,33.418400000000005
1420,어음1리입구,33.418420000000005,126.32661999999999,146,4,150,145,4,149,제주특별자치도 제주시 애월읍 봉성리 1747-1,제주시,403,2,126.326635,33.418400000000005
1421,삼남내,33.47071,126.77633,70,9,79,70,9,79,제주특별자치도 제주시 구좌읍 송당리 1571-21,제주시,36,1,126.68651375,33.4751675
1422,삼남내,33.470620000000004,126.77611,295,46,341,293,44,337,제주특별자치도 제주시 구좌읍 송당리 2791,제주시,36,1,126.68651375,33.4751675
1423,송당물혹,33.47088,126.78652,156,53,209,154,52,206,제주특별자치도 제주시 구좌읍 송당리 1389-27,제주시,53,1,126.58769124999998,33.44820375
1424,송당물혹,33.47098,126.78593000000001,146,59,205,144,57,201,제주특별자치도 제주시 구좌읍 송당리 1467-5,제주시,53,1,126.58769124999998,33.44820375
1425,알송당,33.483779999999996,126.78735,20,6,26,20,6,26,제주특별자치도 제주시 구좌읍 송당리 2774,제주시,404,2,126.787295,33.483765
1426,알송당,33.48375,126.78724,38,3,41,37,2,39,제주특별자치도 제주시 구좌읍 송당리 521-6,제주시,404,2,126.787295,33.483765
1427,대림동,33.4992,126.75525,2,2,4,2,2,4,제주특별자치도 제주시 구좌읍 덕천리 776,제주시,405,2,126.75511,33.4991
1428,대림동,33.499,126.75497,1,1,2,1,1,2,제주특별자치도 제주시 구좌읍 덕천리 1796,제주시,405,2,126.75511,33.4991
1429,멍중내,33.5007,126.6886,1,2,3,1,2,3,제주특별자치도 제주시 조천읍 선흘리 3138-2,제주시,18,3,126.57508249999998,33.493767500000004
1432,제주국제자유도시개발센터,33.45283,126.57125,379,6,385,356,6,362,제주특별자치도 제주시 영평동 2184,제주시,54,1,126.51919875,33.456756250000005
1433,제주국제자유도시개발센터,33.452729999999995,126.57146000000002,3963,137,4100,3934,135,4069,제주특별자치도 제주시 영평동 2273,제주시,54,1,126.51919875,33.456756250000005
1434,제주국제대학교,33.44141,126.57216000000001,239,5,244,236,5,241,제주특별자치도 제주시 영평동 2235,제주시,406,2,126.57229500000001,33.441365000000005
1437,가물개공원,33.52455,126.58482,449,7,456,447,7,454,제주특별자치도 제주시 삼양이동 2182-1,제주시,699,4,126.58482,33.52455
1439,삼양3동,33.524680000000004,126.5797,153,5,158,153,5,158,제주특별자치도 제주시 삼양삼동 2582-1,제주시,700,4,126.5797,33.524680000000004
1440,하귀휴먼시아입구,33.48572,126.41545,5943,52,5995,5888,50,5938,제주특별자치도 제주시 애월읍 하귀1리 562,제주시,27,1,126.40820142857142,33.47559285714285
1441,하귀휴먼시아1단지,33.48368,126.41618000000001,6723,53,6776,6647,51,6698,제주특별자치도 제주시 애월읍 하귀1리 562,제주시,407,2,126.416025,33.48353
1442,하귀휴먼시아2단지앞,33.4813,126.41485,2836,28,2864,2807,26,2833,제주특별자치도 제주시 애월읍 하귀1리 562,제주시,408,2,126.414465,33.48159
1443,하귀휴먼시아입구,33.48573,126.41515,511,10,521,502,10,512,제주특별자치도 제주시 애월읍 하귀1리 137-3,제주시,27,1,126.40820142857142,33.47559285714285
1444,하귀휴먼시아1단지,33.48338,126.41587,1440,9,1449,1418,9,1427,제주특별자치도 제주시 애월읍 하귀1리 562,제주시,407,2,126.416025,33.48353
1446,서문사거리,33.51079,126.5198,19,4,23,19,4,23,제주특별자치도 제주시 용담일동 2578,제주시,121,2,126.51956,33.51126
1447,라마다프라자제주호텔,33.518229999999996,126.51848000000001,579,271,850,570,253,823,제주특별자치도 제주시 삼도이동 1222-45,제주시,409,2,126.51852000000001,33.518305
1448,라마다프라자제주호텔,33.51838,126.51856000000001,2362,801,3163,2349,752,3101,제주특별자치도 제주시 삼도이동 1264,제주시,409,2,126.51852000000001,33.518305
1449,카카오,33.45126,126.57122,222,87,309,219,84,303,제주특별자치도 제주시 영평동 2180,제주시,54,1,126.51919875,33.456756250000005
1450,디지털융합센터,33.4513,126.57146000000002,2722,500,3222,2699,494,3193,제주특별자치도 제주시 영평동 2273,제주시,54,1,126.51919875,33.456756250000005
1451,도평입구,33.4795,126.46503999999999,499,77,576,486,75,561,제주특별자치도 제주시 노형동 3766,제주시,410,2,126.46516,33.479479999999995
1452,도평입구,33.479459999999996,126.46528,367,72,439,364,66,430,제주특별자치도 제주시 노형동 3129-6,제주시,410,2,126.46516,33.479479999999995
1453,부민장례식장,33.48076,126.52241000000001,2088,19,2107,2062,19,2081,제주특별자치도 제주시 도남동 1237-1,제주시,411,2,126.522375,33.48084
1454,부민장례식장,33.480920000000005,126.52233999999999,1912,23,1935,1875,23,1898,제주특별자치도 제주시 도남동 1237-1,제주시,411,2,126.522375,33.48084
1455,한일베라체,33.4948,126.54836,4068,47,4115,4024,45,4069,제주특별자치도 제주시 이도이동 150-1,제주시,412,2,126.548455,33.494485
1456,한일베라체,33.494170000000004,126.54855,5614,96,5710,5593,96,5689,제주특별자치도 제주시 이도이동 1956,제주시,412,2,126.548455,33.494485
1457,거로사거리,33.50765,126.55701,211,7,218,210,6,216,제주특별자치도 제주시 화북이동 5128-2,제주시,413,2,126.557005,33.507270000000005
1458,거로사거리,33.507,126.55526,816,34,850,812,33,845,제주특별자치도 제주시 건입동 9-1,제주시,414,2,126.55538,33.50739
1459,거로사거리,33.50778,126.5555,393,22,415,390,22,412,제주특별자치도 제주시 화북이동 5758,제주시,414,2,126.55538,33.50739
1460,거로사거리,33.50689000000001,126.557,1448,78,1526,1433,75,1508,제주특별자치도 제주시 화북이동 5755-1,제주시,413,2,126.557005,33.507270000000005
1461,신광사거리,33.49384000000001,126.49333,396,99,495,388,91,479,제주특별자치도 제주시 연동 1928-4,제주시,32,2,126.4152257142857,33.42904285714286
1462,연동365의원,33.481759999999994,126.4912,5677,162,5839,5614,155,5769,제주특별자치도 제주시 연동 1546,제주시,47,3,126.44603000000001,33.468295000000005
1463,메종글래드제주,33.48608,126.4869,3747,289,4036,3671,268,3939,제주특별자치도 제주시 연동 252-14,제주시,209,2,126.48716999999999,33.485969999999995
1464,연동365의원,33.48196,126.49231,7853,316,8169,7718,306,8024,제주특별자치도 제주시 연동 1373-3,제주시,47,3,126.44603000000001,33.468295000000005
1465,한국BMI,33.44907,126.57298999999999,3635,33,3668,3624,33,3657,제주특별자치도 제주시 영평동 2273,제주시,701,4,126.57298999999999,33.44907
1467,첨단꿈에그린3단지아파트,33.4505,126.57721000000001,58,2,60,58,1,59,제주특별자치도 제주시 월평동 747,제주시,702,4,126.57721000000001,33.4505
1469,구산마을입구,33.4844,126.53505,4253,39,4292,4190,38,4228,제주특별자치도 제주시 아라일동 2567,제주시,5,3,126.52680249999999,33.47999624999999
1470,구산마을입구,33.483909999999995,126.53639,1020,11,1031,999,11,1010,제주특별자치도 제주시 아라일동 2602-4,제주시,5,3,126.52680249999999,33.47999624999999
1471,제주여자중고등학교제주지방해양경찰청,33.48516,126.54182,11153,147,11300,10996,147,11143,제주특별자치도 제주시 아라일동 2419-9,제주시,415,2,126.541765,33.485079999999996
1472,제주여자중고등학교,33.485,126.54171000000001,3687,16,3703,3635,16,3651,제주특별자치도 제주시 아라일동 2370-3,제주시,415,2,126.541765,33.485079999999996
1474,하도리서문동,33.52722,126.8814,102,25,127,101,25,126,제주특별자치도 제주시 구좌읍 하도리 1931-3,제주시,703,4,126.8814,33.52722
1475,선진동,33.45753,126.70321000000001,1413,259,1672,1384,252,1636,제주특별자치도 제주시 조천읍 선흘리 1938-10,제주시,241,2,126.70306500000001,33.458164999999994
1477,신연동,33.31624,126.2495,2,3,5,2,3,5,제주특별자치도 제주시 한경면 청수리 604-8,제주시,704,4,126.2495,33.31624
1479,가시나물,33.47252,126.56995,6150,37,6187,6001,37,6038,제주특별자치도 제주시 영평동 1924-4,제주시,0,3,126.528805,33.50356375
1480,가시나물,33.471090000000004,126.57014,842,2,844,819,2,821,제주특별자치도 제주시 영평동 2010-2,제주시,0,3,126.528805,33.50356375
1481,달샘마을,33.474509999999995,126.57015,2161,15,2176,2109,15,2124,제주특별자치도 제주시 월평동 1373-8,제주시,416,2,126.570055,33.474464999999995
1482,달샘마을,33.47442,126.56996000000001,664,14,678,654,14,668,제주특별자치도 제주시 월평동 1379,제주시,416,2,126.570055,33.474464999999995
1483,제주삼양동유적,33.5232,126.58641999999999,4548,142,4690,4469,124,4593,제주특별자치도 제주시 삼양이동 2124-2,제주시,417,2,126.58658499999999,33.523070000000004
1484,제주삼양동유적,33.52294000000001,126.58675,292,2,294,291,2,293,제주특별자치도 제주시 삼양이동 2184-1,제주시,417,2,126.58658499999999,33.523070000000004
1485,오라동주민센터,33.4952,126.51258999999999,62,3,65,62,3,65,제주특별자치도 제주시 오라일동 1246-6,제주시,705,4,126.51258999999999,33.4952
1486,오라1동복지회관,33.49392,126.51638999999999,84,2,86,84,2,86,제주특별자치도 제주시 오라일동 1287-3,제주시,27,2,126.40820142857142,33.47559285714285
1487,해병대제9여단,33.47729,126.49973999999999,339,7,346,336,6,342,제주특별자치도 제주시 연동 489-16,제주시,418,2,126.49974499999999,33.4774
1488,해병대제9여단,33.477509999999995,126.49975,261,16,277,260,16,276,제주특별자치도 제주시 연동 489-9,제주시,418,2,126.49974499999999,33.4774
1489,방선문빌리지,33.47766,126.5368,1177,1,1178,1166,1,1167,제주특별자치도 제주시 아라일동 2807-4,제주시,419,2,126.536575,33.477665
1490,방선문빌리지,33.47767,126.53635,2386,29,2415,2356,28,2384,제주특별자치도 제주시 아라일동 2807-1,제주시,419,2,126.536575,33.477665
1491,함덕농협주유소,33.5365,126.67492,394,5,399,390,5,395,제주특별자치도 제주시 조천읍 함덕리 72-141,제주시,706,4,126.67492,33.5365
1492,신사동(종점),33.52537,126.67791000000001,8925,210,9135,8787,202,8989,제주특별자치도 제주시 조천읍 함덕리 317-12,제주시,420,2,126.6779,33.525665000000004
1493,신산마을입구,33.479409999999994,126.45786000000001,389,3,392,385,3,388,제주특별자치도 제주시 도평동 19-7,제주시,41,3,126.41387999999999,33.42416142857142
1494,신산마을입구,33.47922,126.45885,1376,9,1385,1363,9,1372,제주특별자치도 제주시 도평동 15-7,제주시,41,3,126.41387999999999,33.42416142857142
1495,한라도서관입구,33.480979999999995,126.51636,1016,12,1028,999,12,1011,제주특별자치도 제주시 오라이동 1567-3,제주시,63,1,126.5741,33.48683
1496,한라도서관입구,33.481190000000005,126.51493,1094,20,1114,1069,20,1089,제주특별자치도 제주시 오라이동 1550-5,제주시,63,1,126.5741,33.48683
1497,오등동입구,33.48123,126.52933999999999,2926,25,2951,2900,25,2925,제주특별자치도 제주시 도남동 439-6,제주시,50,3,126.62230625,33.503832499999994
1498,오등동입구,33.48141,126.53056000000001,2344,7,2351,2322,7,2329,제주특별자치도 제주시 도남동 214-2,제주시,50,3,126.62230625,33.503832499999994
1499,제주영지학교,33.489290000000004,126.54267,4103,24,4127,4040,24,4064,제주특별자치도 제주시 이도이동 695-3,제주시,421,2,126.54278500000001,33.48924
1500,제주영지학교,33.48919,126.5429,2958,7,2965,2936,7,2943,제주특별자치도 제주시 이도이동 695-3,제주시,421,2,126.54278500000001,33.48924
1501,탐라중학교,33.49075,126.5453,2620,11,2631,2514,10,2524,제주특별자치도 제주시 아라이동 1262-6,제주시,422,2,126.54541,33.490935
1502,탐라중학교,33.49112,126.54552,5740,53,5793,5671,53,5724,제주특별자치도 제주시 아라이동 1262-6,제주시,422,2,126.54541,33.490935
1503,한마음병원,33.496,126.54735,5181,67,5248,5141,66,5207,제주특별자치도 제주시 이도이동 212-5,제주시,423,2,126.547275,33.49597
1504,한마음병원,33.495940000000004,126.5472,5789,66,5855,5760,64,5824,제주특별자치도 제주시 이도이동 256-4,제주시,423,2,126.547275,33.49597
1505,돌선밭,33.45415,126.42516,345,5,350,343,5,348,제주특별자치도 제주시 애월읍 광령리 4059-2,제주시,424,2,126.42516499999999,33.45406
1506,돌선밭,33.45397,126.42517,59,2,61,55,2,57,제주특별자치도 제주시 애월읍 광령리 4059-1,제주시,424,2,126.42516499999999,33.45406
1507,던덕모롤,33.462309999999995,126.40817,192,2,194,190,2,192,제주특별자치도 제주시 애월읍 상귀리 698-2,제주시,425,2,126.408275,33.462355
1508,던덕모롤,33.4624,126.40838000000001,261,2,263,254,2,256,제주특별자치도 제주시 애월읍 고성리 1412-1,제주시,425,2,126.408275,33.462355
1509,삼담우체국,33.50253,126.51303999999999,690,15,705,684,14,698,제주특별자치도 제주시 용담일동 2830,제주시,391,2,126.51291499999999,33.502245
1510,용해로,33.51522,126.50258000000001,669,110,779,658,109,767,제주특별자치도 제주시 용담삼동 1034-4,제주시,426,2,126.50242,33.515485
1511,용해로,33.51575,126.50226,295,183,478,284,175,459,제주특별자치도 제주시 용담삼동 1034-26,제주시,426,2,126.50242,33.515485
1512,도두동,33.50287,126.4662,499,78,577,493,77,570,제주특별자치도 제주시 도두일동 2531-1,제주시,156,2,126.46638000000002,33.502725
1513,우령서로입구,33.49155,126.4264,559,4,563,555,4,559,제주특별자치도 제주시 외도일동 648-1,제주시,427,2,126.42630500000001,33.49167
1514,우령서로입구,33.49179,126.42621000000001,2892,15,2907,2851,13,2864,제주특별자치도 제주시 외도일동 648-1,제주시,427,2,126.42630500000001,33.49167
1515,함덕리(4구),33.53929,126.67421999999999,506,91,597,499,90,589,제주특별자치도 제주시 조천읍 함덕리 4150-3,제주시,55,1,126.57922571428571,33.512727142857145
1517,하귀농협장례식장,33.47249,126.42647,176,3,179,173,3,176,제주특별자치도 제주시 애월읍 광령리 3674-4,제주시,707,4,126.42647,33.47249
1518,하귀1리,33.47222,126.41909,274,8,282,270,8,278,제주특별자치도 제주시 애월읍 하귀1리 909-1,제주시,70,3,126.50214,33.4967575
1519,하귀1리,33.47241,126.41769,16,3,19,16,3,19,제주특별자치도 제주시 애월읍 하귀1리 1130-4,제주시,70,3,126.50214,33.4967575
1520,애조로광령1리입구,33.47137,126.43562,337,11,348,327,11,338,제주특별자치도 제주시 애월읍 광령리 1751-1,제주시,46,3,126.62861222222222,33.44766888888889
1521,애조로광령1리입구,33.47213,126.43417,26,6,32,25,6,31,제주특별자치도 제주시 애월읍 광령리 1695-6,제주시,46,3,126.62861222222222,33.44766888888889
1522,사라마을,33.46929,126.44086999999999,405,11,416,405,11,416,제주특별자치도 제주시 애월읍 광령리 1872-2,제주시,28,3,126.48837428571427,33.499021428571425
1523,사라마을,33.46986,126.44001000000002,154,1,155,152,1,153,제주특별자치도 제주시 애월읍 광령리 1872-2,제주시,28,3,126.48837428571427,33.499021428571425
1525,청소년수련원,33.45456,126.61873999999999,252,12,264,251,12,263,제주특별자치도 제주시 봉개동 2736,제주시,428,2,126.618975,33.454405
1526,4.3평화공원,33.451190000000004,126.62162,12,6,18,10,6,16,제주특별자치도 제주시 봉개동 산 78-30,제주시,429,2,126.62176,33.45111
1527,4.3평화공원,33.451029999999996,126.6219,485,142,627,478,139,617,제주특별자치도 제주시 봉개동 산 53-1,제주시,429,2,126.62176,33.45111
1528,청소년수련원,33.45425,126.61921000000001,383,66,449,374,62,436,제주특별자치도 제주시 봉개동 234-158,제주시,428,2,126.618975,33.454405
1529,4.3평화공원입구,33.453109999999995,126.62008999999999,5,3,8,5,3,8,제주특별자치도 제주시 봉개동 237-2,제주시,708,4,126.62008999999999,33.453109999999995
1530,교래자연휴양림,33.443090000000005,126.66628999999999,12,5,17,11,5,16,제주특별자치도 제주시 조천읍 교래리 산 52-1,제주시,430,2,126.66617,33.44341
1531,교래자연휴양림,33.44373,126.66605,1043,601,1644,856,522,1378,제주특별자치도 제주시 조천읍 교래리 산 52-1,제주시,430,2,126.66617,33.44341
1532,S중앙병원,33.49285,126.47166999999999,4855,220,5075,4822,217,5039,제주특별자치도 제주시 도두일동 2280-3,제주시,3,1,126.46005749999999,33.49101875
1533,S중앙병원,33.49293,126.47182,3215,104,3319,3177,100,3277,제주특별자치도 제주시 도두일동 2280-3,제주시,3,1,126.46005749999999,33.49101875
1534,새마을금고연수원,33.41341,126.39676000000001,143,26,169,139,25,164,제주특별자치도 제주시 애월읍 유수암리 3256,제주시,431,2,126.396965,33.413129999999995
1535,새마을금고연수원,33.41285,126.39716999999999,1053,91,1144,1010,82,1092,제주특별자치도 제주시 애월읍 유수암리 3257,제주시,431,2,126.396965,33.413129999999995
1537,김녕미로공원,33.53613,126.77247,81,144,225,77,141,218,제주특별자치도 제주시 구좌읍 김녕리 산 38-1,제주시,432,2,126.77248,33.536085
1538,김녕미로공원,33.53604,126.77248999999999,1305,1434,2739,1246,1402,2648,제주특별자치도 제주시 구좌읍 김녕리 산 38-1,제주시,432,2,126.77248,33.536085
1539,"다랑쉬오름입구(남),손지오름",33.46031,126.81711999999999,317,351,668,311,347,658,제주특별자치도 제주시 구좌읍 세화리 3593-18,제주시,433,2,126.817125,33.460274999999996
1540,"다랑쉬오름입구(남),손지오름",33.46024,126.81713,371,423,794,357,408,765,제주특별자치도 제주시 구좌읍 송당리 1-11,제주시,433,2,126.817125,33.460274999999996
1541,메이즈랜드,33.49087,126.79907,190,202,392,186,196,382,제주특별자치도 제주시 구좌읍 한동리 4848,제주시,56,1,126.64144142857143,33.49493857142857
1542,근로복지공단,33.49986,126.54453999999998,1932,14,1946,1909,14,1923,제주특별자치도 제주시 일도이동 115,제주시,434,2,126.54445,33.49984499999999
1543,근로복지공단,33.499829999999996,126.54436000000001,5602,41,5643,5548,41,5589,제주특별자치도 제주시 이도이동 443,제주시,434,2,126.54445,33.49984499999999
1544,화북휴먼시아정문,33.51597,126.57632,6615,46,6661,6544,46,6590,제주특별자치도 제주시 화북일동 1002-1,제주시,435,2,126.57644499999999,33.51593
1545,성수동,33.48095,126.4128,82,3,85,82,3,85,제주특별자치도 제주시 애월읍 하귀1리 215-8,제주시,436,2,126.41277,33.480869999999996
1546,성수동,33.48079,126.41273999999999,540,10,550,535,10,545,제주특별자치도 제주시 애월읍 하귀1리 586,제주시,436,2,126.41277,33.480869999999996
1547,광평고치동산,33.4836,126.46373,607,9,616,604,9,613,제주특별자치도 제주시 노형동 2920-5,제주시,709,4,126.46373,33.4836
1549,대흘1리,33.49889,126.65166,26,8,34,25,8,33,제주특별자치도 제주시 조천읍 대흘리 2345-5,제주시,710,4,126.65166,33.49889
1551,멍중내,33.51123,126.6863,27,12,39,27,12,39,제주특별자치도 제주시 조천읍 선흘리 3687-5,제주시,18,3,126.57508249999998,33.493767500000004
1555,개법사,33.40442,126.33823000000001,63,1,64,63,1,64,제주특별자치도 제주시 애월읍 어음리 3902,제주시,711,4,126.33823000000001,33.40442
1556,두인빌라삼거리,33.42407,126.40409,167,2,169,165,2,167,제주특별자치도 제주시 애월읍 유수암리 1381-12,제주시,437,2,126.40410499999999,33.424085000000005
1557,두인빌라삼거리,33.4241,126.40411999999999,142,2,144,141,2,143,제주특별자치도 제주시 애월읍 유수암리 1381-6,제주시,437,2,126.40410499999999,33.424085000000005
1558,유수암리입구,33.44339,126.39103,7,4,11,7,4,11,제주특별자치도 제주시 애월읍 장전리 628-2,제주시,712,4,126.39103,33.44339
1560,웃거리,33.43942,126.40256000000001,75,3,78,75,3,78,제주특별자치도 제주시 애월읍 유수암리 1779-3,제주시,57,1,126.45485,33.47211857142857
1561,웃거리,33.439840000000004,126.40307,181,3,184,180,3,183,제주특별자치도 제주시 애월읍 유수암리 3234,제주시,57,1,126.45485,33.47211857142857
1562,전국환경감시협회,33.462270000000004,126.66095,204,8,212,182,8,190,제주특별자치도 제주시 조천읍 와흘리 산 13-6,제주시,713,4,126.66095,33.462270000000004
1564,제주시외버스터미널,33.49946,126.51478999999999,165061,11955,177016,162692,11434,174126,제주특별자치도 제주시 오라일동 2455-16,제주시,6,1,126.468044,33.475798999999995
1565,시외버스출발지(가상정류소),33.49946,126.51478,116638,10105,126743,114107,9532,123639,제주특별자치도 제주시 오라일동 2441-4,제주시,6,1,126.468044,33.475798999999995
1566,금능해수욕장,33.389540000000004,126.23558999999999,730,496,1226,669,471,1140,제주특별자치도 제주시 한림읍 협재리 2689-2,제주시,438,2,126.23562,33.389505
1567,금능해수욕장,33.38947,126.23565,2051,800,2851,1915,770,2685,제주특별자치도 제주시 한림읍 협재리 2689-2,제주시,438,2,126.23562,33.389505
1568,당동산,33.46001,126.4334,206,5,211,203,5,208,제주특별자치도 제주시 애월읍 광령리 2150-4,제주시,439,2,126.43350000000001,33.459954999999994
1569,제주자동차검사정비사업조합,33.510290000000005,126.56191000000001,1271,2,1273,1259,2,1261,제주특별자치도 제주시 화북이동 3583-5,제주시,714,4,126.56191000000001,33.510290000000005
1570,거로마을,33.50983,126.56043000000001,2158,14,2172,2138,14,2152,제주특별자치도 제주시 화북이동 3467-1,제주시,715,4,126.56043000000001,33.50983
1571,제주국제대학교,33.441320000000005,126.57243000000001,3329,88,3417,3279,84,3363,제주특별자치도 제주시 영평동 2235,제주시,406,2,126.57229500000001,33.441365000000005
1572,제주절물자연휴양림,33.4407,126.63025,7094,697,7791,6924,637,7561,제주특별자치도 제주시 봉개동 산 65-1,제주시,380,2,126.63022,33.440479999999994
1573,노루생태관찰원,33.44485,126.62753000000001,432,95,527,426,85,511,제주특별자치도 제주시 봉개동 산 53-18,제주시,716,4,126.62753000000001,33.44485
1575,영등물,33.55556,126.73613999999999,294,112,406,288,109,397,제주특별자치도 제주시 구좌읍 김녕리 4322,제주시,440,2,126.73616,33.555440000000004
1576,금산목,33.55366,126.80524,1135,193,1328,1111,185,1296,제주특별자치도 제주시 구좌읍 행원리 1351-2,제주시,441,2,126.80488,33.55344
1577,삼양3동포구,33.52717,126.57623999999998,912,18,930,906,18,924,제주특별자치도 제주시 삼양삼동 2682,제주시,717,4,126.57623999999998,33.52717
1578,별빛누리공원/난타공연장,33.445440000000005,126.54831000000001,325,62,387,301,58,359,제주특별자치도 제주시 오등동 10-1,제주시,389,2,126.54839000000001,33.445375
1579,제주국제공항(600번),33.50577,126.49252,9129,25270,34399,9129,25270,34399,제주특별자치도 제주시 용담이동 1984-5,제주시,28,1,126.48837428571427,33.499021428571425
1580,전경대입구,33.50679,126.87714,72,4,76,71,3,74,제주특별자치도 제주시 구좌읍 상도리 산 7-2,제주시,442,2,126.87738999999999,33.5068
1581,전경대입구,33.506809999999994,126.87763999999999,539,11,550,534,11,545,제주특별자치도 제주시 구좌읍 하도리 산 76,제주시,442,2,126.87738999999999,33.5068
1582,동부위생처리장입구,33.43631,126.69538,6,3,9,6,2,8,제주특별자치도 제주시 조천읍 교래리 산 39,제주시,443,2,126.695425,33.43638
1583,동부위생처리장입구,33.43645,126.69547,132,6,138,132,6,138,제주특별자치도 제주시 조천읍 교래리 산 39-3,제주시,443,2,126.695425,33.43638
1584,셰프라인월드,33.43468,126.73161999999999,9,8,17,8,8,16,제주특별자치도 제주시 구좌읍 송당리 2635-1,제주시,444,2,126.73201999999999,33.434785000000005
1585,셰프라인월드,33.43489,126.73241999999999,45,5,50,44,5,49,제주특별자치도 제주시 구좌읍 송당리 2635-3,제주시,444,2,126.73201999999999,33.434785000000005
1586,환경시설관리소,33.480340000000005,126.62541999999999,74,32,106,72,32,104,제주특별자치도 제주시 회천동 424-10,제주시,445,2,126.62557,33.47993
1587,환경시설관리소,33.47952,126.62572,32,14,46,31,14,45,제주특별자치도 제주시 회천동 422-7,제주시,445,2,126.62557,33.47993
1588,당동산,33.4599,126.4336,692,14,706,688,14,702,제주특별자치도 제주시 애월읍 광령리 2151-1,제주시,439,2,126.43350000000001,33.459954999999994
1589,번대동,33.477740000000004,126.39225,2528,142,2670,2500,131,2631,제주특별자치도 제주시 애월읍 하귀2리 2966-5,제주시,58,1,126.44750285714285,33.48175428571429
1590,청용사,33.44166,126.33073999999999,446,12,458,442,12,454,제주특별자치도 제주시 애월읍 납읍리 1827-7,제주시,446,2,126.33077999999999,33.441784999999996
1591,청용사,33.44191,126.33081999999999,211,2,213,209,2,211,제주특별자치도 제주시 애월읍 납읍리 1781-1,제주시,446,2,126.33077999999999,33.441784999999996
1592,가원,33.49866,126.5629,38,1,39,37,1,38,제주특별자치도 제주시 화북이동 3089-1,제주시,718,4,126.5629,33.49866
1593,다희연,33.48723,126.70605,27,6,33,26,6,32,제주특별자치도 제주시 조천읍 선흘리 1672-2,제주시,447,2,126.70619,33.487354999999994
1594,다희연,33.48748,126.70633000000001,104,104,208,101,104,205,제주특별자치도 제주시 조천읍 선흘리 1672,제주시,447,2,126.70619,33.487354999999994
1595,비자림로교래입구,33.419129999999996,126.61716000000001,482,568,1050,459,538,997,제주특별자치도 제주시 봉개동 산 78-1,제주시,51,1,126.5372542857143,33.463521428571426
1597,고상동,33.508590000000005,126.67321000000001,35,1,36,32,1,33,제주특별자치도 제주시 조천읍 대흘리 144,제주시,719,4,126.67321000000001,33.508590000000005
1600,서부신협유통영농조합,33.3356,126.26114,4,3,7,4,3,7,제주특별자치도 제주시 한경면 저지리 2095-1,제주시,448,2,126.261195,33.33553
1601,저지리,33.3267,126.25343000000001,20,4,24,20,4,24,제주특별자치도 제주시 한경면 저지리 1522-11,제주시,32,1,126.4152257142857,33.42904285714286
1602,청소년수련원,33.3776,126.23875,103,23,126,100,22,122,제주특별자치도 제주시 한림읍 협재리 2838,제주시,449,2,126.238785,33.37722
1603,청소년수련원,33.37684,126.23881999999999,50,9,59,48,9,57,제주특별자치도 제주시 한림읍 금능리 산 19-5,제주시,449,2,126.238785,33.37722
1604,금능농공단지입구,33.36258,126.24721000000001,2,4,6,2,4,6,제주특별자치도 제주시 한림읍 금능리 485-3,제주시,450,2,126.24728999999999,33.36262
1605,금능농공단지입구,33.36266,126.24736999999999,119,15,134,116,15,131,제주특별자치도 제주시 한림읍 금능리 485-6,제주시,450,2,126.24728999999999,33.36262
1606,금능농공단지,33.35913,126.24327,54,6,60,53,6,59,제주특별자치도 제주시 한림읍 금능리 407-7,제주시,451,2,126.24336500000001,33.35906000000001
1607,금능농공단지,33.35899000000001,126.24346000000001,348,23,371,341,23,364,제주특별자치도 제주시 한림읍 금능리 407-18,제주시,451,2,126.24336500000001,33.35906000000001
1608,더마파크,33.3571,126.24281,34,28,62,34,27,61,제주특별자치도 제주시 한림읍 금능리 2318,제주시,452,2,126.242925,33.357175
1609,더마파크,33.35725,126.24304,49,41,90,42,40,82,제주특별자치도 제주시 한림읍 금능리 409-2,제주시,452,2,126.242925,33.357175
1610,서부농업기술센터,33.35281,126.24745,30,5,35,30,5,35,제주특별자치도 제주시 한림읍 금능리 산 23-2,제주시,720,4,126.24745,33.35281
1612,제주유리의성,33.31413,126.27191,222,86,308,209,82,291,제주특별자치도 제주시 한경면 저지리 산 39-2,제주시,453,2,126.271985,33.313900000000004
1613,제주유리의성,33.31367,126.27206000000001,212,225,437,210,221,431,제주특별자치도 제주시 한경면 저지리 산 37-10,제주시,453,2,126.271985,33.313900000000004
1614,제주평화양로원,33.46524,126.61133999999998,1302,36,1338,1297,33,1330,제주특별자치도 제주시 봉개동 234-200,제주시,454,2,126.61122999999999,33.46537
1615,제주평화양로원,33.4655,126.61112,25,4,29,23,4,27,제주특별자치도 제주시 봉개동 275-39,제주시,454,2,126.61122999999999,33.46537
1616,안국사,33.4686,126.61119,419,16,435,416,16,432,제주특별자치도 제주시 봉개동 2736,제주시,455,2,126.611035,33.468785
1617,안국사,33.46897,126.61088000000001,10,2,12,7,1,8,제주특별자치도 제주시 봉개동 319,제주시,455,2,126.611035,33.468785
1619,방애왓,33.48123,126.60525,148,4,152,148,4,152,제주특별자치도 제주시 봉개동 685-18,제주시,721,4,126.60525,33.48123
1621,명도암,33.473859999999995,126.60987,23,2,25,22,2,24,제주특별자치도 제주시 봉개동 458-1,제주시,722,4,126.60987,33.473859999999995
1622,축산마을,33.44656,126.4859,381,28,409,370,28,398,제주특별자치도 제주시 노형동 315-6,제주시,723,4,126.4859,33.44656
1623,월정리용천동,33.55072,126.78275,55,53,108,51,52,103,제주특별자치도 제주시 구좌읍 월정리 1320-2,제주시,456,2,126.78238499999999,33.55066
1624,월정리용천동,33.5506,126.78201999999999,4814,2218,7032,4533,2092,6625,제주특별자치도 제주시 구좌읍 월정리 1320-1,제주시,456,2,126.78238499999999,33.55066
1626,애월하나로마트,33.46008,126.3213,2994,150,3144,2947,146,3093,제주특별자치도 제주시 애월읍 애월리 1400-7,제주시,457,2,126.32121,33.460044999999994
1627,애월하나로마트,33.46001,126.32112,387,15,402,383,13,396,제주특별자치도 제주시 애월읍 애월리 1378-5,제주시,457,2,126.32121,33.460044999999994
1628,붉은오름휴양림입구,33.402409999999996,126.68274,236,50,286,233,49,282,제주특별자치도 서귀포시 표선면 가시리 산 158-3,서귀포시,1,2,126.53914285714286,33.289225714285706
1629,붉은오름휴양림입구,33.403259999999996,126.68276999999999,589,115,704,565,108,673,제주특별자치도 서귀포시 표선면 가시리 산 158-5,서귀포시,1,2,126.53914285714286,33.289225714285706
1630,메이즈랜드,33.49068,126.79833,347,207,554,334,201,535,제주특별자치도 제주시 구좌읍 한동리 4458-1,제주시,56,1,126.64144142857143,33.49493857142857
1632,한림천주교회,33.417790000000004,126.26528,546,30,576,539,30,569,제주특별자치도 제주시 한림읍 한림리 1309-3,제주시,48,1,126.40944571428574,33.456941428571426
1636,롯데호텔,33.24872,126.41032,858,1378,2236,858,1378,2236,제주특별자치도 서귀포시 색달동 2812-4,서귀포시,33,1,126.48008142857144,33.25181428571429
1637,캐슬렉스골프클럽,33.33905,126.35627,157,28,185,150,27,177,제주특별자치도 서귀포시 안덕면 광평리 산 123-5,서귀포시,36,3,126.6409257142857,33.35606571428571
1638,캐슬렉스골프클럽,33.33735,126.35543,237,5,242,237,5,242,제주특별자치도 서귀포시 안덕면 광평리 349,서귀포시,36,3,126.6409257142857,33.35606571428571
1639,상창보건진료소,33.274640000000005,126.36294,1855,982,2837,1754,935,2689,제주특별자치도 서귀포시 안덕면 상창리 626-2,서귀포시,2,2,126.4046125,33.26323625
1640,상창보건진료소,33.27458,126.3628,2443,636,3079,2401,610,3011,제주특별자치도 서귀포시 안덕면 상창리 626-2,서귀포시,2,2,126.4046125,33.26323625
1641,우남동,33.264540000000004,126.3909,1234,246,1480,1199,233,1432,제주특별자치도 서귀포시 상예동 4999,서귀포시,3,2,126.45668714285715,33.255034285714295
1642,우남동,33.26432,126.39088999999998,2490,205,2695,2451,195,2646,제주특별자치도 서귀포시 상예동 4999,서귀포시,3,2,126.45668714285715,33.255034285714295
1643,소보리당입구,33.26419,126.38201000000001,32,8,40,31,7,38,제주특별자치도 서귀포시 상예동 4999,서귀포시,4,2,126.51396210526316,33.26277789473685
1644,예래사우나,33.264179999999996,126.38501000000001,519,105,624,497,93,590,제주특별자치도 서귀포시 상예동 2802-2,서귀포시,5,2,126.39661875,33.266799999999996
1645,중문관광단지입구,33.25593,126.41261999999999,10795,4132,14927,10261,3967,14228,제주특별자치도 서귀포시 색달동 3383,서귀포시,6,2,126.4122775,33.2481775
1646,중문관광단지입구,33.255790000000005,126.4126,2588,763,3351,2531,720,3251,제주특별자치도 서귀포시 색달동 2551-3,서귀포시,6,2,126.4122775,33.2481775
1647,예래입구,33.25869,126.40463999999999,3475,1541,5016,3388,1509,4897,제주특별자치도 서귀포시 색달동 3391,서귀포시,0,1,126.51989499999999,33.295381250000005
1648,예래입구,33.25862,126.40442,2434,730,3164,2332,694,3026,제주특별자치도 서귀포시 색달동 3391,서귀포시,0,1,126.51989499999999,33.295381250000005
1649,회수삼거리,33.26133,126.4424,616,1,617,612,1,613,제주특별자치도 서귀포시 회수동 769-2,서귀포시,7,2,126.49492888888888,33.251287777777776
1650,회수삼거리,33.26112,126.44223999999998,130,12,142,128,11,139,제주특별자치도 서귀포시 회수동 770-5,서귀포시,7,2,126.49492888888888,33.251287777777776
1651,볼목당,33.25665,126.43613,308,2,310,307,2,309,제주특별자치도 서귀포시 중문동 1835-2,서귀포시,395,4,126.43613,33.25665
1653,1100도로입구,33.25159,126.43163999999999,1996,626,2622,1958,561,2519,제주특별자치도 서귀포시 중문동 1918-3,서귀포시,8,2,126.56943375,33.28377125
1654,대천동주민센터,33.25088,126.47828,2786,58,2844,2734,57,2791,제주특별자치도 서귀포시 도순동 266-5,서귀포시,1,1,126.53914285714286,33.289225714285706
1655,대천동주민센터,33.25107,126.47832,52,4,56,52,4,56,제주특별자치도 서귀포시 도순동 266-4,서귀포시,1,1,126.53914285714286,33.289225714285706
1656,도순동,33.25275,126.47478000000001,3309,55,3364,3253,53,3306,제주특별자치도 서귀포시 도순동 896-12,서귀포시,7,3,126.49492888888888,33.251287777777776
1657,도순동,33.252629999999996,126.4733,3566,29,3595,3526,27,3553,제주특별자치도 서귀포시 도순동 811,서귀포시,7,3,126.49492888888888,33.251287777777776
1658,속도르,33.252959999999995,126.46983,419,16,435,409,16,425,제주특별자치도 서귀포시 도순동 786-1,서귀포시,9,2,126.57550250000001,33.25769583333333
1659,속도르,33.25271,126.47048000000001,286,2,288,283,2,285,제주특별자치도 서귀포시 도순동 759-4,서귀포시,9,2,126.57550250000001,33.25769583333333
1660,제주국제컨벤션센터중문대포해안주상절리대,33.24309,126.42472,1974,1150,3124,1896,1109,3005,제주특별자치도 서귀포시 중문동 2504,서귀포시,10,2,126.50737875000002,33.25214
1661,씨에스호텔,33.24385,126.42033,1381,774,2155,1365,741,2106,제주특별자치도 서귀포시 중문동 2643-4,서귀포시,11,2,126.54324,33.25177125
1662,씨에스호텔,33.24362,126.42031999999999,72,331,403,72,331,403,제주특별자치도 서귀포시 중문동 2798-9,서귀포시,11,2,126.54324,33.25177125
1663,상예2동,33.2644,126.3772,1026,47,1073,1021,45,1066,제주특별자치도 서귀포시 상예동 4999,서귀포시,12,2,126.45767142857143,33.284415714285714
1664,상예2동,33.26417,126.37716999999999,2887,39,2926,2870,39,2909,제주특별자치도 서귀포시 상예동 4631-7,서귀포시,12,2,126.45767142857143,33.284415714285714
1665,창천리,33.265409999999996,126.37153,5693,1444,7137,5573,1397,6970,제주특별자치도 서귀포시 안덕면 창천리 155-14,서귀포시,2,1,126.4046125,33.26323625
1666,창천리,33.26598,126.37082,2916,424,3340,2887,406,3293,제주특별자치도 서귀포시 안덕면 창천리 153-6,서귀포시,2,1,126.4046125,33.26323625
1667,지세못,33.253029999999995,126.46423,1615,28,1643,1595,26,1621,제주특별자치도 서귀포시 하원동 328-1,서귀포시,13,2,126.5886957142857,33.29717571428572
1668,서진아파트,33.25334,126.46391000000001,1354,22,1376,1333,19,1352,제주특별자치도 서귀포시 하원동 1878,서귀포시,13,2,126.5886957142857,33.29717571428572
1669,하원동,33.25367,126.46167,6825,127,6952,6731,112,6843,제주특별자치도 서귀포시 월평동 232-4,서귀포시,396,4,126.46167,33.25367
1670,하원동,33.254129999999996,126.4606,5633,137,5770,5493,134,5627,제주특별자치도 서귀포시 하원동 1878,서귀포시,3,1,126.45668714285715,33.255034285714295
1671,중문고등학교,33.252759999999995,126.44858,8500,194,8694,8100,187,8287,제주특별자치도 서귀포시 대포동 533-2,서귀포시,14,2,126.55566250000001,33.2732475
1672,중문고등학교,33.252829999999996,126.4477,5553,360,5913,5454,348,5802,제주특별자치도 서귀포시 대포동 628-7,서귀포시,14,2,126.55566250000001,33.2732475
1673,한국통신,33.25367,126.51155,268,17,285,264,17,281,제주특별자치도 서귀포시 서호동 1478-2,서귀포시,15,2,126.54513299999999,33.261267000000004
1674,한국통신,33.25312,126.51116,77,24,101,76,23,99,제주특별자치도 서귀포시 법환동 753,서귀포시,15,2,126.54513299999999,33.261267000000004
1675,신시가지,33.24978,126.50628,10211,403,10614,10045,385,10430,제주특별자치도 서귀포시 강정동 248-3,서귀포시,4,1,126.51396210526316,33.26277789473685
1676,성산하이츠빌라,33.25011,126.5048,5531,375,5906,5430,362,5792,제주특별자치도 서귀포시 강정동 186-4,서귀포시,4,1,126.51396210526316,33.26277789473685
1677,반참모르,33.25022,126.50113,6610,168,6778,6500,162,6662,제주특별자치도 서귀포시 강정동 5630-1,서귀포시,16,2,126.48757857142856,33.25839714285715
1678,반참모르,33.25,126.5011,19,5,24,19,2,21,제주특별자치도 서귀포시 강정동 1233-2,서귀포시,16,2,126.48757857142856,33.25839714285715
1679,염돈,33.2499,126.49478,1490,35,1525,1471,35,1506,제주특별자치도 서귀포시 강정동 2144-5,서귀포시,17,2,126.64931,33.30715857142857
1680,염돈동,33.25012,126.49405,767,28,795,759,27,786,제주특별자치도 서귀포시 강정동 2093-3,서귀포시,17,2,126.64931,33.30715857142857
1681,묵은길입구,33.25065,126.48838,308,6,314,295,6,301,제주특별자치도 서귀포시 강정동 5630-10,서귀포시,18,2,126.61156714285713,33.30907571428571
1682,묵은길입구,33.250440000000005,126.48848999999998,590,18,608,576,17,593,제주특별자치도 서귀포시 강정동 3306-3,서귀포시,18,2,126.61156714285713,33.30907571428571
1683,용흥동,33.25025,126.48346000000001,3553,37,3590,3516,35,3551,제주특별자치도 서귀포시 강정동 4024-4,서귀포시,19,2,126.61672250000001,33.2755
1684,용흥동,33.25045,126.48251,1769,34,1803,1743,34,1777,제주특별자치도 서귀포시 강정동 4033-9,서귀포시,19,2,126.61672250000001,33.2755
1685,플레이케이팝박물관,33.25007,126.41415,2533,1523,4056,2381,1429,3810,제주특별자치도 서귀포시 색달동 2864-20,서귀포시,20,2,126.50806625,33.26451
1686,농업기술원,33.260909999999996,126.48661000000001,620,132,752,618,131,749,제주특별자치도 서귀포시 강정동 3436-5,서귀포시,21,2,126.55541500000001,33.29999375
1687,농업기술원,33.26082,126.48655,227,7,234,225,5,230,제주특별자치도 서귀포시 강정동 3462-2,서귀포시,21,2,126.55541500000001,33.29999375
1688,월산동,33.2599,126.49171000000001,119,3,122,118,3,121,제주특별자치도 서귀포시 강정동 5630-1,서귀포시,22,2,126.579643,33.256641
1689,월산동,33.26012,126.49221999999999,60,14,74,59,14,73,제주특별자치도 서귀포시 강정동 1914-12,서귀포시,22,2,126.579643,33.256641
1691,신시가지,33.26044,126.50995,248,5,253,247,5,252,제주특별자치도 서귀포시 서호동 1478,서귀포시,397,4,126.50995,33.26044
1692,신시가지,33.25898,126.51043,1678,21,1699,1664,18,1682,제주특별자치도 서귀포시 서호동 1478-1,서귀포시,23,2,126.52565142857144,33.25023785714286
1693,신시가지,33.258340000000004,126.51026,1443,23,1466,1437,20,1457,제주특별자치도 서귀포시 강정동 186,서귀포시,23,2,126.52565142857144,33.25023785714286
1694,시청후문,33.25675,126.51078000000001,56,2,58,54,2,56,제주특별자치도 서귀포시 서호동 1478-2,서귀포시,398,4,126.51078000000001,33.25675
1696,회수동,33.263690000000004,126.44391999999999,39,5,44,36,5,41,제주특별자치도 서귀포시 회수동 389-2,서귀포시,5,1,126.39661875,33.266799999999996
1697,삼주연립주택,33.25025,126.51035,2477,39,2516,2447,39,2486,제주특별자치도 서귀포시 법환동 753,서귀포시,4,1,126.51396210526316,33.26277789473685
1698,동남아파트,33.249790000000004,126.50998,425,24,449,414,24,438,제주특별자치도 서귀포시 법환동 753,서귀포시,4,1,126.51396210526316,33.26277789473685
1699,제주월드컵경기장서귀포버스터미널,33.24912,126.509,44875,2913,47788,43480,2774,46254,제주특별자치도 서귀포시 법환동 816-9,서귀포시,4,1,126.51396210526316,33.26277789473685
1702,대림한숲빌라,33.25165,126.50598000000001,177,5,182,176,5,181,제주특별자치도 서귀포시 강정동 186-1,서귀포시,4,1,126.51396210526316,33.26277789473685
1704,국민건강보험공단,33.25462,126.50681000000002,217,2,219,216,2,218,제주특별자치도 서귀포시 강정동 186-1,서귀포시,399,4,126.50681000000002,33.25462
1705,서귀포우체국서귀포시청제2청사,33.25507,126.51007,6020,1336,7356,5996,1334,7330,제주특별자치도 서귀포시 법환동 754,서귀포시,15,3,126.54513299999999,33.261267000000004
1706,서귀포우체국서귀포시청제2청사,33.25517,126.50894,2649,95,2744,2630,88,2718,제주특별자치도 서귀포시 강정동 187,서귀포시,15,3,126.54513299999999,33.261267000000004
1707,서귀포경찰서,33.25608,126.5076,460,9,469,456,9,465,제주특별자치도 서귀포시 법환동 754,서귀포시,24,2,126.50524000000001,33.24985777777778
1708,서귀포경찰서,33.256370000000004,126.50761000000001,520,8,528,511,8,519,제주특별자치도 서귀포시 강정동 186,서귀포시,24,2,126.50524000000001,33.24985777777778
1709,하원초등학교,33.25347,126.45985,266,7,273,263,7,270,제주특별자치도 서귀포시 월평동 239-7,서귀포시,3,1,126.45668714285715,33.255034285714295
1710,하원초등학교,33.253170000000004,126.46007,111,3,114,106,3,109,제주특별자치도 서귀포시 월평동 239-7,서귀포시,3,1,126.45668714285715,33.255034285714295
1711,머구낭동산,33.24566,126.45831000000001,291,12,303,289,12,301,제주특별자치도 서귀포시 월평동 753-11,서귀포시,25,2,126.5539542857143,33.25205285714286
1712,머구낭동산,33.24573,126.45815,198,2,200,196,2,198,제주특별자치도 서귀포시 하원동 1615-2,서귀포시,25,2,126.5539542857143,33.25205285714286
1713,월평아왜낭목,33.24362,126.45867,279,20,299,272,19,291,제주특별자치도 서귀포시 월평동 741-3,서귀포시,26,2,126.59011999999998,33.26138428571429
1714,월평아왜낭목,33.24353,126.4588,724,80,804,685,77,762,제주특별자치도 서귀포시 월평동 513,서귀포시,26,2,126.59011999999998,33.26138428571429
1715,월평알동네,33.24343,126.46036000000001,209,7,216,208,7,215,제주특별자치도 서귀포시 월평동 499-7,서귀포시,6,1,126.4122775,33.2481775
1716,월평알동네,33.24327,126.46055,359,32,391,354,31,385,제주특별자치도 서귀포시 월평동 510-2,서귀포시,6,1,126.4122775,33.2481775
1717,동병듸,33.24238,126.46349,220,12,232,219,12,231,제주특별자치도 서귀포시 월평동 558-1,서귀포시,27,2,126.58037818181816,33.28037545454546
1718,동병듸,33.24269,126.46326,97,2,99,97,2,99,제주특별자치도 서귀포시 월평동 400-5,서귀포시,27,2,126.58037818181816,33.28037545454546
1719,이천장물,33.24175,126.46748999999998,63,21,84,62,21,83,제주특별자치도 서귀포시 월평동 73-2,서귀포시,28,2,126.43984142857143,33.241957142857146
1720,이천장물,33.24179,126.46708999999998,165,20,185,165,20,185,제주특별자치도 서귀포시 월평동 72-2,서귀포시,28,2,126.43984142857143,33.241957142857146
1721,허물서,33.23877,126.47363,198,12,210,194,8,202,제주특별자치도 서귀포시 강정동 5491-2,서귀포시,29,2,126.48017374999999,33.25316
1722,허물서,33.2385,126.47386999999999,455,14,469,450,14,464,제주특별자치도 서귀포시 강정동 5492-7,서귀포시,29,2,126.48017374999999,33.25316
1723,섯가름,33.23703,126.47582,3067,22,3089,3037,18,3055,제주특별자치도 서귀포시 강정동 4370-2,서귀포시,30,2,126.48163400000001,33.238526
1724,섯가름,33.237120000000004,126.47605,996,8,1004,987,8,995,제주특별자치도 서귀포시 강정동 4370,서귀포시,30,2,126.48163400000001,33.238526
1726,강정농협,33.23603,126.47827,5947,102,6049,5804,93,5897,제주특별자치도 서귀포시 강정동 4400-8,서귀포시,400,4,126.47827,33.23603
1727,강정초등학교,33.23561,126.47977,3046,84,3130,3001,78,3079,제주특별자치도 서귀포시 강정동 4548,서귀포시,31,2,126.61406500000001,33.26293875
1728,강정초등학교,33.235640000000004,126.4801,3086,306,3392,3059,301,3360,제주특별자치도 서귀포시 강정동 4521-10,서귀포시,31,2,126.61406500000001,33.26293875
1729,서귀포여자고등학교,33.24463,126.53137,8545,744,9289,8281,725,9006,제주특별자치도 서귀포시 호근동 1532-1,서귀포시,32,2,126.52956,33.25009
1730,서귀포여자고등학교,33.24438,126.53168000000001,17593,866,18459,16905,826,17731,제주특별자치도 서귀포시 호근동 1561,서귀포시,32,2,126.52956,33.25009
1731,수모루,33.24593,126.52443999999998,288,28,316,278,24,302,제주특별자치도 서귀포시 서호동 30-7,서귀포시,7,1,126.49492888888888,33.251287777777776
1732,주거물,33.24394,126.52123999999999,356,20,376,351,17,368,제주특별자치도 서귀포시 법환동 69-2,서귀포시,33,2,126.48008142857144,33.25181428571429
1733,주거물,33.24378,126.52122,301,55,356,294,52,346,제주특별자치도 서귀포시 법환동 72-2,서귀포시,33,2,126.48008142857144,33.25181428571429
1734,공물,33.24067,126.51635,687,78,765,677,72,749,제주특별자치도 서귀포시 법환동 454,서귀포시,34,2,126.42470875000001,33.250165
1735,공물,33.240429999999996,126.51628999999998,1660,94,1754,1635,88,1723,제주특별자치도 서귀포시 법환동 450,서귀포시,34,2,126.42470875000001,33.250165
1736,신세계빌라,33.239540000000005,126.51467,555,21,576,549,21,570,제주특별자치도 서귀포시 법환동 424-3,서귀포시,8,1,126.56943375,33.28377125
1737,신세계빌라,33.23958,126.51501999999999,2779,57,2836,2739,54,2793,제주특별자치도 서귀포시 법환동 425-6,서귀포시,8,1,126.56943375,33.28377125
1738,법환새마을금고,33.23843,126.51398,863,30,893,847,27,874,제주특별자치도 서귀포시 법환동 352,서귀포시,8,1,126.56943375,33.28377125
1739,법환새마을금고,33.23785,126.51342,2722,96,2818,2681,88,2769,제주특별자치도 서귀포시 법환동 260-5,서귀포시,8,1,126.56943375,33.28377125
1740,법환농협,33.23728,126.5119,1860,238,2098,1819,226,2045,제주특별자치도 서귀포시 법환동 1275-3,서귀포시,35,2,126.55455285714287,33.24852714285714
1741,뒷동산,33.23666,126.51068000000001,2141,73,2214,2120,72,2192,제주특별자치도 서귀포시 법환동 1282,서귀포시,401,4,126.51068000000001,33.23666
1742,법환초등학교,33.236740000000005,126.50941,1137,129,1266,1111,125,1236,제주특별자치도 서귀포시 법환동 1299-4,서귀포시,11,3,126.54324,33.25177125
1743,법환초등학교,33.23653,126.50815,1191,288,1479,1154,276,1430,제주특별자치도 서귀포시 법환동 1291-4,서귀포시,11,3,126.54324,33.25177125
1744,남성마을,33.24262,126.55417,789,32,821,776,32,808,제주특별자치도 서귀포시 서홍동 744-8,서귀포시,36,2,126.6409257142857,33.35606571428571
1745,종합문예진흥사업소,33.24508,126.55365,22,24,46,22,24,46,제주특별자치도 서귀포시 서홍동 586,서귀포시,37,2,126.728285,33.33050375
1746,삼매봉도서관,33.24557,126.55363999999999,511,32,543,502,29,531,제주특별자치도 서귀포시 서홍동 578-15,서귀포시,37,2,126.728285,33.33050375
1747,남성마을입구,33.2477,126.5526,5658,1103,6761,5478,1055,6533,제주특별자치도 서귀포시 서홍동 558-1,서귀포시,38,2,126.72819,33.29882200000001
1748,남성마을입구,33.24795,126.55224,5482,1365,6847,5310,1272,6582,제주특별자치도 서귀포시 서홍동 534-5,서귀포시,38,2,126.72819,33.29882200000001
1749,삼매봉입구,33.24491,126.5438,757,384,1141,711,369,1080,제주특별자치도 서귀포시 호근동 268-5,서귀포시,39,2,126.71906142857142,33.322051428571434
1750,삼매봉,33.2447,126.54354,56,37,93,55,32,87,제주특별자치도 서귀포시 호근동 310-4,서귀포시,39,2,126.71906142857142,33.322051428571434
1751,여의물,33.24504,126.53822,156,95,251,151,92,243,제주특별자치도 서귀포시 호근동 461-3,서귀포시,40,2,126.4694525,33.254366250000004
1752,여의물,33.24483,126.53777,464,93,557,448,92,540,제주특별자치도 서귀포시 호근동 461-1,서귀포시,40,2,126.4694525,33.254366250000004
1753,솜반천,33.25015,126.55332,22,6,28,20,6,26,제주특별자치도 서귀포시 서홍동 1196-2,서귀포시,402,4,126.55332,33.25015
1755,외돌개,33.24096,126.54739,803,734,1537,747,672,1419,제주특별자치도 서귀포시 서홍동 795-3,서귀포시,41,2,126.57285857142858,33.27642285714286
1756,서호북문,33.26123,126.52205,1078,25,1103,1069,25,1094,제주특별자치도 서귀포시 서호동 595-7,서귀포시,42,2,126.39550200000001,33.246428
1757,서호북문,33.26113,126.52301000000001,1306,34,1340,1286,29,1315,제주특별자치도 서귀포시 서호동 609-1,서귀포시,42,2,126.39550200000001,33.246428
1758,바가잣도,33.2614,126.52707,115,1,116,109,1,110,제주특별자치도 서귀포시 호근동 2142,서귀포시,43,2,126.34861,33.252337142857144
1759,바가잣도,33.26126,126.52743000000001,661,5,666,656,5,661,제주특별자치도 서귀포시 호근동 2013-2,서귀포시,43,2,126.34861,33.252337142857144
1760,용천사입구,33.26145,126.52951999999999,247,7,254,246,7,253,제주특별자치도 서귀포시 호근동 1170-2,서귀포시,44,2,126.32166500000001,33.234591249999994
1761,용천사입구,33.261309999999995,126.5302,1061,15,1076,1054,15,1069,제주특별자치도 서귀포시 호근동 1136-3,서귀포시,44,2,126.32166500000001,33.234591249999994
1762,돗소,33.26187,126.53613,73,4,77,73,4,77,제주특별자치도 서귀포시 호근동 801-4,서귀포시,45,2,126.77516600000001,33.384221999999994
1763,돗소,33.26197,126.5352,45,1,46,45,1,46,제주특별자치도 서귀포시 호근동 793,서귀포시,45,2,126.77516600000001,33.384221999999994
1764,자연빌라,33.26232,126.53863,164,1,165,163,1,164,제주특별자치도 서귀포시 호근동 814-3,서귀포시,46,2,126.76076599999999,33.384136
1765,자연빌라,33.26218,126.53898000000001,845,6,851,834,6,840,제주특별자치도 서귀포시 호근동 849-4,서귀포시,46,2,126.76076599999999,33.384136
1766,진진내,33.26263,126.54298,380,7,387,380,7,387,제주특별자치도 서귀포시 서홍동 1780-7,서귀포시,33,3,126.48008142857144,33.25181428571429
1767,진진내,33.263020000000004,126.54467,47,2,49,47,2,49,제주특별자치도 서귀포시 서홍동 1782-1,서귀포시,33,3,126.48008142857144,33.25181428571429
1768,수모루,33.24657,126.52415,8009,342,8351,7894,327,8221,제주특별자치도 서귀포시 서호동 24-2,서귀포시,7,1,126.49492888888888,33.251287777777776
1769,광대왓,33.24752,126.51857,675,211,886,652,200,852,제주특별자치도 서귀포시 법환동 15-2,서귀포시,3,3,126.45668714285715,33.255034285714295
1770,광대왓,33.248090000000005,126.51593000000001,333,100,433,323,95,418,제주특별자치도 서귀포시 서호동 1609,서귀포시,3,3,126.45668714285715,33.255034285714295
1771,고래왓,33.24848,126.5123,2959,549,3508,2892,515,3407,제주특별자치도 서귀포시 법환동 828-4,서귀포시,2,3,126.4046125,33.26323625
1772,대륜동주민센터,33.24848,126.51118999999998,5318,1713,7031,5130,1615,6745,제주특별자치도 서귀포시 법환동 816-9,서귀포시,403,4,126.51118999999998,33.24848
1773,고근산,33.260329999999996,126.51373000000001,927,12,939,924,12,936,제주특별자치도 서귀포시 서호동 1237-7,서귀포시,47,2,126.387708,33.254452
1774,고근산,33.26048,126.51393,68,6,74,68,6,74,제주특별자치도 서귀포시 서호동 1238-6,서귀포시,47,2,126.387708,33.254452
1775,아이뜨락공원,33.264109999999995,126.55343,681,1,682,678,1,679,제주특별자치도 서귀포시 서홍동 1615-11,서귀포시,404,4,126.55343,33.264109999999995
1776,솔대왓,33.26406,126.55546000000001,1730,22,1752,1717,22,1739,제주특별자치도 서귀포시 서홍동 271-17,서귀포시,48,2,126.41514200000002,33.255396
1777,양가왓,33.26421,126.5556,980,20,1000,972,18,990,제주특별자치도 서귀포시 서홍동 271-13,서귀포시,48,2,126.41514200000002,33.255396
1778,서홍새마을금고,33.26424,126.55796000000001,1306,15,1321,1293,15,1308,제주특별자치도 서귀포시 서홍동 257-4,서귀포시,49,2,126.74017666666664,33.30399
1779,서귀북초등학교,33.26037,126.5594,4562,65,4627,4491,59,4550,제주특별자치도 서귀포시 동홍동 1557-4,서귀포시,50,2,126.377458,33.239484000000004
1780,동덕아파트,33.25762,126.56008999999999,8095,72,8167,7976,72,8048,제주특별자치도 서귀포시 서홍동 316-44,서귀포시,51,2,126.37958600000002,33.262034
1781,서귀포고등학교,33.2576,126.56043000000001,2883,14,2897,2850,12,2862,제주특별자치도 서귀포시 동홍동 1460-12,서귀포시,51,2,126.37958600000002,33.262034
1782,서귀중앙여자중학교,33.25497,126.56055,2538,35,2573,2500,31,2531,제주특별자치도 서귀포시 서홍동 397-115,서귀포시,52,2,126.38022545454545,33.30013272727273
1783,서귀중앙여자중학교,33.25508,126.56078000000001,5872,47,5919,5775,44,5819,제주특별자치도 서귀포시 동홍동 1484-3,서귀포시,52,2,126.38022545454545,33.30013272727273
1784,중앙로터리(동),33.25297,126.56135,87704,4905,92609,86505,4656,91161,제주특별자치도 서귀포시 서귀동 336,서귀포시,9,1,126.57550250000001,33.25769583333333
1786,도영슈퍼앞,33.24198,126.60045,83,4,87,81,4,85,제주특별자치도 서귀포시 보목동 735,서귀포시,53,2,126.6864557142857,33.269752857142855
1787,도영슈퍼,33.24225,126.60025,2024,38,2062,1980,37,2017,제주특별자치도 서귀포시 보목동 735,서귀포시,53,2,126.6864557142857,33.269752857142855
1788,농협보목지소,33.24323,126.5983,6129,155,6284,6071,151,6222,제주특별자치도 서귀포시 보목동 881-7,서귀포시,54,2,126.7603,33.31871399999999
1789,함덕골,33.24317,126.59808000000001,315,18,333,314,17,331,제주특별자치도 서귀포시 보목동 1311-1,서귀포시,54,2,126.7603,33.31871399999999
1790,장안그랜드빌라,33.24375,126.5964,882,30,912,877,29,906,제주특별자치도 서귀포시 보목동 1225-3,서귀포시,55,2,126.78752,33.366368
1791,장안그랜드빌라,33.24365,126.59624,29,3,32,28,3,31,제주특별자치도 서귀포시 보목동 1230-3,서귀포시,55,2,126.78752,33.366368
1792,동부하수처리장입구,33.24436,126.59403999999999,651,83,734,632,83,715,제주특별자치도 서귀포시 보목동 1170-2,서귀포시,56,2,126.66646600000001,33.284141999999996
1793,동부하수처리장입구,33.24443,126.59328000000001,101,18,119,100,18,118,제주특별자치도 서귀포시 보목동 1480-10,서귀포시,56,2,126.66646600000001,33.284141999999996
1794,라임오렌지빌,33.246559999999995,126.58723,159,12,171,149,11,160,제주특별자치도 서귀포시 토평동 417-1,서귀포시,57,2,126.77318199999999,33.343149999999994
1795,라임오렌지빌,33.24686,126.58701,497,96,593,480,94,574,제주특별자치도 서귀포시 토평동 418-5,서귀포시,57,2,126.77318199999999,33.343149999999994
1796,검은여입구,33.24819,126.58287,1169,216,1385,1146,199,1345,제주특별자치도 서귀포시 토평동 635-2,서귀포시,58,2,126.57301166666667,33.252878333333335
1797,검은여입구,33.2481,126.58253,567,94,661,558,90,648,제주특별자치도 서귀포시 토평동 621-2,서귀포시,58,2,126.57301166666667,33.252878333333335
1798,칼호텔,33.24803,126.57823,148,67,215,144,64,208,제주특별자치도 서귀포시 토평동 580-2,서귀포시,25,1,126.5539542857143,33.25205285714286
1799,효성빌라,33.25165,126.57676000000001,238,43,281,237,40,277,제주특별자치도 서귀포시 동홍동 192-43,서귀포시,59,2,126.50107599999998,33.246554
1800,효성빌라,33.251870000000004,126.57683,519,23,542,516,20,536,제주특별자치도 서귀포시 토평동 820-11,서귀포시,59,2,126.50107599999998,33.246554
1801,삼아아파트,33.25189,126.57441999999999,10673,518,11191,10572,497,11069,제주특별자치도 서귀포시 동홍동 184-4,서귀포시,60,2,126.3705242857143,33.28986428571428
1802,주공34단지,33.2501,126.57186999999999,8889,314,9203,8718,299,9017,제주특별자치도 서귀포시 동홍동 2174-17,서귀포시,10,1,126.50737875000002,33.25214
1803,주공아파트,33.25108,126.57221000000001,348,3,351,338,3,341,제주특별자치도 서귀포시 동홍동 175-1,서귀포시,10,1,126.50737875000002,33.25214
1804,주공2아파트,33.25225,126.57185,827,12,839,821,11,832,제주특별자치도 서귀포시 동홍동 650-8,서귀포시,10,1,126.50737875000002,33.25214
1805,보목신협앞,33.2416,126.6025,183,43,226,176,43,219,제주특별자치도 서귀포시 보목동 1637,서귀포시,61,2,126.36891666666666,33.22575333333334
1806,보목신협,33.241659999999996,126.60198999999999,4004,256,4260,3896,243,4139,제주특별자치도 서귀포시 보목동 750-4,서귀포시,61,2,126.36891666666666,33.22575333333334
1807,상효입구,33.2596,126.59567,517,42,559,507,41,548,제주특별자치도 서귀포시 신효동 1494-4,서귀포시,62,2,126.733986,33.309762
1808,상효입구,33.25965,126.59505,1020,54,1074,983,49,1032,제주특별자치도 서귀포시 신효동 1514-2,서귀포시,62,2,126.733986,33.309762
1809,보목입구,33.25871,126.59158000000001,400,19,419,396,17,413,제주특별자치도 서귀포시 토평동 1093-3,서귀포시,63,2,126.65415800000001,33.290906
1810,토평보목입구,33.25875,126.59062,992,12,1004,972,11,983,제주특별자치도 서귀포시 토평동 1073-3,서귀포시,63,2,126.65415800000001,33.290906
1811,삼성여자고등학교,33.25732,126.58478000000001,12004,61,12065,11559,59,11618,제주특별자치도 서귀포시 토평동 937-3,서귀포시,14,3,126.55566250000001,33.2732475
1812,삼성여자고등학교,33.257659999999994,126.58657,4085,53,4138,4011,50,4061,제주특별자치도 서귀포시 토평동 932,서귀포시,14,3,126.55566250000001,33.2732475
1813,창남거리,33.25627,126.58205,224,10,234,212,10,222,제주특별자치도 서귀포시 토평동 851-3,서귀포시,64,2,126.53915666666667,33.255085
1814,창남거리,33.25623,126.58143000000001,703,17,720,694,17,711,제주특별자치도 서귀포시 토평동 3245-48,서귀포시,64,2,126.53915666666667,33.255085
1816,비석거리,33.25496,126.57824,5852,604,6456,5755,574,6329,제주특별자치도 서귀포시 토평동 827-2,서귀포시,17,1,126.64931,33.30715857142857
1817,효돈중학교,33.26348,126.62143,3385,638,4023,3303,612,3915,제주특별자치도 서귀포시 하효동 300-1,서귀포시,11,1,126.54324,33.25177125
1818,효돈중학교,33.26363,126.62008,6055,172,6227,5945,164,6109,제주특별자치도 서귀포시 하효동 1460,서귀포시,405,4,126.62008,33.26363
1819,효돈초등학교,33.26375,126.61641000000002,11982,189,12171,11831,181,12012,제주특별자치도 서귀포시 하효동 1460,서귀포시,65,2,126.588856,33.252526
1820,앞동산,33.26377,126.61425,1131,48,1179,1115,48,1163,제주특별자치도 서귀포시 신효동 842-1,서귀포시,25,3,126.5539542857143,33.25205285714286
1821,신효,33.263729999999995,126.61113,1179,68,1247,1153,65,1218,제주특별자치도 서귀포시 신효동 768-1,서귀포시,406,4,126.61113,33.263729999999995
1822,신효동,33.26361,126.61012,3519,127,3646,3468,119,3587,제주특별자치도 서귀포시 신효동 746-1,서귀포시,407,4,126.61012,33.26361
1823,월라봉,33.26254,126.60623999999999,1736,76,1812,1722,72,1794,제주특별자치도 서귀포시 신효동 1151-2,서귀포시,66,2,126.612934,33.261552
1824,월라봉,33.26225,126.60561000000001,539,36,575,527,34,561,제주특별자치도 서귀포시 신효동 1544-20,서귀포시,66,2,126.612934,33.261552
1825,서귀포시중앙도서관,33.251670000000004,126.50773000000001,1939,52,1991,1899,49,1948,제주특별자치도 서귀포시 강정동 187,서귀포시,67,2,126.50771,33.25177000000001
1826,종보존연구센터,33.275929999999995,126.682,165,53,218,162,53,215,제주특별자치도 서귀포시 남원읍 위미리 690-1,서귀포시,68,2,126.68176500000001,33.276025
1827,종보존연구센터,33.27612,126.68153000000001,322,67,389,319,63,382,제주특별자치도 서귀포시 남원읍 위미리 4591-71,서귀포시,68,2,126.68176500000001,33.276025
1828,세천동,33.27523,126.675,1031,71,1102,1006,68,1074,제주특별자치도 서귀포시 남원읍 위미리 894-4,서귀포시,69,2,126.67484999999999,33.275235
1829,세천동,33.275240000000004,126.6747,2296,90,2386,2268,87,2355,제주특별자치도 서귀포시 남원읍 위미리 4591-71,서귀포시,69,2,126.67484999999999,33.275235
1830,대원상동,33.27483,126.67058,773,14,787,766,12,778,제주특별자치도 서귀포시 남원읍 위미리 1658-1,서귀포시,70,2,126.67023499999999,33.274895
1831,대원상동,33.27496,126.66989,1546,23,1569,1506,23,1529,제주특별자치도 서귀포시 남원읍 위미리 1574-3,서귀포시,70,2,126.67023499999999,33.274895
1832,뒤통모루,33.275259999999996,126.66707,1531,49,1580,1504,47,1551,제주특별자치도 서귀포시 남원읍 위미리 1846-1,서귀포시,71,2,126.66698,33.27533
1833,뒤통모루,33.2754,126.66689,3244,37,3281,3193,35,3228,제주특별자치도 서귀포시 남원읍 위미리 4591,서귀포시,71,2,126.66698,33.27533
1834,상원동,33.27505,126.66353000000001,2098,94,2192,2052,84,2136,제주특별자치도 서귀포시 남원읍 위미리 1883-2,서귀포시,72,2,126.66344000000001,33.27513
1835,위미문화의집,33.27474,126.65983,2154,298,2452,2102,282,2384,제주특별자치도 서귀포시 남원읍 위미리 2846-1,서귀포시,29,3,126.48017374999999,33.25316
1836,위미문화의집,33.274770000000004,126.65836999999999,5576,412,5988,5456,391,5847,제주특별자치도 서귀포시 남원읍 위미리 4591,서귀포시,29,3,126.48017374999999,33.25316
1837,위미1리사무소,33.27411,126.65645,3934,171,4105,3799,165,3964,제주특별자치도 서귀포시 남원읍 위미리 3155-3,서귀포시,408,4,126.65645,33.27411
1838,위미초등학교,33.27367,126.65455,4738,193,4931,4663,185,4848,제주특별자치도 서귀포시 남원읍 위미리 3235-1,서귀포시,409,4,126.65455,33.27367
1839,대화동,33.27275,126.6518,1535,126,1661,1506,119,1625,제주특별자치도 서귀포시 남원읍 위미리 4144-2,서귀포시,410,4,126.6518,33.27275
1840,서성동,33.27245,126.65032,2591,110,2701,2535,104,2639,제주특별자치도 서귀포시 남원읍 위미리 4148-8,서귀포시,411,4,126.65032,33.27245
1841,농협주유소,33.27097,126.64738,346,16,362,339,15,354,제주특별자치도 서귀포시 남원읍 신례리 3,서귀포시,73,2,126.64693,33.270709999999994
1842,신례2리교차로,33.26746,126.64323999999999,521,32,553,514,32,546,제주특별자치도 서귀포시 남원읍 신례리 39-7,서귀포시,74,2,126.64309,33.26724
1843,농협주유소,33.27045,126.64648000000001,919,34,953,910,30,940,제주특별자치도 서귀포시 남원읍 신례리 274-1,서귀포시,73,2,126.64693,33.270709999999994
1844,신례2리교차로,33.26702,126.64294,680,71,751,665,68,733,제주특별자치도 서귀포시 남원읍 신례리 25-2,서귀포시,74,2,126.64309,33.26724
1845,공천포,33.26583,126.64053,3734,254,3988,3679,245,3924,제주특별자치도 서귀포시 남원읍 신례리 118-2,서귀포시,75,2,126.64035,33.265640000000005
1846,공천포,33.26545,126.64017,1945,184,2129,1919,175,2094,제주특별자치도 서귀포시 남원읍 신례리 2191,서귀포시,75,2,126.64035,33.265640000000005
1847,망장포입구,33.26408,126.6345,537,81,618,513,79,592,제주특별자치도 서귀포시 남원읍 하례리 1887,서귀포시,76,2,126.63421,33.264115000000004
1848,망장포입구,33.26415,126.63391999999999,2455,148,2603,2434,142,2576,제주특별자치도 서귀포시 남원읍 하례리 313-2,서귀포시,76,2,126.63421,33.264115000000004
1849,하례1리입구,33.2635,126.62608999999999,1542,223,1765,1492,211,1703,제주특별자치도 서귀포시 남원읍 하례리 351-2,서귀포시,77,2,126.626135,33.263585
1850,하례1리입구,33.26367,126.62618,4568,161,4729,4511,148,4659,제주특별자치도 서귀포시 남원읍 하례리 344-4,서귀포시,77,2,126.626135,33.263585
1852,신례교,33.293420000000005,126.62463000000001,31,7,38,31,7,38,제주특별자치도 서귀포시 남원읍 신례리 2194,서귀포시,78,2,126.62462500000001,33.29347
1853,신례교,33.29352,126.62462,757,9,766,754,9,763,제주특별자치도 서귀포시 남원읍 신례리 2194,서귀포시,78,2,126.62462500000001,33.29347
1854,만지동,33.29325,126.62675,555,16,571,542,16,558,제주특별자치도 서귀포시 남원읍 신례리 1233-3,서귀포시,12,1,126.45767142857143,33.284415714285714
1855,만지동,33.2929,126.62658,602,9,611,598,9,607,제주특별자치도 서귀포시 남원읍 신례리 1225-1,서귀포시,12,1,126.45767142857143,33.284415714285714
1856,사가동,33.290079999999996,126.62735,624,6,630,623,6,629,제주특별자치도 서귀포시 남원읍 신례리 2191,서귀포시,79,2,126.62735,33.29017999999999
1857,사가동,33.290279999999996,126.62735,631,10,641,627,10,637,제주특별자치도 서귀포시 남원읍 신례리 1301-1,서귀포시,79,2,126.62735,33.29017999999999
1858,동문정류소,33.289320000000004,126.63025,880,6,886,870,6,876,제주특별자치도 서귀포시 남원읍 신례리 984-7,서귀포시,80,2,126.630285,33.289060000000006
1859,동문정류소,33.2888,126.63032,563,17,580,558,16,574,제주특별자치도 서귀포시 남원읍 신례리 1024-13,서귀포시,80,2,126.630285,33.289060000000006
1860,신례초등학교,33.28518,126.63263,725,11,736,715,11,726,제주특별자치도 서귀포시 남원읍 신례리 841-1,서귀포시,81,2,126.632945,33.284555
1861,신례초등학교,33.28393,126.63326,1194,9,1203,1131,8,1139,제주특별자치도 서귀포시 남원읍 신례리 836-12,서귀포시,81,2,126.632945,33.284555
1862,신례하동,33.281209999999994,126.63506000000001,204,1,205,202,1,203,제주특별자치도 서귀포시 남원읍 신례리 652-1,서귀포시,412,4,126.63506000000001,33.281209999999994
1864,신성동,33.27479,126.6951,884,48,932,847,46,893,제주특별자치도 서귀포시 남원읍 남원리 2420-2,서귀포시,82,2,126.694835,33.274825
1865,신성동,33.27486,126.69457,1118,72,1190,1104,70,1174,제주특별자치도 서귀포시 남원읍 남원리 2490-116,서귀포시,82,2,126.694835,33.274825
1866,위미3리마을회관,33.27503,126.68867,1398,58,1456,1355,55,1410,제주특별자치도 서귀포시 남원읍 위미리 168-2,서귀포시,83,2,126.68887000000001,33.275075
1867,위미3리,33.2754,126.68708000000001,1658,77,1735,1619,75,1694,제주특별자치도 서귀포시 남원읍 위미리 172-7,서귀포시,84,2,126.68690000000001,33.275355
1868,서귀포산업과학고등학교,33.29573,126.59512,121,36,157,116,34,150,제주특별자치도 서귀포시 상효동 1262-2,서귀포시,13,1,126.5886957142857,33.29717571428572
1869,서귀포산업과학고등학교,33.295970000000004,126.59557,4240,353,4593,4081,327,4408,제주특별자치도 서귀포시 상효동 1262-4,서귀포시,13,1,126.5886957142857,33.29717571428572
1870,하례환승정류장(하례리입구),33.29998,126.60048,2790,202,2992,2741,184,2925,제주특별자치도 서귀포시 상효동 1122-5,서귀포시,85,2,126.60059000000001,33.299989999999994
1871,감귤단지,33.30127,126.60908,146,2,148,146,2,148,제주특별자치도 서귀포시 남원읍 하례리 1763-6,서귀포시,86,2,126.609235,33.30121
1872,감귤단지,33.30115,126.60938999999999,218,11,229,217,11,228,제주특별자치도 서귀포시 남원읍 하례리 1887,서귀포시,86,2,126.609235,33.30121
1873,심향사,33.29547,126.62207,69,10,79,69,10,79,제주특별자치도 서귀포시 남원읍 신례리 1638-9,서귀포시,87,2,126.621905,33.295015
1874,진학농원,33.29995,126.61587,56,1,57,55,1,56,제주특별자치도 서귀포시 남원읍 하례리 1210-4,서귀포시,413,4,126.61587,33.29995
1876,돈내코마을,33.30275,126.57352,12,1,13,12,1,13,제주특별자치도 서귀포시 상효동 2245-2,서귀포시,88,2,126.57359,33.302825
1877,돈내코,33.2997,126.58429,1008,166,1174,981,158,1139,제주특별자치도 서귀포시 상효동 1463,서귀포시,89,2,126.584555,33.299735
1878,돈내코,33.29977,126.58482,4,7,11,4,7,11,제주특별자치도 서귀포시 상효동 1453-1,서귀포시,89,2,126.584555,33.299735
1879,돈내코교,33.29934,126.58861999999999,170,35,205,168,35,203,제주특별자치도 서귀포시 상효동 1449-4,서귀포시,90,2,126.58869999999999,33.29948
1880,돈내코교,33.299620000000004,126.58878,59,14,73,58,13,71,제주특별자치도 서귀포시 상효동 1613,서귀포시,90,2,126.58869999999999,33.29948
1881,고도농원,33.28753,126.59368,339,8,347,334,8,342,제주특별자치도 서귀포시 상효동 1350-2,서귀포시,91,2,126.59351000000001,33.28758
1882,고도농원,33.28763,126.59334,355,8,363,344,8,352,제주특별자치도 서귀포시 상효동 1351-11,서귀포시,91,2,126.59351000000001,33.28758
1883,법호촌입구,33.290079999999996,126.59386,259,8,267,259,8,267,제주특별자치도 서귀포시 상효동 1344-1,서귀포시,14,1,126.55566250000001,33.2732475
1884,법호촌입구,33.29065,126.59456999999999,685,11,696,681,11,692,제주특별자치도 서귀포시 상효동 1296-4,서귀포시,14,1,126.55566250000001,33.2732475
1885,법호촌온성학교,33.29186,126.59449,3454,40,3494,3411,36,3447,제주특별자치도 서귀포시 상효동 1290-1,서귀포시,14,1,126.55566250000001,33.2732475
1886,법호촌온성학교,33.29282,126.59475,2062,22,2084,2038,19,2057,제주특별자치도 서귀포시 상효동 1300-15,서귀포시,14,1,126.55566250000001,33.2732475
1887,서귀포산업과학고등학교,33.29515,126.59487,6292,203,6495,6086,194,6280,제주특별자치도 서귀포시 상효동 1262-3,서귀포시,13,1,126.5886957142857,33.29717571428572
1889,하례2리,33.28929,126.60598999999999,620,12,632,616,11,627,제주특별자치도 서귀포시 남원읍 하례리 1648-4,서귀포시,92,2,126.60611,33.28931
1892,제2효레교,33.28477,126.60816000000001,22,2,24,22,2,24,제주특별자치도 서귀포시 상효동 409-3,서귀포시,414,4,126.60816000000001,33.28477
1896,동상효,33.279959999999996,126.60717,1073,18,1091,1068,18,1086,제주특별자치도 서귀포시 상효동 454-6,서귀포시,93,2,126.607235,33.279804999999996
1897,동상효,33.27965,126.6073,11,1,12,11,1,12,제주특별자치도 서귀포시 상효동 454-4,서귀포시,93,2,126.607235,33.279804999999996
1899,뒤큰글,33.27584,126.60378,246,5,251,244,4,248,제주특별자치도 서귀포시 상효동 162-18,서귀포시,415,4,126.60378,33.27584
1901,고장낭밭,33.27414,126.59935,538,2,540,538,2,540,제주특별자치도 서귀포시 상효동 654-19,서귀포시,416,4,126.59935,33.27414
1903,서상효,33.2728,126.59652,920,11,931,918,9,927,제주특별자치도 서귀포시 상효동 915-1,서귀포시,417,4,126.59652,33.2728
1904,토평반석타운,33.27114,126.59432,120,2,122,120,2,122,제주특별자치도 서귀포시 토평동 176-1,서귀포시,94,2,126.59403499999999,33.270835000000005
1905,토평반석타운,33.27053,126.59375,1515,6,1521,1497,6,1503,제주특별자치도 서귀포시 토평동 176-3,서귀포시,94,2,126.59403499999999,33.270835000000005
1906,토평초등학교,33.26807,126.59055,293,9,302,286,8,294,제주특별자치도 서귀포시 토평동 1278-1,서귀포시,38,3,126.72819,33.29882200000001
1907,토평초등학교,33.268,126.58888,1538,24,1562,1515,23,1538,제주특별자치도 서귀포시 토평동 1304-4,서귀포시,38,3,126.72819,33.29882200000001
1908,한라산교회,33.273109999999996,126.56826000000001,2721,17,2738,2563,16,2579,제주특별자치도 서귀포시 동홍동 953-2,서귀포시,418,4,126.56826000000001,33.273109999999996
1910,동홍분식,33.26676,126.56816,329,5,334,325,5,330,제주특별자치도 서귀포시 동홍동 1073-34,서귀포시,15,1,126.54513299999999,33.261267000000004
1911,동홍분식,33.266709999999996,126.56835,203,1,204,195,1,196,제주특별자치도 서귀포시 동홍동 1042-6,서귀포시,15,1,126.54513299999999,33.261267000000004
1912,동홍동청소년문화의집,33.265879999999996,126.56872,485,5,490,479,5,484,제주특별자치도 서귀포시 동홍동 1126-2,서귀포시,15,1,126.54513299999999,33.261267000000004
1913,동홍동청소년문화의집,33.26608,126.56863,2365,34,2399,2311,33,2344,제주특별자치도 서귀포시 동홍동 1075-5,서귀포시,15,1,126.54513299999999,33.261267000000004
1914,서귀포향토오일시장,33.26574,126.57394,7444,184,7628,7344,174,7518,제주특별자치도 서귀포시 동홍동 807-4,서귀포시,16,1,126.48757857142856,33.25839714285715
1915,서귀포향토오일시장,33.265640000000005,126.57399,468,6,474,465,6,471,제주특별자치도 서귀포시 동홍동 789-3,서귀포시,16,1,126.48757857142856,33.25839714285715
1916,측골,33.267179999999996,126.58332,985,20,1005,977,20,997,제주특별자치도 서귀포시 토평동 2272-7,서귀포시,95,2,126.58330000000001,33.26725
1917,측골,33.26732,126.58328,393,24,417,386,22,408,제주특별자치도 서귀포시 토평동 3245,서귀포시,95,2,126.58330000000001,33.26725
1918,비석거리,33.25613,126.57751999999999,1401,17,1418,1385,17,1402,제주특별자치도 서귀포시 동홍동 657-4,서귀포시,17,1,126.64931,33.30715857142857
1919,비석거리,33.25578,126.57745,18848,1860,20708,18446,1746,20192,제주특별자치도 서귀포시 토평동 867-11,서귀포시,17,1,126.64931,33.30715857142857
1920,답다니,33.25882,126.57983,555,10,565,548,9,557,제주특별자치도 서귀포시 토평동 965-7,서귀포시,96,2,126.57978,33.25886
1921,답다니,33.2589,126.57973,360,5,365,360,5,365,제주특별자치도 서귀포시 토평동 978-3,서귀포시,96,2,126.57978,33.25886
1922,흙통,33.26239,126.5829,478,9,487,475,9,484,제주특별자치도 서귀포시 토평동 2322-6,서귀포시,97,2,126.58259000000001,33.262150000000005
1923,흙통,33.26191,126.58228000000001,591,9,600,583,9,592,제주특별자치도 서귀포시 토평동 2335-7,서귀포시,97,2,126.58259000000001,33.262150000000005
1924,오희준공원,33.26621,126.58549,311,11,322,305,10,315,제주특별자치도 서귀포시 토평동 1200-2,서귀포시,98,2,126.58534499999999,33.266194999999996
1925,오희준공원,33.26618,126.5852,487,9,496,482,9,491,제주특별자치도 서귀포시 토평동 2263-5,서귀포시,98,2,126.58534499999999,33.266194999999996
1926,평안전문요양원,33.28135,126.58845,758,34,792,751,33,784,제주특별자치도 서귀포시 토평동 1700-1,서귀포시,18,1,126.61156714285713,33.30907571428571
1927,평안전문요양원,33.28068,126.58827,2003,64,2067,1979,61,2040,제주특별자치도 서귀포시 토평동 1693-18,서귀포시,18,1,126.61156714285713,33.30907571428571
1929,꽃동산,33.27942,126.58863999999998,73,13,86,71,13,84,제주특별자치도 서귀포시 토평동 1707-1,서귀포시,18,1,126.61156714285713,33.30907571428571
1930,뒷빌레,33.27391,126.58979,258,2,260,257,2,259,제주특별자치도 서귀포시 토평동 1600-1,서귀포시,19,1,126.61672250000001,33.2755
1931,뒷빌레,33.273270000000004,126.58965,2112,10,2122,2103,9,2112,제주특별자치도 서귀포시 토평동 1541-1,서귀포시,19,1,126.61672250000001,33.2755
1932,토평마을회관,33.27192,126.5898,6506,96,6602,6421,94,6515,제주특별자치도 서귀포시 토평동 1426-9,서귀포시,19,1,126.61672250000001,33.2755
1934,토평마을회관,33.27053,126.58975,9919,90,10009,9823,87,9910,제주특별자치도 서귀포시 토평동 1341-10,서귀포시,19,1,126.61672250000001,33.2755
1935,영천동주민센터,33.2688,126.58733000000001,1843,60,1903,1818,60,1878,제주특별자치도 서귀포시 토평동 1310-5,서귀포시,99,2,126.58723,33.26884
1936,영천동주민센터,33.268879999999996,126.58713,2787,45,2832,2750,43,2793,제주특별자치도 서귀포시 토평동 3245,서귀포시,99,2,126.58723,33.26884
1937,L마트,33.2643,126.56003,3707,39,3746,3669,38,3707,제주특별자치도 서귀포시 동홍동 2187,서귀포시,419,4,126.56003,33.2643
1938,주공아파트5단지,33.2646,126.56115,17280,188,17468,17082,180,17262,제주특별자치도 서귀포시 동홍동 1674,서귀포시,420,4,126.56115,33.2646
1939,남주중고등학교,33.2744,126.56615,1647,13,1660,1579,11,1590,제주특별자치도 서귀포시 동홍동 1910-1,서귀포시,100,2,126.56611999999998,33.27464
1940,남주중고등학교,33.274879999999996,126.56608999999999,7773,25,7798,7323,23,7346,제주특별자치도 서귀포시 동홍동 948-1,서귀포시,100,2,126.56611999999998,33.27464
1941,강정천,33.2336,126.48635,273,76,349,258,75,333,제주특별자치도 서귀포시 강정동 5647-1,서귀포시,1,3,126.53914285714286,33.289225714285706
1942,강정천,33.23402,126.4876,1593,140,1733,1483,131,1614,제주특별자치도 서귀포시 강정동 2673-4,서귀포시,1,3,126.53914285714286,33.289225714285706
1943,켄싱턴리조트악근천,33.2344,126.49043,1644,279,1923,1572,263,1835,제주특별자치도 서귀포시 강정동 5628,서귀포시,101,2,126.490625,33.23451
1944,켄싱턴리조트악근천,33.23462,126.49082,782,476,1258,767,462,1229,제주특별자치도 서귀포시 강정동 2626-1,서귀포시,101,2,126.490625,33.23451
1945,서년듸,33.23555,126.49468,489,55,544,475,54,529,제주특별자치도 서귀포시 강정동 2483-3,서귀포시,102,2,126.49478,33.235645000000005
1946,서년듸,33.23574,126.49488000000001,72,25,97,70,21,91,제주특별자치도 서귀포시 강정동 2483-1,서귀포시,102,2,126.49478,33.235645000000005
1947,고향모루,33.23645,126.49823,344,67,411,327,63,390,제주특별자치도 서귀포시 강정동 851-6,서귀포시,103,2,126.49837500000001,33.236414999999994
1948,고향모루,33.23638,126.49852,986,103,1089,929,95,1024,제주특별자치도 서귀포시 강정동 885-2,서귀포시,103,2,126.49837500000001,33.236414999999994
1949,서건도입구,33.23592,126.50313,303,98,401,274,91,365,제주특별자치도 서귀포시 강정동 572-4,서귀포시,20,1,126.50806625,33.26451
1950,서건도입구,33.23584,126.50332,524,139,663,498,119,617,제주특별자치도 서귀포시 강정동 637-3,서귀포시,20,1,126.50806625,33.26451
1951,중문관광단지,33.2522,126.41271,225,249,474,216,231,447,제주특별자치도 서귀포시 색달동 2822-1,서귀포시,21,1,126.55541500000001,33.29999375
1952,(구)중앙파출소,33.2476,126.56088999999999,6742,1686,8428,6505,1563,8068,제주특별자치도 서귀포시 서귀동 341,서귀포시,22,1,126.579643,33.256641
1953,제주은행,33.24807,126.56356000000001,61564,3068,64632,60200,2847,63047,제주특별자치도 서귀포시 서귀동 274-11,서귀포시,421,4,126.56356000000001,33.24807
1954,동미빌딩,33.24866,126.56658,10735,1098,11833,10474,1055,11529,제주특별자치도 서귀포시 서귀동 256-11,서귀포시,23,1,126.52565142857144,33.25023785714286
1955,청소년문화의집,33.25043,126.56505,13303,495,13798,13109,472,13581,제주특별자치도 서귀포시 서귀동 335,서귀포시,35,3,126.55455285714287,33.24852714285714
1956,청소년문화의집,33.25088,126.56405,16525,1595,18120,16318,1519,17837,제주특별자치도 서귀포시 서귀동 279-14,서귀포시,35,3,126.55455285714287,33.24852714285714
1957,중앙로터리,33.25285,126.56058,66471,1887,68358,65446,1794,67240,제주특별자치도 서귀포시 서귀동 336,서귀포시,9,1,126.57550250000001,33.25769583333333
1958,서귀북초등학교,33.26095,126.55896000000001,28605,301,28906,28256,292,28548,제주특별자치도 서귀포시 서홍동 307-3,서귀포시,50,2,126.377458,33.239484000000004
1959,구삼일금고,33.2492,126.56168000000001,13404,681,14085,13218,630,13848,제주특별자치도 서귀포시 서귀동 336,서귀포시,22,1,126.579643,33.256641
1960,오션팰리스호텔,33.24617,126.56208000000001,842,568,1410,826,507,1333,제주특별자치도 서귀포시 서귀동 494-7,서귀포시,104,2,126.561975,33.2461
1961,오션팰리스호텔,33.24603,126.56187,371,269,640,365,254,619,제주특별자치도 서귀포시 서귀동 437-2,서귀포시,104,2,126.561975,33.2461
1962,솔동산입구,33.244609999999994,126.56369,1075,273,1348,1054,258,1312,제주특별자치도 서귀포시 서귀동 961,서귀포시,105,2,126.56368499999999,33.244675
1963,솔동산입구,33.24474,126.56368,1297,449,1746,1243,425,1668,제주특별자치도 서귀포시 서귀동 475-3,서귀포시,105,2,126.56368499999999,33.244675
1964,송산동주민센터,33.24537,126.56561,776,196,972,757,185,942,제주특별자치도 서귀포시 서귀동 553-11,서귀포시,24,1,126.50524000000001,33.24985777777778
1966,서귀포중학교,33.24765,126.56875,825,122,947,797,115,912,제주특별자치도 서귀포시 서귀동 221-14,서귀포시,23,1,126.52565142857144,33.25023785714286
1967,세기아파트,33.25268,126.57523,8461,188,8649,8362,180,8542,제주특별자치도 서귀포시 동홍동 139-11,서귀포시,60,2,126.3705242857143,33.28986428571428
1968,보목포구입구,33.241279999999996,126.60458,371,23,394,362,23,385,제주특별자치도 서귀포시 보목동 470-1,서귀포시,422,4,126.60458,33.241279999999996
1970,칼호텔,33.24797,126.57786999999999,28,38,66,28,37,65,제주특별자치도 서귀포시 동홍동 216-2,서귀포시,25,1,126.5539542857143,33.25205285714286
1971,서귀포중학교,33.247679999999995,126.56906000000001,3299,112,3411,3225,108,3333,제주특별자치도 서귀포시 서귀동 222-3,서귀포시,23,1,126.52565142857144,33.25023785714286
1973,주공2단지,33.2548,126.57252,6244,71,6315,6117,67,6184,제주특별자치도 서귀포시 동홍동 657-5,서귀포시,26,1,126.59011999999998,33.26138428571429
1974,산남새마을금고,33.254909999999995,126.57378,16753,189,16942,16473,185,16658,제주특별자치도 서귀포시 동홍동 657-5,서귀포시,423,4,126.57378,33.254909999999995
1975,동홍초등학교,33.25923,126.57083,459,1,460,446,1,447,제주특별자치도 서귀포시 동홍동 657-1,서귀포시,106,2,126.570505,33.259280000000004
1976,동홍초등학교,33.25933,126.57018000000001,154,1,155,151,1,152,제주특별자치도 서귀포시 동홍동 657-1,서귀포시,106,2,126.570505,33.259280000000004
1977,거문머들,33.256879999999995,126.53424,749,5,754,742,5,747,제주특별자치도 서귀포시 호근동 628-11,서귀포시,424,4,126.53424,33.256879999999995
1979,동문,33.25745,126.53098,257,6,263,257,6,263,제주특별자치도 서귀포시 호근동 2142,서귀포시,107,2,126.53098499999999,33.257385
1980,동문,33.25732,126.53098999999999,1345,52,1397,1320,52,1372,제주특별자치도 서귀포시 호근동 1309-9,서귀포시,107,2,126.53098499999999,33.257385
1981,고갠드르,33.25472,126.52418999999999,1446,84,1530,1412,80,1492,제주특별자치도 서귀포시 서호동 1490,서귀포시,27,1,126.58037818181816,33.28037545454546
1982,남문,33.25257,126.52434,691,6,697,685,5,690,제주특별자치도 서귀포시 서호동 276-2,서귀포시,108,2,126.524275,33.2526
1983,남문,33.252629999999996,126.52421000000001,398,11,409,387,10,397,제주특별자치도 서귀포시 서호동 276-3,서귀포시,108,2,126.524275,33.2526
1984,서호입구,33.24757,126.52423999999999,100,2,102,100,2,102,제주특별자치도 서귀포시 서호동 1539,서귀포시,7,1,126.49492888888888,33.251287777777776
1985,서호입구,33.247640000000004,126.52439,125,5,130,125,5,130,제주특별자치도 서귀포시 서호동 140-2,서귀포시,7,1,126.49492888888888,33.251287777777776
1986,대평리사무소,33.238240000000005,126.36632,32,8,40,32,8,40,제주특별자치도 서귀포시 안덕면 창천리 890-1,서귀포시,425,4,126.36632,33.238240000000005
1988,대평리,33.23492,126.36692,2834,411,3245,2788,393,3181,제주특별자치도 서귀포시 안덕면 창천리 823-2,서귀포시,109,2,126.36692500000001,33.235065
1989,대평리,33.235209999999995,126.36693000000001,5339,606,5945,5235,567,5802,제주특별자치도 서귀포시 안덕면 창천리 876-5,서귀포시,109,2,126.36692500000001,33.235065
1990,하예하동,33.23628,126.37321000000001,16,1,17,16,1,17,제주특별자치도 서귀포시 하예동 1560,서귀포시,110,2,126.37327000000002,33.236205
1991,하예하동,33.236129999999996,126.37333000000001,3089,127,3216,3056,121,3177,제주특별자치도 서귀포시 하예동 1561-1,서귀포시,110,2,126.37327000000002,33.236205
1992,하예중동,33.2416,126.38413,2529,225,2754,2494,210,2704,제주특별자치도 서귀포시 하예동 1962,서귀포시,111,2,126.384145,33.241695
1993,하예중동,33.24179,126.38416000000001,103,18,121,99,17,116,제주특별자치도 서귀포시 하예동 392,서귀포시,111,2,126.384145,33.241695
1994,예래동가동거리,33.245329999999996,126.38805,3375,150,3525,3291,128,3419,제주특별자치도 서귀포시 하예동 266-3,서귀포시,426,4,126.38805,33.245329999999996
1999,벼락동산,33.24783,126.39242,5,2,7,5,1,6,제주특별자치도 서귀포시 상예동 1216-3,서귀포시,28,1,126.43984142857143,33.241957142857146
2000,정문동,33.24938,126.39367,892,17,909,887,15,902,제주특별자치도 서귀포시 상예동 1178-2,서귀포시,29,1,126.48017374999999,33.25316
2001,정문동,33.24965,126.39363,92,2,94,92,2,94,제주특별자치도 서귀포시 상예동 1309-2,서귀포시,29,1,126.48017374999999,33.25316
2002,예래동주민센터,33.25377,126.39771999999999,146,13,159,143,12,155,제주특별자치도 서귀포시 상예동 528,서귀포시,112,2,126.398135,33.25401
2003,예래동주민센터,33.25425,126.39855,2117,92,2209,2086,89,2175,제주특별자치도 서귀포시 상예동 534-4,서귀포시,112,2,126.398135,33.25401
2004,상예입구,33.2576,126.40433999999999,253,44,297,244,42,286,제주특별자치도 서귀포시 색달동 2094-5,서귀포시,0,1,126.51989499999999,33.295381250000005
2005,상예입구,33.2578,126.40448,997,230,1227,984,219,1203,제주특별자치도 서귀포시 색달동 2091-6,서귀포시,0,1,126.51989499999999,33.295381250000005
2007,파라다이스호텔입구,33.24753,126.57692,168,190,358,168,187,355,제주특별자치도 서귀포시 동홍동 317-16,서귀포시,25,1,126.5539542857143,33.25205285714286
2008,서귀포항,33.23977,126.5645,238,92,330,233,91,324,제주특별자치도 서귀포시 서귀동 783-15,서귀포시,30,1,126.48163400000001,33.238526
2009,뉴경남호텔,33.24613,126.55957,49,185,234,49,183,232,제주특별자치도 서귀포시 서귀동 803,서귀포시,22,1,126.579643,33.256641
2010,플레이케이팝박물관,33.25018,126.41343,759,832,1591,731,812,1543,제주특별자치도 서귀포시 색달동 2864-36,서귀포시,20,2,126.50806625,33.26451
2012,하나호텔한국관광공사,33.2502,126.40843000000001,1763,759,2522,1740,722,2462,제주특별자치도 서귀포시 색달동 2822-1,서귀포시,34,1,126.42470875000001,33.250165
2013,신라호텔,33.24775,126.40793000000001,200,784,984,200,784,984,제주특별자치도 서귀포시 색달동 3039-3,서귀포시,34,1,126.42470875000001,33.250165
2014,하얏트호텔,33.24511,126.40579,1188,1424,2612,1186,1415,2601,제주특별자치도 서귀포시 색달동 3039-1,서귀포시,427,4,126.40579,33.24511
2016,동홍동청소년문화의집,33.265209999999996,126.56798,43,1,44,43,1,44,제주특별자치도 서귀포시 동홍동 1137-15,서귀포시,15,1,126.54513299999999,33.261267000000004
2019,아랑조을거리입구,33.25116,126.55937,1542,471,2013,1497,449,1946,제주특별자치도 서귀포시 서귀동 305-11,서귀포시,9,1,126.57550250000001,33.25769583333333
2020,평생학습관,33.2495,126.55807,3572,1643,5215,3460,1522,4982,제주특별자치도 서귀포시 서귀동 337,서귀포시,113,2,126.55803499999999,33.24955
2021,제주국제컨벤션센터,33.2434,126.42466,6235,4484,10719,5968,4340,10308,제주특별자치도 서귀포시 중문동 2507,서귀포시,10,2,126.50737875000002,33.25214
2022,향토오일시장,33.26743,126.57516000000001,721,36,757,711,33,744,제주특별자치도 서귀포시 동홍동 2174,서귀포시,428,4,126.57516000000001,33.26743
2023,대포동,33.24293,126.43168,1179,24,1203,1167,21,1188,제주특별자치도 서귀포시 대포동 1599-1,서귀포시,114,2,126.43175,33.24297
2024,큰솔동산,33.24742,126.43185,293,60,353,286,55,341,제주특별자치도 서귀포시 대포동 760-2,서귀포시,115,2,126.431795,33.24741
2025,큰솔동산,33.2474,126.43173999999999,527,30,557,519,30,549,제주특별자치도 서귀포시 대포동 760-3,서귀포시,115,2,126.431795,33.24741
2026,법환농협,33.23721,126.5121,4067,363,4430,4014,343,4357,제주특별자치도 서귀포시 법환동 1275-5,서귀포시,35,2,126.55455285714287,33.24852714285714
2027,수모루,33.24605,126.52441999999999,940,107,1047,924,100,1024,제주특별자치도 서귀포시 서호동 24-1,서귀포시,7,1,126.49492888888888,33.251287777777776
2028,제석공원,33.24612,126.56731,479,61,540,475,58,533,제주특별자치도 서귀포시 서귀동 961,서귀포시,31,1,126.61406500000001,33.26293875
2029,서귀포YWCA,33.24457,126.56528999999999,1149,52,1201,1141,51,1192,제주특별자치도 서귀포시 서귀동 558-8,서귀포시,24,1,126.50524000000001,33.24985777777778
2030,서귀포초등학교,33.2427,126.56508000000001,2060,139,2199,2052,135,2187,제주특별자치도 서귀포시 서귀동 725-2,서귀포시,24,1,126.50524000000001,33.24985777777778
2031,파인힐호텔,33.24112,126.56464,440,180,620,429,173,602,제주특별자치도 서귀포시 서귀동 782-5,서귀포시,30,1,126.48163400000001,33.238526
2032,천지연폭포입구,33.241209999999995,126.56131,2395,968,3363,2284,916,3200,제주특별자치도 서귀포시 서귀동 961,서귀포시,116,2,126.56139,33.241225
2033,천지연폭포입구,33.241240000000005,126.56147,32,10,42,32,8,40,제주특별자치도 서귀포시 서귀동 659-2,서귀포시,116,2,126.56139,33.241225
2034,서귀포항,33.239779999999996,126.56393,12,3,15,12,3,15,제주특별자치도 서귀포시 서귀동 788-10,서귀포시,30,1,126.48163400000001,33.238526
2035,파인힐호텔,33.24122,126.56453,132,29,161,132,29,161,제주특별자치도 서귀포시 서귀동 776-1,서귀포시,30,1,126.48163400000001,33.238526
2036,송산동주민센터,33.24445,126.56516,112,21,133,109,21,130,제주특별자치도 서귀포시 서귀동 575-2,서귀포시,24,1,126.50524000000001,33.24985777777778
2037,제석공원,33.24608,126.56696000000001,474,87,561,456,82,538,제주특별자치도 서귀포시 서귀동 166-4,서귀포시,31,1,126.61406500000001,33.26293875
2038,천지동주민센터,33.24808,126.5617,8003,615,8618,7950,580,8530,제주특별자치도 서귀포시 서귀동 294-21,서귀포시,22,1,126.579643,33.256641
2039,서귀포농협,33.251529999999995,126.56115,5757,367,6124,5711,352,6063,제주특별자치도 서귀포시 서귀동 297-38,서귀포시,9,1,126.57550250000001,33.25769583333333
2040,서홍새마을금고,33.2641,126.55802,1724,14,1738,1714,14,1728,제주특별자치도 서귀포시 서홍동 256-4,서귀포시,49,2,126.74017666666664,33.30399
2043,앞거리,33.258309999999994,126.42768999999998,75,9,84,75,9,84,제주특별자치도 서귀포시 중문동 1355-5,서귀포시,117,2,126.427595,33.258255
2044,앞거리,33.2582,126.4275,8,2,10,8,2,10,제주특별자치도 서귀포시 중문동 1355-5,서귀포시,117,2,126.427595,33.258255
2051,천제연폭포,33.25353,126.41953000000001,7663,1992,9655,7390,1886,9276,제주특별자치도 서귀포시 중문동 2232,서귀포시,118,2,126.419255,33.25374
2052,중문환승정류장(중문우체국),33.2518,126.4238,30408,1651,32059,29787,1568,31355,제주특별자치도 서귀포시 중문동 2774,서귀포시,119,2,126.423595,33.251845
2053,중문환승정류장(중문우체국),33.25189,126.42339,42736,4231,46967,42024,3987,46011,제주특별자치도 서귀포시 중문동 2087-14,서귀포시,119,2,126.423595,33.251845
2054,중문동,33.25155,126.4269,20697,403,21100,20272,377,20649,제주특별자치도 서귀포시 중문동 2774,서귀포시,120,2,126.42718,33.25159
2055,중문동,33.25163,126.42746000000001,8933,495,9428,8772,472,9244,제주특별자치도 서귀포시 중문동 1965-7,서귀포시,120,2,126.42718,33.25159
2056,중문초등학교,33.25147,126.42981999999999,21231,1106,22337,20916,1045,21961,제주특별자치도 서귀포시 중문동 1905-2,서귀포시,121,2,126.42985,33.25141
2057,중문초등학교,33.25135,126.42988000000001,32391,891,33282,31881,844,32725,제주특별자치도 서귀포시 중문동 2774,서귀포시,121,2,126.42985,33.25141
2058,(구)중문동주민센터,33.25103,126.43435,4382,220,4602,4299,214,4513,제주특별자치도 서귀포시 중문동 2774,서귀포시,122,2,126.43430000000001,33.251085
2059,(구)중문동주민센터,33.25114,126.43425,2536,194,2730,2461,185,2646,제주특별자치도 서귀포시 중문동 1880-2,서귀포시,122,2,126.43430000000001,33.251085
2060,어두모루,33.25162,126.43853,340,84,424,336,81,417,제주특별자치도 서귀포시 대포동 700-2,서귀포시,123,2,126.43852000000001,33.251545
2061,어두모루,33.25147,126.43851000000001,497,45,542,486,41,527,제주특별자치도 서귀포시 대포동 2606-20,서귀포시,123,2,126.43852000000001,33.251545
2062,현대산부인과,33.249179999999996,126.5671,7826,433,8259,7726,415,8141,제주특별자치도 서귀포시 서귀동 335,서귀포시,23,1,126.52565142857144,33.25023785714286
2063,남군농협,33.2482,126.565,23481,621,24102,23108,580,23688,제주특별자치도 서귀포시 서귀동 404-14,서귀포시,429,4,126.565,33.2482
2064,서문로터리입구,33.24727,126.55635,244,94,338,231,92,323,제주특별자치도 서귀포시 서귀동 961-37,서귀포시,430,4,126.55635,33.24727
2065,고갠드르,33.25461,126.52411000000001,338,25,363,331,25,356,제주특별자치도 서귀포시 서호동 302,서귀포시,27,1,126.58037818181816,33.28037545454546
2066,서호새마을금고,33.25727,126.52292,1988,26,2014,1983,26,2009,제주특별자치도 서귀포시 서호동 1490,서귀포시,27,1,126.58037818181816,33.28037545454546
2067,서호동마을회관,33.257290000000005,126.52278999999999,677,17,694,673,17,690,제주특별자치도 서귀포시 서호동 806,서귀포시,27,1,126.58037818181816,33.28037545454546
2068,호근사거리,33.257329999999996,126.52753,3426,36,3462,3396,36,3432,제주특별자치도 서귀포시 호근동 2142,서귀포시,124,2,126.527545,33.25739
2069,호근새마을금고,33.25745,126.52756000000001,1024,40,1064,1012,39,1051,제주특별자치도 서귀포시 호근동 2157,서귀포시,124,2,126.527545,33.25739
2070,용당,33.25523,126.54007,369,20,389,363,19,382,제주특별자치도 서귀포시 호근동 689-12,서귀포시,32,1,126.52956,33.25009
2071,용당,33.25533,126.54014,129,25,154,113,23,136,제주특별자치도 서귀포시 호근동 690-4,서귀포시,32,1,126.52956,33.25009
2072,효돈초등학교,33.26358,126.61695,3117,94,3211,3053,88,3141,제주특별자치도 서귀포시 하효동 140,서귀포시,65,2,126.588856,33.252526
2073,평생학습관,33.2496,126.55799999999999,5247,1663,6910,5072,1508,6580,제주특별자치도 서귀포시 서귀동 326-8,서귀포시,113,2,126.55803499999999,33.24955
2074,신협,33.2642,126.61323999999999,9075,124,9199,8979,121,9100,제주특별자치도 서귀포시 신효동 714-1,서귀포시,431,4,126.61323999999999,33.2642
2075,효례교,33.263659999999994,126.62268,45,4,49,45,4,49,제주특별자치도 서귀포시 하효동 367-13,서귀포시,11,1,126.54324,33.25177125
2078,대한목장,33.3015,126.61407,42,3,45,42,3,45,제주특별자치도 서귀포시 남원읍 하례리 1339-4,서귀포시,432,4,126.61407,33.3015
2080,(구)중앙파출소,33.247,126.56036,2747,368,3115,2673,345,3018,제주특별자치도 서귀포시 서귀동 832-1,서귀포시,22,1,126.579643,33.256641
2081,동홍초등학교입구,33.25857,126.56811,655,1,656,642,1,643,제주특별자치도 서귀포시 동홍동 2174-46,서귀포시,125,2,126.568295,33.258725
2082,아랑조을거리입구,33.25108,126.55955,483,323,806,472,311,783,제주특별자치도 서귀포시 서귀동 337,서귀포시,9,1,126.57550250000001,33.25769583333333
2083,LH아파트,33.24725,126.52281,7902,447,8349,7822,434,8256,제주특별자치도 서귀포시 서호동 968-1,서귀포시,433,4,126.52281,33.24725
2084,아시아CGI애니메이션센터,33.252309999999994,126.56782,1164,2,1166,1150,2,1152,제주특별자치도 서귀포시 동홍동 449,서귀포시,126,2,126.56772,33.25233
2085,아시아CGI애니메이션센터,33.25235,126.56761999999999,1815,15,1830,1799,14,1813,제주특별자치도 서귀포시 동홍동 447-38,서귀포시,126,2,126.56772,33.25233
2086,공업단지입구,33.28412,126.59041,1001,63,1064,982,61,1043,제주특별자치도 서귀포시 토평동 1761-2,서귀포시,127,2,126.590355,33.283815000000004
2087,공업단지입구,33.28351,126.5903,1135,75,1210,1116,71,1187,제주특별자치도 서귀포시 토평동 1716-1,서귀포시,127,2,126.590355,33.283815000000004
2088,동문로터리,33.24868,126.56835,7773,317,8090,7630,306,7936,제주특별자치도 서귀포시 서귀동 216-3,서귀포시,23,1,126.52565142857144,33.25023785714286
2090,반석아르미아파트,33.26251,126.5674,2548,15,2563,2510,15,2525,제주특별자치도 서귀포시 동홍동 1240-4,서귀포시,434,4,126.5674,33.26251
2091,동홍동청소년문화의집,33.265,126.56777,921,11,932,905,11,916,제주특별자치도 서귀포시 동홍동 1137-12,서귀포시,15,1,126.54513299999999,33.261267000000004
2093,고래왓,33.24794,126.51468999999999,2635,552,3187,2566,528,3094,제주특별자치도 서귀포시 법환동 1665-7,서귀포시,2,3,126.4046125,33.26323625
2094,한국콘도입구,33.250240000000005,126.41022,5296,1431,6727,5194,1372,6566,제주특별자치도 서귀포시 색달동 2822-1,서귀포시,33,1,126.48008142857144,33.25181428571429
2095,켄싱턴제주호텔입구,33.250370000000004,126.40992,77,98,175,77,95,172,제주특별자치도 서귀포시 색달동 2822-1,서귀포시,33,1,126.48008142857144,33.25181428571429
2096,신라호텔,33.247479999999996,126.40688999999999,303,18,321,302,16,318,제주특별자치도 서귀포시 색달동 3039-3,서귀포시,435,4,126.40688999999999,33.247479999999996
2097,중문골프장,33.24985,126.40751000000002,44,8,52,43,8,51,제주특별자치도 서귀포시 색달동 2798-7,서귀포시,34,1,126.42470875000001,33.250165
2098,색달,33.25985,126.4057,192,25,217,178,25,203,제주특별자치도 서귀포시 색달동 2138-1,서귀포시,128,2,126.405615,33.259865
2099,색달,33.259879999999995,126.40553,5,4,9,5,4,9,제주특별자치도 서귀포시 색달동 2137-3,서귀포시,128,2,126.405615,33.259865
2100,색달동,33.26177,126.41226999999999,39,7,46,38,6,44,제주특별자치도 서귀포시 색달동 3383,서귀포시,129,2,126.412275,33.26172
2101,색달동,33.26167,126.41228000000001,1453,25,1478,1419,23,1442,제주특별자치도 서귀포시 색달동 1934-2,서귀포시,129,2,126.412275,33.26172
2102,서홍동복지회관,33.263729999999995,126.55038,280,7,287,273,7,280,제주특별자치도 서귀포시 서홍동 1645-1,서귀포시,130,2,126.55084500000001,33.263695
2103,서홍동복지회관,33.263659999999994,126.55131000000002,2170,22,2192,2143,22,2165,제주특별자치도 서귀포시 서홍동 1627-6,서귀포시,130,2,126.55084500000001,33.263695
2104,뉴경남호텔,33.24671,126.55825,1046,3791,4837,1045,3788,4833,제주특별자치도 서귀포시 서귀동 841-2,서귀포시,436,4,126.55825,33.24671
2105,서귀포항,33.23988,126.56421999999999,834,1153,1987,834,1153,1987,제주특별자치도 서귀포시 서귀동 786-16,서귀포시,30,1,126.48163400000001,33.238526
2106,서귀포여자중학교,33.254290000000005,126.54701999999999,6302,123,6425,6101,116,6217,제주특별자치도 서귀포시 서홍동 2576,서귀포시,131,2,126.54672,33.254580000000004
2107,서귀포여자중학교,33.254870000000004,126.54642,2099,233,2332,2035,215,2250,제주특별자치도 서귀포시 서홍동 1335-6,서귀포시,131,2,126.54672,33.254580000000004
2108,남성마을,33.24295,126.55423,33,11,44,33,10,43,제주특별자치도 서귀포시 서홍동 641-1,서귀포시,36,2,126.6409257142857,33.35606571428571
2109,예비군훈련장,33.28808,126.57491,169,4,173,166,4,170,제주특별자치도 서귀포시 토평동 3058-3,서귀포시,437,4,126.57491,33.28808
2111,서귀포칼호텔,33.24694,126.58148999999999,690,1871,2561,690,1871,2561,제주특별자치도 서귀포시 토평동 486-3,서귀포시,132,2,126.58113499999999,33.246975
2113,천지연폭포(종점),33.243109999999994,126.56025,1679,711,2390,1562,664,2226,제주특별자치도 서귀포시 서홍동 689-1,서귀포시,438,4,126.56025,33.243109999999994
2114,스위트호텔,33.24904,126.40767,7848,1567,9415,7706,1459,9165,제주특별자치도 서귀포시 색달동 2798-7,서귀포시,34,1,126.42470875000001,33.250165
2115,보목포구(도착),33.23936,126.60687,493,34,527,479,30,509,제주특별자치도 서귀포시 보목동 566-3,서귀포시,133,2,126.606565,33.239425
2116,열린병원,33.25387,126.56466999999999,4500,42,4542,4446,42,4488,제주특별자치도 서귀포시 서귀동 263-24,서귀포시,134,2,126.56496,33.25401
2117,열린병원,33.25415,126.56525,8705,82,8787,8598,78,8676,제주특별자치도 서귀포시 동홍동 1503-18,서귀포시,134,2,126.56496,33.25401
2120,한국오우퍼빌,33.25758,126.57195,780,2,782,767,1,768,제주특별자치도 서귀포시 동홍동 93-2,서귀포시,439,4,126.57195,33.25758
2122,동홍대림,33.25592,126.57202,682,5,687,667,5,672,제주특별자치도 서귀포시 동홍동 657-5,서귀포시,26,1,126.59011999999998,33.26138428571429
2123,동홍대림,33.25573,126.57212,238,2,240,236,2,238,제주특별자치도 서귀포시 동홍동 657-5,서귀포시,26,1,126.59011999999998,33.26138428571429
2124,감산리,33.26007,126.35693,208,26,234,207,26,233,제주특별자치도 서귀포시 안덕면 감산리 1947,서귀포시,135,2,126.356975,33.259935
2125,안덕계곡,33.25816,126.35336000000001,2317,116,2433,2292,112,2404,제주특별자치도 서귀포시 안덕면 감산리 346,서귀포시,24,3,126.50524000000001,33.24985777777778
2126,감산리,33.2598,126.35701999999999,933,66,999,919,62,981,제주특별자치도 서귀포시 안덕면 감산리 299-1,서귀포시,135,2,126.356975,33.259935
2127,창천리남당물동산,33.26168,126.36617,3408,681,4089,3368,654,4022,제주특별자치도 서귀포시 안덕면 창천리 365-2,서귀포시,34,3,126.42470875000001,33.250165
2128,창천리남당물동산,33.2617,126.36731999999999,515,40,555,510,40,550,제주특별자치도 서귀포시 안덕면 창천리 434-1,서귀포시,34,3,126.42470875000001,33.250165
2129,창천초등학교,33.2641,126.37078000000001,1037,319,1356,1002,312,1314,제주특별자치도 서귀포시 안덕면 창천리 1440,서귀포시,2,1,126.4046125,33.26323625
2130,창천초등학교,33.264759999999995,126.37104,56,13,69,54,12,66,제주특별자치도 서귀포시 안덕면 창천리 155-46,서귀포시,2,1,126.4046125,33.26323625
2132,강창학종합경기장,33.26178,126.50146000000001,1242,351,1593,1242,351,1593,제주특별자치도 서귀포시 강정동 1515-3,서귀포시,136,2,126.501455,33.261700000000005
2133,강창학종합경기장,33.26162,126.50145,1259,79,1338,1241,66,1307,제주특별자치도 서귀포시 강정동 1515-2,서귀포시,136,2,126.501455,33.261700000000005
2134,숨비나리,33.2839,126.35415,438,275,713,413,255,668,제주특별자치도 서귀포시 안덕면 상창리 1946-1,서귀포시,137,2,126.354185,33.283965
2135,숨비나리,33.28403,126.35422,495,221,716,450,201,651,제주특별자치도 서귀포시 안덕면 상창리 1946-1,서귀포시,137,2,126.354185,33.283965
2136,상창리사무소,33.27268,126.36505,469,78,547,462,72,534,제주특별자치도 서귀포시 안덕면 상창리 646-8,서귀포시,440,4,126.36505,33.27268
2137,천제연폭포,33.25395,126.41898,4516,1647,6163,4314,1563,5877,제주특별자치도 서귀포시 중문동 1489-15,서귀포시,118,2,126.419255,33.25374
2138,중문사거리,33.25164,126.43151999999999,30,8,38,30,8,38,제주특별자치도 서귀포시 중문동 1789,서귀포시,8,2,126.56943375,33.28377125
2139,비석거리,33.25427,126.57672,638,122,760,629,119,748,제주특별자치도 서귀포시 토평동 824-2,서귀포시,35,1,126.55455285714287,33.24852714285714
2140,동문로터리,33.24859,126.56853000000001,34548,4399,38947,33712,4143,37855,제주특별자치도 서귀포시 서귀동 216-21,서귀포시,23,1,126.52565142857144,33.25023785714286
2141,안덕계곡,33.25786,126.35238000000001,2208,136,2344,2179,128,2307,제주특별자치도 서귀포시 안덕면 감산리 362-7,서귀포시,24,3,126.50524000000001,33.24985777777778
2151,안좌동,33.35837,126.75583,71,1,72,71,1,72,제주특별자치도 서귀포시 표선면 가시리 2966-1,서귀포시,441,4,126.75583,33.35837
2155,토산1리리사무소,33.32595,126.76588999999998,323,8,331,323,7,330,제주특별자치도 서귀포시 표선면 토산리 1377-4,서귀포시,138,2,126.76580999999999,33.32595
2159,동광단지,33.31388,126.35938999999999,154,45,199,153,44,197,제주특별자치도 서귀포시 안덕면 동광리 74-34,서귀포시,139,2,126.35952499999999,33.313874999999996
2161,월광동,33.29311,126.2551,39,2,41,39,2,41,제주특별자치도 서귀포시 대정읍 무릉리 13,서귀포시,442,4,126.2551,33.29311
2162,산양곶자왈,33.29072,126.25085,54,9,63,54,9,63,제주특별자치도 제주시 한경면 청수리 955-2,제주시,231,2,126.25082499999999,33.29076
2165,신도2리,33.2777,126.17565,24,4,28,23,4,27,제주특별자치도 서귀포시 대정읍 신도리 2606-2,서귀포시,140,2,126.17566,33.277665
2166,신도2리,33.27763,126.17567,57,4,61,57,3,60,제주특별자치도 서귀포시 대정읍 신도리 2566-1,서귀포시,140,2,126.17566,33.277665
2169,평지동옹기박물관,33.28242,126.2235,24,1,25,24,1,25,제주특별자치도 서귀포시 대정읍 무릉리 933-22,서귀포시,141,2,126.22365500000001,33.282295000000005
2170,좌기동,33.2747,126.23404,39,9,48,39,9,48,제주특별자치도 서귀포시 대정읍 무릉리 616-26,서귀포시,142,2,126.234145,33.27462
2173,산이수동,33.20847,126.29025,339,133,472,329,127,456,제주특별자치도 서귀포시 대정읍 상모리 125-1,서귀포시,143,2,126.29018500000001,33.20841
2174,새소망요양병원,33.27882,126.36135,27,23,50,27,19,46,제주특별자치도 서귀포시 안덕면 상창리 2885,서귀포시,144,2,126.36137,33.278745
2175,새소망요양병원,33.27867,126.36138999999999,13,22,35,13,20,33,제주특별자치도 서귀포시 안덕면 상창리 1276-3,서귀포시,144,2,126.36137,33.278745
2176,한밭입구,33.251059999999995,126.35806000000001,30,8,38,30,7,37,제주특별자치도 서귀포시 안덕면 감산리 554,서귀포시,145,2,126.358115,33.251239999999996
2177,한밭입구,33.25142,126.35817,19,2,21,19,2,21,제주특별자치도 서귀포시 안덕면 감산리 555,서귀포시,145,2,126.358115,33.251239999999996
2178,광평리,33.3293,126.38198,223,19,242,213,17,230,제주특별자치도 서귀포시 안덕면 광평리 205-23,서귀포시,443,4,126.38198,33.3293
2179,상천리사무소,33.30743,126.3798,204,24,228,202,23,225,제주특별자치도 서귀포시 안덕면 상천리 472-2,서귀포시,146,2,126.379895,33.30732999999999
2180,상천리사무소,33.30723,126.37998999999999,160,332,492,148,316,464,제주특별자치도 서귀포시 안덕면 상천리 471-1,서귀포시,146,2,126.379895,33.30732999999999
2185,토산초등학교,33.31185,126.77648,10,1,11,10,1,11,제주특별자치도 서귀포시 표선면 토산리 506-5,서귀포시,444,4,126.77648,33.31185
2186,토산초등학교,33.31007,126.7769,54,7,61,54,7,61,제주특별자치도 서귀포시 표선면 토산리 519-10,서귀포시,147,2,126.776965,33.309965000000005
2187,토산초등학교,33.30986,126.77703000000001,8,1,9,8,1,9,제주특별자치도 서귀포시 표선면 토산리 519-5,서귀포시,147,2,126.776965,33.309965000000005
2192,하천리몰고랑터,33.35382,126.83679,472,1,473,472,1,473,제주특별자치도 서귀포시 표선면 하천리 788-2,서귀포시,445,4,126.83679,33.35382
2195,하천상동회관앞,33.3528,126.8389,444,3,447,444,3,447,제주특별자치도 서귀포시 표선면 하천리 725-4,서귀포시,446,4,126.8389,33.3528
2199,하천리세골세,33.34935,126.84028,34,1,35,33,1,34,제주특별자치도 서귀포시 표선면 하천리 563-2,서귀포시,447,4,126.84028,33.34935
2201,하천리중동,33.347229999999996,126.84062,865,1,866,865,1,866,제주특별자치도 서귀포시 표선면 하천리 496-2,서귀포시,448,4,126.84062,33.347229999999996
2202,물진밭입구,33.371,126.86158,110,76,186,101,74,175,제주특별자치도 서귀포시 성산읍 삼달리 108-6,서귀포시,148,2,126.86159,33.37104
2203,물진밭입구,33.37108,126.8616,44,7,51,43,6,49,제주특별자치도 서귀포시 성산읍 삼달리 105-2,서귀포시,148,2,126.86159,33.37104
2204,삼달1리삼달보건진료소,33.37325,126.85217,368,17,385,368,14,382,제주특별자치도 서귀포시 성산읍 삼달리 434-6,서귀포시,149,2,126.85220000000001,33.373189999999994
2205,삼달1리삼달보건진료소,33.373129999999996,126.85223,358,10,368,357,10,367,제주특별자치도 서귀포시 성산읍 삼달리 448-2,서귀포시,149,2,126.85220000000001,33.373189999999994
2206,삼달1리사무소,33.37421,126.8481,343,19,362,343,15,358,제주특별자치도 서귀포시 성산읍 삼달리 726-1,서귀포시,150,2,126.84813,33.374134999999995
2207,삼달1리,33.37406,126.84816,105,4,109,105,4,109,제주특별자치도 서귀포시 성산읍 삼달리 729-3,서귀포시,150,2,126.84813,33.374134999999995
2209,수산2리비석거리,33.4396,126.86506999999999,293,31,324,293,30,323,제주특별자치도 서귀포시 성산읍 수산리 2481-2,서귀포시,151,2,126.8651,33.439674999999994
2211,수산2리퐁낭거리,33.44113,126.86193,163,7,170,162,7,169,제주특별자치도 서귀포시 성산읍 수산리 4764,서귀포시,152,2,126.861805,33.44108
2214,수산1리비석거리,33.44354000000001,126.88843999999999,55,37,92,55,36,91,제주특별자치도 서귀포시 성산읍 수산리 4764,서귀포시,36,1,126.6409257142857,33.35606571428571
2215,고성리장만이동산,33.44555,126.90047,597,169,766,577,162,739,제주특별자치도 서귀포시 성산읍 고성리 2088,서귀포시,153,2,126.900575,33.445449999999994
2216,고성리장만이동산,33.44535,126.90068000000001,392,428,820,376,420,796,제주특별자치도 서귀포시 성산읍 고성리 2087-6,서귀포시,153,2,126.900575,33.445449999999994
2217,고성리노인회관,33.44662,126.90875,291,57,348,286,56,342,제주특별자치도 서귀포시 성산읍 고성리 1472-4,서귀포시,154,2,126.9087,33.446685
2218,고성리노인회관,33.44675,126.90865,1354,96,1450,1328,93,1421,제주특별자치도 서귀포시 성산읍 고성리 1485-2,서귀포시,154,2,126.9087,33.446685
2219,그린카센터,33.31698,126.82857,340,41,381,333,37,370,제주특별자치도 서귀포시 표선면 표선리 1461-4,서귀포시,155,2,126.82861500000001,33.316925
2221,성산항,33.47032,126.93008,475,283,758,436,272,708,제주특별자치도 서귀포시 성산읍 성산리 347-16,서귀포시,156,2,126.93001,33.470375000000004
2222,삼달1리삼거리,33.371159999999996,126.84138999999999,200,5,205,199,5,204,제주특별자치도 서귀포시 성산읍 삼달리 2260,서귀포시,157,2,126.8415,33.37128
2223,신풍리사거리,33.36458,126.83538999999999,145,12,157,130,12,142,제주특별자치도 서귀포시 성산읍 신풍리 1728,서귀포시,158,2,126.835335,33.364615
2224,신풍리사무소,33.36172,126.83623,258,17,275,257,16,273,제주특별자치도 서귀포시 성산읍 신풍리 797,서귀포시,159,2,126.835925,33.36123
2225,신풍리화단이소,33.35848,126.8371,122,4,126,122,4,126,제주특별자치도 서귀포시 성산읍 신풍리 882-2,서귀포시,449,4,126.8371,33.35848
2226,신풍리사무소,33.36074,126.83561999999999,666,19,685,662,19,681,제주특별자치도 서귀포시 성산읍 신풍리 746-1,서귀포시,159,2,126.835925,33.36123
2227,삼달1리삼거리,33.3714,126.84161,416,4,420,411,4,415,제주특별자치도 서귀포시 성산읍 삼달리 1223-2,서귀포시,157,2,126.8415,33.37128
2228,가시리,33.36135,126.76687,169,5,174,169,5,174,제주특별자치도 서귀포시 표선면 가시리 2502-2,서귀포시,160,2,126.76674,33.361395
2230,신풍리사거리,33.36465,126.83528000000001,304,6,310,304,6,310,제주특별자치도 서귀포시 성산읍 신풍리 1728,서귀포시,158,2,126.835335,33.364615
2231,삼달1리,33.37397,126.84318,107,13,120,106,12,118,제주특별자치도 서귀포시 성산읍 삼달리 1152-13,서귀포시,161,2,126.84324000000001,33.374120000000005
2232,성읍1리,33.39208,126.80026000000001,602,26,628,594,26,620,제주특별자치도 서귀포시 표선면 성읍리 3294,서귀포시,37,1,126.728285,33.33050375
2233,표선환승정류장(표선면사무소),33.3265,126.83218000000001,2200,100,2300,2163,91,2254,제주특별자치도 서귀포시 표선면 표선리 699,서귀포시,38,1,126.72819,33.29882200000001
2236,가시농협,33.35263,126.77147,505,11,516,499,11,510,제주특별자치도 서귀포시 표선면 가시리 2015-4,서귀포시,39,1,126.71906142857142,33.322051428571434
2237,제주민속촌,33.32474000000001,126.84236000000001,775,48,823,758,36,794,제주특별자치도 서귀포시 표선면 표선리 40,서귀포시,31,3,126.61406500000001,33.26293875
2238,영락리,33.257909999999995,126.21001000000001,267,18,285,266,16,282,제주특별자치도 서귀포시 대정읍 영락리 2169,서귀포시,162,2,126.21017,33.257495
2239,감산리서동,33.2567,126.34952,18,8,26,17,1,18,제주특별자치도 서귀포시 안덕면 감산리 1471-1,서귀포시,163,2,126.34909,33.256755
2240,성산포수협,33.448879999999996,126.91644,1064,881,1945,1009,835,1844,제주특별자치도 서귀포시 성산읍 고성리 298-2,서귀포시,164,2,126.91622,33.44878
2241,신흥리취락구조,33.29873,126.76482,1027,19,1046,1017,18,1035,제주특별자치도 서귀포시 남원읍 신흥리 632-38,서귀포시,165,2,126.76486500000001,33.29866
2242,표선환승정류장(표선리사무소),33.32528,126.83246000000001,14539,925,15464,14335,873,15208,제주특별자치도 서귀포시 표선면 표선리 631-6,서귀포시,38,1,126.72819,33.29882200000001
2243,고성리제주은행,33.448679999999996,126.916,13733,3115,16848,13412,3000,16412,제주특별자치도 서귀포시 성산읍 고성리 316-2,서귀포시,164,2,126.91622,33.44878
2244,하모3리,33.221579999999996,126.25107,14469,526,14995,14314,497,14811,제주특별자치도 서귀포시 대정읍 하모리 1029-1,서귀포시,40,1,126.4694525,33.254366250000004
2246,하모2리,33.22146,126.25277,22909,1327,24236,22490,1240,23730,제주특별자치도 서귀포시 대정읍 하모리 921-19,서귀포시,40,1,126.4694525,33.254366250000004
2247,일과1리,33.2351,126.23592,18,15,33,18,14,32,제주특별자치도 서귀포시 대정읍 일과리 1954-1,서귀포시,30,3,126.48163400000001,33.238526
2248,일과2리사무소,33.2452,126.22381000000001,922,19,941,901,18,919,제주특별자치도 서귀포시 대정읍 일과리 1954,서귀포시,166,2,126.22398000000001,33.245279999999994
2249,안성리사무소앞,33.249340000000004,126.28126999999999,598,24,622,592,22,614,제주특별자치도 서귀포시 대정읍 안성리 1589,서귀포시,167,2,126.28161,33.249365000000004
2250,대정농공단지입구,33.24807,126.22026000000001,545,33,578,537,32,569,제주특별자치도 서귀포시 대정읍 일과리 1838-4,서귀포시,168,2,126.22033,33.24813
2251,대정농공단지입구,33.24819,126.2204,186,26,212,181,26,207,제주특별자치도 서귀포시 대정읍 일과리 1954-3,서귀포시,168,2,126.22033,33.24813
2252,불미거동산,33.317679999999996,126.74501000000001,60,3,63,59,3,62,제주특별자치도 서귀포시 남원읍 신흥리 1586-3,서귀포시,41,1,126.57285857142858,33.27642285714286
2254,옛성정문,33.31817,126.74521000000001,197,2,199,197,2,199,제주특별자치도 서귀포시 남원읍 신흥리 1593-1,서귀포시,41,1,126.57285857142858,33.27642285714286
2261,신흥1리사무소,33.305170000000004,126.76581000000002,95,1,96,95,1,96,제주특별자치도 서귀포시 남원읍 신흥리 245-2,서귀포시,450,4,126.76581000000002,33.305170000000004
2263,남원농협신흥지소,33.30238,126.76703,178,2,180,178,2,180,제주특별자치도 서귀포시 남원읍 신흥리 217-2,서귀포시,169,2,126.76708,33.302395
2264,남원농협신흥지소,33.302409999999995,126.76713000000001,177,4,181,173,4,177,제주특별자치도 서귀포시 남원읍 신흥리 217-2,서귀포시,169,2,126.76708,33.302395
2265,거물여,33.33227,126.8005,71,3,74,71,1,72,제주특별자치도 서귀포시 표선면 세화리 2489,서귀포시,170,2,126.8006,33.332225
2266,거물여,33.33218,126.8007,479,18,497,477,14,491,제주특별자치도 서귀포시 표선면 세화리 1049-1,서귀포시,170,2,126.8006,33.332225
2267,세화1리마을회관,33.331759999999996,126.79836,131,6,137,131,6,137,제주특별자치도 서귀포시 표선면 세화리 1122-1,서귀포시,171,2,126.79837,33.331705
2268,세화1리마을회관,33.33165,126.79838000000001,882,5,887,876,4,880,제주특별자치도 서귀포시 표선면 세화리 1086-2,서귀포시,171,2,126.79837,33.331705
2270,세화1리북문,33.33266,126.79538000000001,124,2,126,123,2,125,제주특별자치도 서귀포시 표선면 세화리 1989-4,서귀포시,451,4,126.79538000000001,33.33266
2271,남원리월산동,33.29153,126.71058000000001,302,8,310,301,8,309,제주특별자치도 서귀포시 남원읍 남원리 1058-6,서귀포시,172,2,126.71064000000001,33.291575
2272,남원리월산동,33.29162,126.7107,158,1,159,156,1,157,제주특별자치도 서귀포시 남원읍 남원리 2490,서귀포시,172,2,126.71064000000001,33.291575
2273,일과2리서림수원지입구,33.243390000000005,126.22758,54,6,60,53,6,59,제주특별자치도 서귀포시 대정읍 일과리 1472-3,서귀포시,173,2,126.22800000000001,33.24306
2274,안덕초등학교,33.25007,126.33507,38,1,39,37,1,38,제주특별자치도 서귀포시 안덕면 화순리 1128-9,서귀포시,174,2,126.33510000000001,33.250125
2275,안덕초등학교,33.25018,126.33513,1163,23,1186,1143,23,1166,제주특별자치도 서귀포시 안덕면 화순리 1290,서귀포시,174,2,126.33510000000001,33.250125
2276,산방산,33.2368,126.31057,486,210,696,441,201,642,제주특별자치도 서귀포시 안덕면 사계리 190-2,서귀포시,42,1,126.39550200000001,33.246428
2277,안성리,33.249390000000005,126.28195,704,58,762,696,58,754,제주특별자치도 서귀포시 대정읍 안성리 2038,서귀포시,167,2,126.28161,33.249365000000004
2278,인성리(남문지앞사거리),33.247859999999996,126.27762,2671,481,3152,2630,453,3083,제주특별자치도 서귀포시 대정읍 인성리 365-1,서귀포시,43,1,126.34861,33.252337142857144
2279,하모3리 축협,33.22531,126.2524,2073,359,2432,2048,341,2389,제주특별자치도 서귀포시 대정읍 하모리 1423-20,서귀포시,44,1,126.32166500000001,33.234591249999994
2279,하모3리 축협,33.22531,126.2524,2073,359,2432,2048,341,2389,제주특별자치도 서귀포시 대정읍 하모리 1423-20,서귀포시,44,1,126.32166500000001,33.234591249999994
2279,하모3리축협,33.22531,126.2524,2073,359,2432,2048,341,2389,제주특별자치도 서귀포시 대정읍 하모리 1423-20,서귀포시,44,1,126.32166500000001,33.234591249999994
2279,하모3리축협,33.22531,126.2524,2073,359,2432,2048,341,2389,제주특별자치도 서귀포시 대정읍 하모리 1423-20,서귀포시,44,1,126.32166500000001,33.234591249999994
2280,인성리(남문지앞사거리),33.2479,126.27734,1973,131,2104,1930,126,2056,제주특별자치도 서귀포시 대정읍 인성리 255-1,서귀포시,43,1,126.34861,33.252337142857144
2281,서귀포자연휴양림,33.31185,126.45751000000001,392,103,495,369,81,450,제주특별자치도 서귀포시 대포동 산 1-7,서귀포시,175,2,126.45751000000001,33.311930000000004
2282,거린사슴전망대,33.3076,126.45498,17,5,22,15,5,20,제주특별자치도 서귀포시 대포동 산 2-5,서귀포시,176,2,126.45485500000001,33.307615
2283,법정사입구,33.3028,126.45845,154,19,173,150,19,169,제주특별자치도 서귀포시 대포동 산 6-5,서귀포시,177,2,126.458335,33.302620000000005
2285,수산초등학교,33.44625,126.88632,436,48,484,434,46,480,제주특별자치도 서귀포시 성산읍 수산리 4764,서귀포시,178,2,126.88624,33.4463
2289,가시리사무소,33.35303,126.77152,114,18,132,106,16,122,제주특별자치도 서귀포시 표선면 가시리 3805,서귀포시,39,1,126.71906142857142,33.322051428571434
2290,가시농협,33.35269,126.7716,694,21,715,691,21,712,제주특별자치도 서귀포시 표선면 가시리 2009-2,서귀포시,39,1,126.71906142857142,33.322051428571434
2291,가시리동하동,33.35014,126.7739,154,2,156,151,1,152,제주특별자치도 서귀포시 표선면 가시리 3806,서귀포시,179,2,126.77390500000001,33.350195
2292,가시리동하동,33.35025,126.77391000000001,138,16,154,138,10,148,제주특별자치도 서귀포시 표선면 가시리 2050,서귀포시,179,2,126.77390500000001,33.350195
2294,토산1리운동장,33.33283,126.76893999999999,34,9,43,34,9,43,제주특별자치도 서귀포시 표선면 토산리 2057,서귀포시,180,2,126.76901999999998,33.332750000000004
2295,토산1리운동장입구,33.33267,126.7691,34,3,37,34,3,37,제주특별자치도 서귀포시 표선면 토산리 2057,서귀포시,180,2,126.76901999999998,33.332750000000004
2296,토산1리노인회관앞,33.32963,126.7704,313,1,314,313,1,314,제주특별자치도 서귀포시 표선면 토산리 936-2,서귀포시,452,4,126.7704,33.32963
2297,토산보건소동쪽,33.32748,126.76815,44,1,45,44,1,45,제주특별자치도 서귀포시 표선면 토산리 1434-2,서귀포시,181,2,126.76783,33.32698
2298,토산1리리사무소앞,33.32595,126.76573,418,11,429,413,10,423,제주특별자치도 서귀포시 표선면 토산리 1376-3,서귀포시,138,2,126.76580999999999,33.32595
2302,신흥2리보건진료소,33.3197,126.74796,249,19,268,248,19,267,제주특별자치도 서귀포시 남원읍 신흥리 1770-10,서귀포시,182,2,126.748065,33.319694999999996
2303,신흥2리보건진료소,33.31969,126.74817,155,9,164,154,9,163,제주특별자치도 서귀포시 남원읍 신흥리 1770-6,서귀포시,182,2,126.748065,33.319694999999996
2304,신흥2리사무소,33.32173,126.74543,183,1,184,183,1,184,제주특별자치도 서귀포시 남원읍 신흥리 1784-2,서귀포시,183,2,126.745395,33.32166
2305,신흥2리사무소,33.32159,126.74536,128,2,130,128,2,130,제주특별자치도 서귀포시 남원읍 신흥리 1756-5,서귀포시,183,2,126.745395,33.32166
2309,무릉2리소공원,33.27234,126.24558,159,4,163,156,3,159,제주특별자치도 서귀포시 대정읍 무릉리 산 65-14,서귀포시,184,2,126.245645,33.272315000000006
2310,좌기동,33.27454,126.23425,543,18,561,536,18,554,제주특별자치도 서귀포시 대정읍 무릉리 605-15,서귀포시,142,2,126.234145,33.27462
2311,평지동,33.28078,126.22646999999999,226,4,230,226,4,230,제주특별자치도 서귀포시 대정읍 무릉리 965-2,서귀포시,185,2,126.22646,33.28096
2312,평지동,33.28114,126.22645,46,2,48,46,2,48,제주특별자치도 서귀포시 대정읍 무릉리 965-16,서귀포시,185,2,126.22646,33.28096
2313,평지동옹기박물관,33.28217,126.22381000000001,254,2,256,254,2,256,제주특별자치도 서귀포시 대정읍 무릉리 945-3,서귀포시,141,2,126.22365500000001,33.282295000000005
2314,응전동,33.28295,126.30022,183,5,188,182,5,187,제주특별자치도 서귀포시 안덕면 서광리 2471,서귀포시,186,2,126.300295,33.28295
2315,응전동,33.28295,126.30037,58,7,65,58,7,65,제주특별자치도 서귀포시 안덕면 서광리 2140-4,서귀포시,186,2,126.300295,33.28295
2316,덕수도련동,33.26498,126.30442,107,7,114,99,7,106,제주특별자치도 서귀포시 안덕면 덕수리 1967-2,서귀포시,187,2,126.30455,33.265015000000005
2317,덕수도련동,33.26505,126.30468,91,8,99,90,6,96,제주특별자치도 서귀포시 안덕면 덕수리 1969-1,서귀포시,187,2,126.30455,33.265015000000005
2318,덕수리새마을금고,33.25672,126.30458999999999,184,4,188,183,4,187,제주특별자치도 서귀포시 안덕면 덕수리 2153-7,서귀포시,188,2,126.30447999999998,33.256655
2319,덕수리새마을금고,33.25659,126.30436999999999,151,5,156,147,5,152,제주특별자치도 서귀포시 안덕면 덕수리 2137-1,서귀포시,188,2,126.30447999999998,33.256655
2320,불미공방,33.25349,126.30433000000001,274,6,280,273,6,279,제주특별자치도 서귀포시 안덕면 덕수리 2330-9,서귀포시,189,2,126.304175,33.25336
2321,불미공방,33.25323,126.30402,207,6,213,206,6,212,제주특별자치도 서귀포시 안덕면 덕수리 3004,서귀포시,189,2,126.304175,33.25336
2322,해병부대,33.231,126.26273,3082,196,3278,2978,194,3172,제주특별자치도 서귀포시 대정읍 상모리 3396-2,서귀포시,190,2,126.262315,33.230675000000005
2323,제주조각공원,33.24901,126.32132,11,1,12,11,1,12,제주특별자치도 서귀포시 안덕면 사계리 3606,서귀포시,48,1,126.41514200000002,33.255396
2324,골물동입구,33.25095,126.33397,91,5,96,90,5,95,제주특별자치도 서귀포시 안덕면 화순리 1234-3,서귀포시,453,4,126.33397,33.25095
2325,상수동,33.25626,126.33525,76,4,80,76,4,80,제주특별자치도 서귀포시 안덕면 화순리 1686-4,서귀포시,191,2,126.335185,33.256265
2332,한남농장,33.29913,126.6814,34,1,35,34,1,35,제주특별자치도 서귀포시 남원읍 한남리 480-24,서귀포시,454,4,126.6814,33.29913
2340,난산리사무소,33.40124,126.87116,1041,5,1046,1040,5,1045,제주특별자치도 서귀포시 성산읍 난산리 1075-3,서귀포시,455,4,126.87116,33.40124
2343,난산동동네,33.40206,126.8758,733,3,736,733,3,736,제주특별자치도 서귀포시 성산읍 난산리 373-4,서귀포시,456,4,126.8758,33.40206
2346,성산리입구,33.46067,126.93132,1073,413,1486,1034,391,1425,제주특별자치도 서귀포시 성산읍 성산리 400-3,서귀포시,192,2,126.931295,33.46076
2347,성산리입구,33.46085,126.93127,4826,1075,5901,4690,1025,5715,제주특별자치도 서귀포시 성산읍 성산리 168-11,서귀포시,192,2,126.931295,33.46076
2348,성산일출봉입구,33.462709999999994,126.93303,4949,3680,8629,4600,3490,8090,제주특별자치도 서귀포시 성산읍 성산리 178-12,서귀포시,193,2,126.9334,33.463235
2349,성산일출봉입구,33.46376,126.93377,17064,8548,25612,16023,7993,24016,제주특별자치도 서귀포시 성산읍 성산리 229-2,서귀포시,193,2,126.9334,33.463235
2350,성산리,33.46521,126.93518999999999,1034,1021,2055,961,975,1936,제주특별자치도 서귀포시 성산읍 성산리 284-3,서귀포시,45,1,126.77516600000001,33.384221999999994
2351,성산리취락구조,33.466029999999996,126.9349,788,495,1283,734,472,1206,제주특별자치도 서귀포시 성산읍 성산리 299-1,서귀포시,45,1,126.77516600000001,33.384221999999994
2352,성산리취락구조,33.466029999999996,126.93441000000001,317,135,452,302,129,431,제주특별자치도 서귀포시 성산읍 성산리 261-8,서귀포시,45,1,126.77516600000001,33.384221999999994
2353,성산항입구,33.4682,126.92955,4591,3096,7687,4264,2915,7179,제주특별자치도 서귀포시 성산읍 성산리 369-3,서귀포시,194,2,126.92936,33.468345
2354,성산항입구,33.46849,126.92917,5286,4318,9604,4790,4049,8839,제주특별자치도 서귀포시 성산읍 성산리 363,서귀포시,194,2,126.92936,33.468345
2355,성산항,33.47043,126.92993999999999,12214,8383,20597,10718,7584,18302,제주특별자치도 서귀포시 성산읍 성산리 347-5,서귀포시,156,2,126.93001,33.470375000000004
2356,오조해녀의집,33.46885,126.92253000000001,1272,376,1648,1205,364,1569,제주특별자치도 서귀포시 성산읍 오조리 2-4,서귀포시,195,2,126.922425,33.468775
2357,오조해녀의집,33.4687,126.92232,471,326,797,442,310,752,제주특별자치도 서귀포시 성산읍 오조리 2-5,서귀포시,195,2,126.922425,33.468775
2358,성산고입구삼거리,33.46545,126.90916999999999,129,78,207,125,77,202,제주특별자치도 서귀포시 성산읍 오조리 618-4,서귀포시,46,1,126.76076599999999,33.384136
2359,오조리,33.46712,126.91305,337,124,461,328,119,447,제주특별자치도 서귀포시 성산읍 오조리 623-3,서귀포시,196,2,126.91325,33.467135
2360,오조리입구,33.46715,126.91345,204,152,356,194,150,344,제주특별자치도 서귀포시 성산읍 오조리 268-1,서귀포시,196,2,126.91325,33.467135
2361,성산고등학교,33.46845,126.91673999999999,1418,249,1667,1329,238,1567,제주특별자치도 서귀포시 성산읍 오조리 337-1,서귀포시,197,2,126.91676,33.468515
2362,성산고등학교,33.468579999999996,126.91678,1667,234,1901,1591,225,1816,제주특별자치도 서귀포시 성산읍 오조리 2210,서귀포시,197,2,126.91676,33.468515
2364,모슬포우체국,33.22255,126.25518999999998,431,56,487,425,55,480,제주특별자치도 서귀포시 대정읍 하모리 820-1,서귀포시,198,2,126.255335,33.222539999999995
2365,덕수초등학교,33.25023,126.30357,693,136,829,681,132,813,제주특별자치도 서귀포시 안덕면 사계리 757-1,서귀포시,47,1,126.387708,33.254452
2366,제주조각공원,33.249309999999994,126.32133,296,12,308,294,11,305,제주특별자치도 서귀포시 안덕면 사계리 3591-4,서귀포시,48,1,126.41514200000002,33.255396
2367,상수동,33.25627,126.33511999999999,44,5,49,44,5,49,제주특별자치도 서귀포시 안덕면 화순리 1688-1,서귀포시,191,2,126.335185,33.256265
2368,신풍입구,33.361309999999996,126.82042,1490,44,1534,1477,43,1520,제주특별자치도 서귀포시 표선면 하천리 2611,서귀포시,199,2,126.820435,33.36118
2369,신풍입구,33.36105,126.82045,9,1,10,9,1,10,제주특별자치도 서귀포시 표선면 하천리 1451-6,서귀포시,199,2,126.820435,33.36118
2370,하천리마을입구,33.35399,126.82377,1222,35,1257,1203,33,1236,제주특별자치도 서귀포시 표선면 하천리 1251-7,서귀포시,200,2,126.823555,33.35398000000001
2371,하천리마을입구,33.353970000000004,126.82333999999999,173,35,208,164,33,197,제주특별자치도 서귀포시 표선면 하천리 1559-1,서귀포시,200,2,126.823555,33.35398000000001
2372,표선청년회의소,33.33729,126.82802,38,17,55,38,12,50,제주특별자치도 서귀포시 표선면 표선리 1860-3,서귀포시,201,2,126.828125,33.33715
2373,표선청년회의소,33.33701,126.82823,167,5,172,165,5,170,제주특별자치도 서귀포시 표선면 표선리 1881-2,서귀포시,201,2,126.828125,33.33715
2374,표선고등학교,33.33104,126.82975,508,8,516,494,8,502,제주특별자치도 서귀포시 표선면 표선리 314-12,서귀포시,202,2,126.829815,33.33117
2375,표선고등학교,33.3313,126.82988,3008,121,3129,2913,114,3027,제주특별자치도 서귀포시 표선면 표선리 309-2,서귀포시,202,2,126.829815,33.33117
2377,표선중학교,33.32826,126.83122,1072,8,1080,1042,8,1050,제주특별자치도 서귀포시 표선면 표선리 2954,서귀포시,457,4,126.83122,33.32826
2379,표선환승정류장(표선면사무소),33.32658,126.83235,27398,2314,29712,26817,2131,28948,제주특별자치도 서귀포시 표선면 표선리 600-4,서귀포시,38,1,126.72819,33.29882200000001
2380,표선초등학교,33.329840000000004,126.83618,884,48,932,866,41,907,제주특별자치도 서귀포시 표선면 표선리 447-3,서귀포시,40,3,126.4694525,33.254366250000004
2381,표선초등학교,33.32875,126.83543,1138,253,1391,1093,242,1335,제주특별자치도 서귀포시 표선면 표선리 466-6,서귀포시,40,3,126.4694525,33.254366250000004
2382,표선환승정류장(표선리제주은행),33.32662,126.83322,11951,1149,13100,11605,1083,12688,제주특별자치도 서귀포시 표선면 표선리 597-1,서귀포시,38,1,126.72819,33.29882200000001
2383,표선파출소,33.324059999999996,126.83108999999999,1591,11,1602,1587,11,1598,제주특별자치도 서귀포시 표선면 표선리 671-1,서귀포시,49,1,126.74017666666664,33.30399
2384,표선파출소,33.32421,126.83073999999999,236,2,238,235,2,237,제주특별자치도 서귀포시 표선면 표선리 671-1,서귀포시,49,1,126.74017666666664,33.30399
2386,관통사,33.32705,126.82712,101,2,103,100,2,102,제주특별자치도 서귀포시 표선면 표선리 1681-1,서귀포시,458,4,126.82712,33.32705
2387,역지동,33.34689,126.78357,198,1,199,198,1,199,제주특별자치도 서귀포시 표선면 가시리 3801,서귀포시,459,4,126.78357,33.34689
2389,가시리동상동,33.35351,126.77388,386,7,393,384,7,391,제주특별자치도 서귀포시 표선면 가시리 1983-1,서귀포시,203,2,126.77389500000001,33.35366
2390,가시리동상동,33.353809999999996,126.77391000000001,134,3,137,132,3,135,제주특별자치도 서귀포시 표선면 가시리 1973-1,서귀포시,203,2,126.77389500000001,33.35366
2391,가시리,33.36144,126.76661000000001,253,10,263,253,10,263,제주특별자치도 서귀포시 표선면 가시리 3805,서귀포시,160,2,126.76674,33.361395
2394,성읍1리,33.386520000000004,126.79911000000001,1133,107,1240,1091,98,1189,제주특별자치도 서귀포시 표선면 성읍리 727-1,서귀포시,204,2,126.79904,33.386505
2395,성읍1리,33.38649,126.79897,980,96,1076,965,94,1059,제주특별자치도 서귀포시 표선면 성읍리 731-1,서귀포시,204,2,126.79904,33.386505
2396,성읍1리,33.38375,126.79948999999999,632,65,697,619,63,682,제주특별자치도 서귀포시 표선면 성읍리 998,서귀포시,205,2,126.799595,33.383725
2397,성읍1리,33.3837,126.7997,569,46,615,552,41,593,제주특별자치도 서귀포시 표선면 성읍리 993-3,서귀포시,205,2,126.799595,33.383725
2398,성읍농협앞,33.39078,126.8008,3620,189,3809,3586,180,3766,제주특별자치도 서귀포시 표선면 성읍리 603-2,서귀포시,37,1,126.728285,33.33050375
2399,성읍농협,33.39047,126.801,4993,180,5173,4930,175,5105,제주특별자치도 서귀포시 표선면 성읍리 592,서귀포시,37,1,126.728285,33.33050375
2400,성읍1리,33.3921,126.79992,888,28,916,879,28,907,제주특별자치도 서귀포시 표선면 성읍리 1615,서귀포시,37,1,126.728285,33.33050375
2401,바스메,33.405640000000005,126.77833999999999,105,16,121,99,13,112,제주특별자치도 서귀포시 표선면 성읍리 3294,서귀포시,206,2,126.77838,33.405725000000004
2402,바스메,33.405809999999995,126.77842,152,13,165,142,13,155,제주특별자치도 서귀포시 표선면 성읍리 2675-1,서귀포시,206,2,126.77838,33.405725000000004
2403,성읍2리,33.410109999999996,126.76987,668,78,746,647,74,721,제주특별자치도 서귀포시 표선면 성읍리 3030-1,서귀포시,18,3,126.61156714285713,33.30907571428571
2404,성읍2리,33.41088,126.76886999999999,864,91,955,834,89,923,제주특별자치도 서귀포시 표선면 성읍리 3031-3,서귀포시,18,3,126.61156714285713,33.30907571428571
2405,표선면충혼묘지,33.416129999999995,126.7626,233,165,398,232,162,394,제주특별자치도 서귀포시 표선면 성읍리 3144-2,서귀포시,207,2,126.76270500000001,33.416169999999994
2406,표선면충혼묘지,33.41621,126.76281000000002,302,293,595,284,290,574,제주특별자치도 서귀포시 표선면 성읍리 3144-4,서귀포시,207,2,126.76270500000001,33.416169999999994
2407,서의동,33.3009,126.70448,77,1,78,77,1,78,제주특별자치도 서귀포시 남원읍 남원리 2490,서귀포시,208,2,126.704165,33.301
2408,원불교,33.2845,126.71523,276,4,280,276,4,280,제주특별자치도 서귀포시 남원읍 남원리 1227-4,서귀포시,209,2,126.71506500000001,33.284675
2409,원불교,33.28485,126.7149,573,2,575,569,2,571,제주특별자치도 서귀포시 남원읍 남원리 1228-8,서귀포시,209,2,126.71506500000001,33.284675
2410,남원2리,33.2951,126.70787,257,2,259,257,2,259,제주특별자치도 서귀포시 남원읍 남원리 989-2,서귀포시,210,2,126.70783,33.295315
2411,남원2리,33.29553,126.70778999999999,35,2,37,34,2,36,제주특별자치도 서귀포시 남원읍 남원리 948-1,서귀포시,210,2,126.70783,33.295315
2412,서의동,33.3011,126.70385,509,3,512,508,3,511,제주특별자치도 서귀포시 남원읍 남원리 734-5,서귀포시,208,2,126.704165,33.301
2414,한남리사무소,33.31192,126.69555,812,7,819,807,7,814,제주특별자치도 서귀포시 남원읍 한남리 359-2,서귀포시,63,1,126.65415800000001,33.290906
2416,대전동,33.31392,126.70043000000001,24,2,26,24,2,26,제주특별자치도 서귀포시 남원읍 한남리 62-1,서귀포시,460,4,126.70043000000001,33.31392
2417,의귀서동네,33.30986,126.71198000000001,451,5,456,451,5,456,제주특별자치도 서귀포시 남원읍 의귀리 1480-2,서귀포시,211,2,126.71186,33.30975
2418,의귀서동네,33.30964,126.71173999999999,70,1,71,70,1,71,제주특별자치도 서귀포시 남원읍 의귀리 2006,서귀포시,211,2,126.71186,33.30975
2421,입석동,33.316359999999996,126.59728,728,54,782,698,53,751,제주특별자치도 서귀포시 남원읍 하례리 산 144,서귀포시,212,2,126.597005,33.316154999999995
2422,입석동,33.31595,126.59673000000001,356,32,388,345,31,376,제주특별자치도 서귀포시 상효동 산 108-10,서귀포시,212,2,126.597005,33.316154999999995
2424,신도3리,33.28585,126.18588000000001,693,20,713,690,18,708,제주특별자치도 서귀포시 대정읍 신도리 1880-7,서귀포시,461,4,126.18588000000001,33.28585
2425,신도1리,33.27841,126.19133000000001,714,45,759,706,44,750,제주특별자치도 서귀포시 대정읍 신도리 1381-23,서귀포시,213,2,126.191415,33.278055
2426,신도1리,33.2777,126.1915,2173,41,2214,2154,41,2195,제주특별자치도 서귀포시 대정읍 신도리 1402,서귀포시,213,2,126.191415,33.278055
2427,무릉문화의집,33.272729999999996,126.1991,225,14,239,222,14,236,제주특별자치도 서귀포시 대정읍 무릉리 3314-6,서귀포시,214,2,126.19929,33.27258
2428,무릉문화의집,33.27243,126.19948000000001,992,20,1012,984,19,1003,제주특별자치도 서귀포시 대정읍 무릉리 3295-8,서귀포시,214,2,126.19929,33.27258
2429,무릉1리학교앞,33.271440000000005,126.20182,993,38,1031,981,38,1019,제주특별자치도 서귀포시 대정읍 무릉리 2802-1,서귀포시,462,4,126.20182,33.271440000000005
2430,무릉1리리사무소앞,33.2703,126.2031,2299,39,2338,2248,37,2285,제주특별자치도 서귀포시 대정읍 무릉리 2929-2,서귀포시,463,4,126.2031,33.2703
2431,영락사통,33.260709999999996,126.20782,197,1,198,196,1,197,제주특별자치도 서귀포시 대정읍 영락리 1240-3,서귀포시,215,2,126.207795,33.260655
2432,영락사통,33.2606,126.20777,923,16,939,910,16,926,제주특별자치도 서귀포시 대정읍 영락리 2169,서귀포시,215,2,126.207795,33.260655
2433,영락리,33.25708,126.21033,1613,28,1641,1604,25,1629,제주특별자치도 서귀포시 대정읍 영락리 1297-8,서귀포시,162,2,126.21017,33.257495
2434,일과2리사무소,33.24536,126.22415,200,20,220,197,20,217,제주특별자치도 서귀포시 대정읍 일과리 1499-4,서귀포시,166,2,126.22398000000001,33.245279999999994
2435,일과2리서림수원지입구,33.24273,126.22842,21,2,23,20,2,22,제주특별자치도 서귀포시 대정읍 일과리 901-11,서귀포시,173,2,126.22800000000001,33.24306
2436,대수동,33.24001,126.23388999999999,169,47,216,165,46,211,제주특별자치도 서귀포시 대정읍 일과리 1055-4,서귀포시,216,2,126.233755,33.2398
2437,대수동,33.23959,126.23362,622,61,683,611,60,671,제주특별자치도 서귀포시 대정읍 일과리 1110-10,서귀포시,216,2,126.233755,33.2398
2439,대정서초등학교,33.23195,126.23825,85,3,88,84,3,87,제주특별자치도 서귀포시 대정읍 동일리 2659-2,서귀포시,217,2,126.23821,33.231865
2440,대정서초등학교,33.23178,126.23817,307,29,336,305,26,331,제주특별자치도 서귀포시 대정읍 동일리 3168-3,서귀포시,217,2,126.23821,33.231865
2441,동일1리,33.22848,126.24271,404,33,437,396,32,428,제주특별자치도 서귀포시 대정읍 동일리 2821-5,서귀포시,218,2,126.24288999999999,33.22833
2442,동일1리,33.22818,126.24306999999999,1134,55,1189,1127,53,1180,제주특별자치도 서귀포시 대정읍 동일리 2823-3,서귀포시,218,2,126.24288999999999,33.22833
2443,대정읍사무소,33.22592,126.25171,2339,36,2375,2316,34,2350,제주특별자치도 서귀포시 대정읍 하모리 1423-2,서귀포시,44,1,126.32166500000001,33.234591249999994
2445,대정초교후문,33.225570000000005,126.25638000000001,3270,61,3331,3229,58,3287,제주특별자치도 서귀포시 대정읍 상모리 3856-3,서귀포시,50,1,126.377458,33.239484000000004
2446,대정초교후문,33.22575,126.25616000000001,376,66,442,370,65,435,제주특별자치도 서귀포시 대정읍 상모리 3856-5,서귀포시,50,1,126.377458,33.239484000000004
2447,진개동산,33.22531,126.24736000000001,1056,51,1107,1043,50,1093,제주특별자치도 서귀포시 대정읍 동일리 2998-2,서귀포시,219,2,126.24780000000001,33.22552
2448,모슬포우체국,33.22253,126.25548,4044,131,4175,3989,121,4110,제주특별자치도 서귀포시 대정읍 상모리 3944-5,서귀포시,198,2,126.255335,33.222539999999995
2449,상모2리,33.22318,126.2578,318,8,326,315,7,322,제주특별자치도 서귀포시 대정읍 상모리 3978-1,서귀포시,220,2,126.25796,33.223150000000004
2450,상모3리,33.22312,126.25811999999999,1539,45,1584,1517,43,1560,제주특별자치도 서귀포시 대정읍 상모리 3976-2,서귀포시,220,2,126.25796,33.223150000000004
2451,상모리감협,33.2241,126.26183999999999,267,43,310,263,41,304,제주특별자치도 서귀포시 대정읍 상모리 3169-1,서귀포시,221,2,126.26218,33.224125
2452,상모리감협,33.22415,126.26252,1165,74,1239,1135,72,1207,제주특별자치도 서귀포시 대정읍 상모리 3175-4,서귀포시,221,2,126.26218,33.224125
2453,상모리이교동,33.2254,126.26717,1106,64,1170,1099,64,1163,제주특별자치도 서귀포시 대정읍 상모리 2675-2,서귀포시,222,2,126.267315,33.22549
2454,상모리이교동,33.22558,126.26746000000001,437,12,449,436,12,448,제주특별자치도 서귀포시 대정읍 상모리 2667-2,서귀포시,222,2,126.267315,33.22549
2456,상모,33.2247,126.26579,55,5,60,46,5,51,제주특별자치도 서귀포시 대정읍 상모리 3200-4,서귀포시,464,4,126.26579,33.2247
2457,사계리서동,33.230270000000004,126.2926,1337,75,1412,1318,73,1391,제주특별자치도 서귀포시 안덕면 사계리 3439-4,서귀포시,223,2,126.292955,33.230665
2458,사계리서동,33.23106,126.29331,128,2,130,128,2,130,제주특별자치도 서귀포시 안덕면 사계리 2699,서귀포시,223,2,126.292955,33.230665
2459,사계리사무소,33.23128,126.29751999999999,3620,435,4055,3543,414,3957,제주특별자치도 서귀포시 안덕면 사계리 3582,서귀포시,224,2,126.29777999999999,33.231444999999994
2460,사계리사무소,33.231609999999996,126.29803999999999,2225,116,2341,2200,112,2312,제주특별자치도 서귀포시 안덕면 사계리 2843-1,서귀포시,224,2,126.29777999999999,33.231444999999994
2461,사계리동동,33.23451,126.30771999999999,1723,453,2176,1656,440,2096,제주특별자치도 서귀포시 안덕면 사계리 3578,서귀포시,225,2,126.307975,33.234700000000004
2462,사계리동동,33.23489,126.30823000000001,61,30,91,58,30,88,제주특별자치도 서귀포시 안덕면 사계리 3578,서귀포시,225,2,126.307975,33.234700000000004
2463,산방산,33.23673,126.31046,105,27,132,103,27,130,제주특별자치도 서귀포시 안덕면 사계리 192-6,서귀포시,42,1,126.39550200000001,33.246428
2464,산방산,33.23612,126.31248000000001,1036,824,1860,979,786,1765,제주특별자치도 서귀포시 안덕면 사계리 176-2,서귀포시,226,2,126.312465,33.236175
2465,산방산,33.23623,126.31245,509,292,801,489,276,765,제주특별자치도 서귀포시 안덕면 사계리 166-4,서귀포시,226,2,126.312465,33.236175
2466,화순리,33.246320000000004,126.33197,4174,349,4523,4108,339,4447,제주특별자치도 서귀포시 안덕면 화순리 1061-8,서귀포시,227,2,126.33197,33.24637
2467,화순리,33.24642,126.33197,2429,302,2731,2375,285,2660,제주특별자치도 서귀포시 안덕면 화순리 1061-2,서귀포시,227,2,126.33197,33.24637
2468,화순환승정류장(안덕농협),33.246520000000004,126.33507,14514,604,15118,14298,575,14873,제주특별자치도 서귀포시 안덕면 화순리 1075-7,서귀포시,228,2,126.33512999999999,33.246585
2469,화순환승정류장(안덕농협),33.24665,126.33519,6652,425,7077,6515,411,6926,제주특별자치도 서귀포시 안덕면 화순리 1075-5,서귀포시,228,2,126.33512999999999,33.246585
2470,화순동취락지구,33.24922,126.33932,153,73,226,150,69,219,제주특별자치도 서귀포시 안덕면 화순리 233,서귀포시,41,3,126.57285857142858,33.27642285714286
2471,화순동취락지구,33.25006,126.34033000000001,567,140,707,556,137,693,제주특별자치도 서귀포시 안덕면 화순리 230-5,서귀포시,41,3,126.57285857142858,33.27642285714286
2472,덕수리군물왓,33.250640000000004,126.31591999999999,147,21,168,147,21,168,제주특별자치도 서귀포시 안덕면 덕수리 617-2,서귀포시,6,3,126.4122775,33.2481775
2473,덕수리군물왓,33.250809999999994,126.31438,359,31,390,356,30,386,제주특별자치도 서귀포시 안덕면 덕수리 663-4,서귀포시,6,3,126.4122775,33.2481775
2474,덕수리동동,33.25053,126.30856999999999,703,121,824,683,117,800,제주특별자치도 서귀포시 안덕면 덕수리 2369-5,서귀포시,229,2,126.30825499999999,33.250625
2475,덕수리동동,33.25072,126.30793999999999,402,20,422,400,20,420,제주특별자치도 서귀포시 안덕면 덕수리 2368-1,서귀포시,229,2,126.30825499999999,33.250625
2476,덕수초등학교,33.25053,126.30433000000001,2577,257,2834,2526,254,2780,제주특별자치도 서귀포시 안덕면 사계리 753-4,서귀포시,47,1,126.387708,33.254452
2477,덕수초등학교,33.25069000000001,126.30298,834,56,890,821,55,876,제주특별자치도 서귀포시 안덕면 덕수리 2439-1,서귀포시,47,1,126.387708,33.254452
2478,대정고등학교,33.23035,126.2619,681,71,752,626,70,696,제주특별자치도 서귀포시 대정읍 상모리 3396-2,서귀포시,190,2,126.262315,33.230675000000005
2479,대정농공단지,33.257220000000004,126.22922,68,10,78,67,9,76,제주특별자치도 서귀포시 대정읍 일과리 551-17,서귀포시,230,2,126.229285,33.25734
2480,대정농공단지,33.257459999999995,126.22935,193,16,209,192,15,207,제주특별자치도 서귀포시 대정읍 일과리 산 1-2,서귀포시,230,2,126.229285,33.25734
2482,동일2리입구,33.26041,126.23403,21,2,23,19,1,20,제주특별자치도 서귀포시 대정읍 동일리 산 6,서귀포시,465,4,126.23403,33.26041
2483,인향동입구,33.272290000000005,126.24571,592,6,598,587,6,593,제주특별자치도 서귀포시 대정읍 무릉리 산 65-6,서귀포시,184,2,126.245645,33.272315000000006
2484,신평리,33.26467,126.2593,1360,13,1373,1352,13,1365,제주특별자치도 서귀포시 대정읍 신평리 364-4,서귀포시,51,1,126.37958600000002,33.262034
2485,보성상동,33.2522,126.27336000000001,204,1,205,204,1,205,제주특별자치도 서귀포시 대정읍 보성리 2138,서귀포시,231,2,126.27336000000001,33.25233
2486,보성상동,33.25246,126.27336000000001,386,1,387,381,1,382,제주특별자치도 서귀포시 대정읍 보성리 1693-3,서귀포시,231,2,126.27336000000001,33.25233
2487,보성초등학교,33.24994,126.27675,825,163,988,805,155,960,제주특별자치도 서귀포시 대정읍 보성리 2138,서귀포시,43,1,126.34861,33.252337142857144
2488,보성초등학교,33.2498,126.27713999999999,218,17,235,216,14,230,제주특별자치도 서귀포시 대정읍 인성리 227,서귀포시,43,1,126.34861,33.252337142857144
2489,서광리,33.28887,126.32491,1933,283,2216,1890,269,2159,제주특별자치도 서귀포시 안덕면 서광리 366-10,서귀포시,232,2,126.32478,33.289030000000004
2490,서광리,33.289190000000005,126.32465,628,51,679,623,49,672,제주특별자치도 서귀포시 안덕면 서광리 367-3,서귀포시,232,2,126.32478,33.289030000000004
2491,동광리,33.30637,126.33837,1018,29,1047,1012,25,1037,제주특별자치도 서귀포시 안덕면 동광리 995-2,서귀포시,233,2,126.33825999999999,33.306145
2492,동광문화마을,33.30592,126.33815,751,68,819,746,68,814,제주특별자치도 서귀포시 안덕면 동광리 1597,서귀포시,233,2,126.33825999999999,33.306145
2493,동광환승정류장6(모슬포방면),33.30968,126.34025,3447,509,3956,3394,494,3888,제주특별자치도 서귀포시 안덕면 동광리 950-3,서귀포시,52,1,126.38022545454545,33.30013272727273
2494,동광환승정류장5(서귀방면),33.30958,126.34083000000001,12058,3402,15460,11814,3296,15110,제주특별자치도 서귀포시 안덕면 동광리 807-5,서귀포시,52,1,126.38022545454545,33.30013272727273
2495,동광환승정류장4(제주방면),33.31044,126.34098999999999,25438,6524,31962,24748,6245,30993,제주특별자치도 서귀포시 안덕면 동광리 824-1,서귀포시,52,1,126.38022545454545,33.30013272727273
2496,동광환승정류장3(한림방면),33.31048,126.34052,1663,99,1762,1654,98,1752,제주특별자치도 서귀포시 안덕면 동광리 825-3,서귀포시,52,1,126.38022545454545,33.30013272727273
2497,감산리서동,33.256809999999994,126.34866000000001,966,14,980,966,14,980,제주특별자치도 서귀포시 안덕면 감산리 1516-1,서귀포시,163,2,126.34909,33.256755
2499,안성리가스충전소,33.251020000000004,126.2837,25,7,32,25,7,32,제주특별자치도 서귀포시 대정읍 안성리 1454-20,서귀포시,466,4,126.2837,33.251020000000004
2500,추사유배지,33.2491,126.27888,105,8,113,102,8,110,제주특별자치도 서귀포시 대정읍 인성리 208-2,서귀포시,467,4,126.27888,33.2491
2501,인성리(보성농협앞),33.2482,126.27691999999999,29,6,35,29,6,35,제주특별자치도 서귀포시 대정읍 인성리 728,서귀포시,43,1,126.34861,33.252337142857144
2502,신평리,33.26512,126.2588,69,8,77,68,8,76,제주특별자치도 서귀포시 대정읍 신평리 367-21,서귀포시,51,1,126.37958600000002,33.262034
2503,신평리,33.265159999999995,126.25931000000001,1424,40,1464,1404,40,1444,제주특별자치도 서귀포시 대정읍 신평리 367-5,서귀포시,51,1,126.37958600000002,33.262034
2505,신평리상동,33.26815,126.26233,213,12,225,213,12,225,제주특별자치도 서귀포시 대정읍 신평리 610-7,서귀포시,468,4,126.26233,33.26815
2506,구억리,33.27237,126.2789,1812,119,1931,1762,109,1871,제주특별자치도 서귀포시 대정읍 보성리 463-7,서귀포시,234,2,126.27914999999999,33.272575
2507,구억리삼거리,33.27278,126.2794,524,114,638,519,113,632,제주특별자치도 서귀포시 대정읍 안성리 2030-26,서귀포시,234,2,126.27914999999999,33.272575
2508,구억리상동,33.2786,126.28355,270,12,282,265,11,276,제주특별자치도 서귀포시 대정읍 구억리 858-7,서귀포시,235,2,126.283525,33.278755
2509,구억리상동,33.278909999999996,126.2835,176,32,208,172,31,203,제주특별자치도 서귀포시 대정읍 구억리 1055,서귀포시,235,2,126.283525,33.278755
2511,평화의마을,33.27955,126.29337,360,5,365,358,5,363,제주특별자치도 서귀포시 대정읍 구억리 305-4,서귀포시,469,4,126.29337,33.27955
2512,서광서보건진료소,33.28335,126.29848,389,22,411,387,22,409,제주특별자치도 서귀포시 안덕면 서광리 2055-11,서귀포시,236,2,126.29851500000001,33.283474999999996
2513,서광서보건진료소,33.2836,126.29855,211,14,225,211,13,224,제주특별자치도 서귀포시 안덕면 서광리 2055-10,서귀포시,236,2,126.29851500000001,33.283474999999996
2514,서광서리,33.28607,126.30263000000001,2232,151,2383,2196,150,2346,제주특별자치도 서귀포시 안덕면 서광리 2471,서귀포시,237,2,126.30268000000001,33.286125
2515,서광서리,33.28618,126.30273000000001,1058,52,1110,1039,51,1090,제주특별자치도 서귀포시 안덕면 서광리 1906-8,서귀포시,237,2,126.30268000000001,33.286125
2516,서광서리사수동,33.28797,126.30676000000001,128,26,154,128,26,154,제주특별자치도 서귀포시 안덕면 서광리 1788-1,서귀포시,238,2,126.30689500000001,33.28797
2517,서광서리사수동,33.28797,126.30703000000001,193,110,303,189,108,297,제주특별자치도 서귀포시 안덕면 서광리 1789-6,서귀포시,238,2,126.30689500000001,33.28797
2518,서광동리마을,33.28682,126.32885,430,99,529,425,95,520,제주특별자치도 서귀포시 안덕면 서광리 274-24,서귀포시,239,2,126.32879,33.286874999999995
2519,서광동리마을,33.28693,126.32873000000001,376,50,426,370,48,418,제주특별자치도 서귀포시 안덕면 서광리 283-3,서귀포시,239,2,126.32879,33.286874999999995
2520,서광동리소랑못,33.285959999999996,126.33143000000001,429,7,436,427,7,434,제주특별자치도 서귀포시 안덕면 서광리 75-8,서귀포시,240,2,126.331575,33.28594
2521,서광동리소랑못,33.285920000000004,126.33171999999999,256,7,263,253,6,259,제주특별자치도 서귀포시 안덕면 서광리 80-5,서귀포시,240,2,126.331575,33.28594
2522,남원읍사무소,33.27957,126.72102,12055,442,12497,11895,424,12319,제주특별자치도 서귀포시 남원읍 남원리 97-5,서귀포시,53,1,126.6864557142857,33.269752857142855
2523,남원읍사무소,33.2794,126.71975,11124,191,11315,10947,186,11133,제주특별자치도 서귀포시 남원읍 남원리 100-3,서귀포시,470,4,126.71975,33.2794
2524,동부보건소,33.275259999999996,126.70338000000001,2122,238,2360,2061,207,2268,제주특별자치도 서귀포시 남원읍 남원리 2490-116,서귀포시,241,2,126.703045,33.27518499999999
2525,씨사이드홈,33.28035,126.7232,1024,17,1041,1015,16,1031,제주특별자치도 서귀포시 남원읍 남원리 2490-116,서귀포시,22,3,126.579643,33.256641
2526,씨사이드홈,33.28052,126.72421000000001,709,22,731,703,17,720,제주특별자치도 서귀포시 남원읍 남원리 70-1,서귀포시,22,3,126.579643,33.256641
2527,진은동,33.28242,126.72973,1091,26,1117,1087,25,1112,제주특별자치도 서귀포시 남원읍 태흥리 1771-3,서귀포시,471,4,126.72973,33.28242
2529,서소동,33.28365,126.73523,2277,17,2294,2268,13,2281,제주특별자치도 서귀포시 남원읍 태흥리 2008,서귀포시,242,2,126.73564,33.283654999999996
2530,서소동,33.28366,126.73605,380,20,400,380,20,400,제주특별자치도 서귀포시 남원읍 태흥리 1204-4,서귀포시,242,2,126.73564,33.283654999999996
2531,무도동,33.28479,126.74089,2667,76,2743,2641,73,2714,제주특별자치도 서귀포시 남원읍 태흥리 979-2,서귀포시,9,3,126.57550250000001,33.25769583333333
2532,무도동,33.28496,126.74192,626,40,666,620,40,660,제주특별자치도 서귀포시 남원읍 태흥리 2003,서귀포시,9,3,126.57550250000001,33.25769583333333
2533,태흥초등학교,33.28635,126.74501000000001,3338,70,3408,3288,69,3357,제주특별자치도 서귀포시 남원읍 태흥리 2003,서귀포시,243,2,126.74549,33.28649
2534,폭낭사거리,33.28663,126.74597,812,46,858,805,46,851,제주특별자치도 서귀포시 남원읍 태흥리 527-3,서귀포시,243,2,126.74549,33.28649
2535,어촌계입구,33.2878,126.74771000000001,2070,115,2185,2060,102,2162,제주특별자치도 서귀포시 남원읍 태흥리 616-2,서귀포시,26,3,126.59011999999998,33.26138428571429
2536,어촌계입구,33.28829,126.749,390,62,452,373,48,421,제주특별자치도 서귀포시 남원읍 태흥리 369-1,서귀포시,26,3,126.59011999999998,33.26138428571429
2537,태흥3리사무소,33.29358,126.75783,2671,34,2705,2644,31,2675,제주특별자치도 서귀포시 남원읍 태흥리 2001,서귀포시,37,3,126.728285,33.33050375
2538,태흥3리사무소,33.29437,126.75918,1044,24,1068,1033,22,1055,제주특별자치도 서귀포시 남원읍 태흥리 120-8,서귀포시,37,3,126.728285,33.33050375
2539,태흥3리,33.29568,126.76083,479,10,489,469,10,479,제주특별자치도 서귀포시 남원읍 태흥리 20-13,서귀포시,472,4,126.76083,33.29568
2540,신흥리취락구조,33.298590000000004,126.76491000000001,435,7,442,432,7,439,제주특별자치도 서귀포시 남원읍 신흥리 134-10,서귀포시,165,2,126.76486500000001,33.29866
2541,신흥교차로,33.300259999999994,126.76677,5,2,7,5,2,7,제주특별자치도 서귀포시 남원읍 신흥리 138-5,서귀포시,244,2,126.76687999999999,33.300489999999996
2542,신흥교차로,33.30072,126.76698999999999,2665,61,2726,2643,61,2704,제주특별자치도 서귀포시 남원읍 신흥리 167-19,서귀포시,244,2,126.76687999999999,33.300489999999996
2543,수농원,33.30299,126.76973999999998,488,29,517,486,28,514,제주특별자치도 서귀포시 남원읍 신흥리 196-8,서귀포시,245,2,126.77012500000001,33.303110000000004
2544,수농원,33.30323,126.77051000000002,1415,92,1507,1400,88,1488,제주특별자치도 서귀포시 남원읍 신흥리 115-3,서귀포시,245,2,126.77012500000001,33.303110000000004
2545,송천교,33.3075,126.77767,461,21,482,449,21,470,제주특별자치도 서귀포시 표선면 토산리 2057,서귀포시,246,2,126.77805000000001,33.307415
2546,송천교,33.30733,126.77843,649,26,675,645,26,671,제주특별자치도 서귀포시 표선면 토산리 454-4,서귀포시,246,2,126.77805000000001,33.307415
2547,산여리통입구,33.30731,126.78143999999999,1851,58,1909,1825,55,1880,제주특별자치도 서귀포시 표선면 토산리 2057,서귀포시,247,2,126.78143499999999,33.307415000000006
2548,산여리통입구,33.307520000000004,126.78143,1332,42,1374,1276,41,1317,제주특별자치도 서귀포시 표선면 토산리 436-10,서귀포시,247,2,126.78143499999999,33.307415000000006
2549,토산관광지구입구,33.30737,126.78657,264,17,281,256,14,270,제주특별자치도 서귀포시 표선면 토산리 71-3,서귀포시,248,2,126.78661500000001,33.307249999999996
2550,토산관광지구입구,33.30713,126.78666000000001,117,6,123,114,6,120,제주특별자치도 서귀포시 표선면 토산리 69-2,서귀포시,248,2,126.78661500000001,33.307249999999996
2551,샤인빌리조트입구,33.30672,126.79413999999998,1555,355,1910,1496,322,1818,제주특별자치도 서귀포시 표선면 세화리 1567-3,서귀포시,249,2,126.794,33.306830000000005
2552,샤인빌리조트입구,33.306940000000004,126.79386000000001,1406,169,1575,1375,158,1533,제주특별자치도 서귀포시 표선면 세화리 1579-11,서귀포시,249,2,126.794,33.306830000000005
2553,가마초등학교,33.3067,126.79961999999999,782,43,825,774,42,816,제주특별자치도 서귀포시 표선면 세화리 1522-4,서귀포시,250,2,126.79997499999999,33.306625
2554,가마초등학교,33.30655,126.80033,1385,48,1433,1350,46,1396,제주특별자치도 서귀포시 표선면 세화리 1540-4,서귀포시,250,2,126.79997499999999,33.306625
2555,세화2리사무소,33.30685,126.8039,520,32,552,508,30,538,제주특별자치도 서귀포시 표선면 세화리 2491,서귀포시,19,3,126.61672250000001,33.2755
2556,세화2리사무소,33.30682,126.80492,1702,74,1776,1689,71,1760,제주특별자치도 서귀포시 표선면 세화리 250-23,서귀포시,19,3,126.61672250000001,33.2755
2557,가흥동,33.30712,126.80675,386,28,414,380,26,406,제주특별자치도 서귀포시 표선면 세화리 2489-7,서귀포시,0,3,126.51989499999999,33.295381250000005
2558,가흥동,33.30758,126.80851000000001,890,24,914,876,24,900,제주특별자치도 서귀포시 표선면 세화리 133-4,서귀포시,0,3,126.51989499999999,33.295381250000005
2559,한지동,33.309059999999995,126.81153,453,58,511,444,56,500,제주특별자치도 서귀포시 표선면 표선리 2905-6,서귀포시,251,2,126.81188,33.30911999999999
2560,한지동,33.30918,126.81223,646,54,700,631,54,685,제주특별자치도 서귀포시 표선면 표선리 2913-7,서귀포시,251,2,126.81188,33.30911999999999
2561,동원산업,33.31227,126.82212,124,7,131,122,7,129,제주특별자치도 서귀포시 표선면 표선리 2302-2,서귀포시,252,2,126.82231,33.31224
2562,동원산업,33.31221,126.8225,206,8,214,204,8,212,제주특별자치도 서귀포시 표선면 표선리 2305-2,서귀포시,252,2,126.82231,33.31224
2563,그린카센터,33.31687,126.82866000000001,154,32,186,153,30,183,제주특별자치도 서귀포시 표선면 표선리 1466-3,서귀포시,155,2,126.82861500000001,33.316925
2564,표선오일시장,33.321,126.8303,1419,30,1449,1399,28,1427,제주특별자치도 서귀포시 표선면 표선리 2954,서귀포시,253,2,126.830565,33.321415
2565,표선오일시장,33.32183,126.83083,666,28,694,654,28,682,제주특별자치도 서귀포시 표선면 표선리 1018-6,서귀포시,253,2,126.830565,33.321415
2566,표선파출소,33.32328,126.83152,1176,49,1225,1165,47,1212,제주특별자치도 서귀포시 표선면 표선리 779-6,서귀포시,49,1,126.74017666666664,33.30399
2567,성산포수협표선지점,33.32405,126.83173000000001,11028,389,11417,10854,368,11222,제주특별자치도 서귀포시 표선면 표선리 663-1,서귀포시,49,1,126.74017666666664,33.30399
2568,막상올레,33.32582,126.83391999999999,8903,80,8983,8741,75,8816,제주특별자치도 서귀포시 표선면 표선리 2954,서귀포시,38,1,126.72819,33.29882200000001
2569,표선리사거리,33.3257,126.8335,861,187,1048,851,182,1033,제주특별자치도 서귀포시 표선면 표선리 634,서귀포시,38,1,126.72819,33.29882200000001
2571,하천리취락구조,33.3376,126.84278,174,29,203,170,28,198,제주특별자치도 서귀포시 표선면 하천리 292-7,서귀포시,473,4,126.84278,33.3376
2572,하천하동,33.339729999999996,126.84421999999999,2367,62,2429,2347,58,2405,제주특별자치도 서귀포시 표선면 하천리 275-1,서귀포시,254,2,126.84455499999999,33.34003
2573,하천하동,33.34033,126.84488999999999,464,50,514,459,49,508,제주특별자치도 서귀포시 표선면 하천리 295-5,서귀포시,254,2,126.84455499999999,33.34003
2574,신천리,33.344409999999996,126.84885,2731,39,2770,2710,38,2748,제주특별자치도 서귀포시 성산읍 신천리 892-2,서귀포시,255,2,126.849315,33.344645
2575,신천리,33.344879999999996,126.84978000000001,967,43,1010,959,41,1000,제주특별자치도 서귀포시 성산읍 신천리 482,서귀포시,255,2,126.849315,33.344645
2576,신천리취락구조,33.34805,126.85363000000001,230,8,238,227,8,235,제주특별자치도 서귀포시 성산읍 신천리 562-2,서귀포시,256,2,126.85379,33.348265
2577,신천리취락구조,33.34848,126.85395,828,78,906,813,74,887,제주특별자치도 서귀포시 성산읍 신천리 595-2,서귀포시,256,2,126.85379,33.348265
2580,신풍리하동,33.36257,126.86511000000002,542,105,647,523,103,626,제주특별자치도 서귀포시 성산읍 신풍리 75-2,서귀포시,257,2,126.865205,33.363249999999994
2581,신풍리하동,33.363929999999996,126.8653,472,50,522,468,44,512,제주특별자치도 서귀포시 성산읍 신풍리 1728,서귀포시,257,2,126.865205,33.363249999999994
2582,삼달교차로,33.36868,126.86825,1308,90,1398,1285,80,1365,제주특별자치도 서귀포시 성산읍 삼달리 20-2,서귀포시,54,1,126.7603,33.31871399999999
2583,삼달교차로,33.36933,126.86903000000001,905,131,1036,890,125,1015,제주특별자치도 서귀포시 성산읍 삼달리 2262,서귀포시,54,1,126.7603,33.31871399999999
2584,희진주유소,33.37661,126.87364,548,49,597,516,49,565,제주특별자치도 서귀포시 성산읍 신산리 1155-2,서귀포시,258,2,126.87384,33.377089999999995
2585,희진주유소,33.37757,126.87404,824,76,900,809,74,883,제주특별자치도 서귀포시 성산읍 신산리 1085-20,서귀포시,258,2,126.87384,33.377089999999995
2586,신산환승정류장(성산농협신산지점),33.37993,126.87568999999999,2753,148,2901,2721,143,2864,제주특별자치도 서귀포시 성산읍 신산리 1085-20,서귀포시,259,2,126.875935,33.380135
2587,신산환승정류장(성산농협신산지점),33.380340000000004,126.87618,3290,337,3627,3229,319,3548,제주특별자치도 서귀포시 성산읍 신산리 1100-16,서귀포시,259,2,126.875935,33.380135
2588,신산리,33.382329999999996,126.87695,762,36,798,752,34,786,제주특별자치도 서귀포시 성산읍 신산리 1026-2,서귀포시,260,2,126.87731,33.382819999999995
2589,신산리,33.383309999999994,126.87767,1544,34,1578,1531,31,1562,제주특별자치도 서귀포시 성산읍 신산리 611-2,서귀포시,260,2,126.87731,33.382819999999995
2590,난산입구,33.38583,126.88054,363,18,381,360,16,376,제주특별자치도 서귀포시 성산읍 신산리 658-1,서귀포시,474,4,126.88054,33.38583
2591,난산입구(성산기상대),33.38602,126.88173,345,14,359,338,14,352,제주특별자치도 서귀포시 성산읍 신산리 680-9,서귀포시,475,4,126.88173,33.38602
2592,화성농장,33.39124,126.88933,61,50,111,59,49,108,제주특별자치도 서귀포시 성산읍 신산리 1978,서귀포시,261,2,126.88943,33.391605
2593,화성농장,33.39197,126.88953000000001,82,6,88,82,6,88,제주특별자치도 서귀포시 성산읍 신산리 137-1,서귀포시,261,2,126.88943,33.391605
2594,온평리,33.40226,126.89555,209,22,231,205,20,225,제주특별자치도 서귀포시 성산읍 온평리 1407-8,서귀포시,27,3,126.58037818181816,33.28037545454546
2595,온평리,33.40432,126.89656000000001,531,95,626,516,90,606,제주특별자치도 서귀포시 성산읍 온평리 2822,서귀포시,27,3,126.58037818181816,33.28037545454546
2596,온평초등학교,33.4066,126.89692,834,69,903,821,65,886,제주특별자치도 서귀포시 성산읍 온평리 2822,서귀포시,57,1,126.77318199999999,33.343149999999994
2597,온평초등학교,33.40828,126.89775,2305,292,2597,2260,277,2537,제주특별자치도 서귀포시 성산읍 온평리 1563-1,서귀포시,57,1,126.77318199999999,33.343149999999994
2598,혼인지입구,33.41102,126.89882,730,114,844,715,106,821,제주특별자치도 서귀포시 성산읍 온평리 520-6,서귀포시,262,2,126.898945,33.41112
2599,혼인지입구,33.41122,126.89907,1560,192,1752,1535,184,1719,제주특별자치도 서귀포시 성산읍 온평리 522-4,서귀포시,262,2,126.898945,33.41112
2600,성산농협종합유통센터,33.42582,126.90687,838,153,991,820,146,966,제주특별자치도 서귀포시 성산읍 고성리 1905-3,서귀포시,263,2,126.90679,33.42584
2601,성산농협종합유통센터,33.42586,126.90671,140,12,152,137,12,149,제주특별자치도 서귀포시 성산읍 고성리 2747,서귀포시,263,2,126.90679,33.42584
2602,신양리입구,33.43415,126.90923000000001,931,516,1447,888,479,1367,제주특별자치도 서귀포시 성산읍 고성리 1772-3,서귀포시,21,3,126.55541500000001,33.29999375
2603,신양리입구,33.43565,126.90993,1230,894,2124,1159,842,2001,제주특별자치도 서귀포시 성산읍 고성리 896-4,서귀포시,21,3,126.55541500000001,33.29999375
2604,성산읍사무소,33.44097,126.9111,760,81,841,733,80,813,제주특별자치도 서귀포시 성산읍 고성리 919-2,서귀포시,17,3,126.64931,33.30715857142857
2605,성산읍사무소,33.44225,126.91203,607,162,769,598,154,752,제주특별자치도 서귀포시 성산읍 고성리 937-5,서귀포시,17,3,126.64931,33.30715857142857
2606,오조리하동,33.4587,126.91228000000001,114,37,151,112,37,149,제주특별자치도 서귀포시 성산읍 오조리 2210,서귀포시,264,2,126.912265,33.458614999999995
2607,오조리하동,33.458529999999996,126.91225,40,9,49,39,9,48,제주특별자치도 서귀포시 성산읍 오조리 956-1,서귀포시,264,2,126.912265,33.458614999999995
2610,고성오일시장,33.4523,126.91413,636,238,874,623,233,856,제주특별자치도 서귀포시 성산읍 고성리 2747,서귀포시,265,2,126.91409,33.45218
2611,고성오일시장,33.452059999999996,126.91405,68,32,100,68,31,99,제주특별자치도 서귀포시 성산읍 고성리 2747,서귀포시,265,2,126.91409,33.45218
2612,고성리제주은행,33.449459999999995,126.91505,1258,285,1543,1226,281,1507,제주특별자치도 서귀포시 성산읍 고성리 313-6,서귀포시,55,1,126.78752,33.366368
2613,고성리구성산농협,33.44798,126.91496000000001,10217,1111,11328,10009,1058,11067,제주특별자치도 서귀포시 성산읍 고성리 322-8,서귀포시,55,1,126.78752,33.366368
2614,신양리입구,33.4448,126.91354,70,38,108,69,34,103,제주특별자치도 서귀포시 성산읍 고성리 999-4,서귀포시,266,2,126.913465,33.444805
2615,신양입구,33.44481,126.91338999999999,44,7,51,44,7,51,제주특별자치도 서귀포시 성산읍 고성리 1009-2,서귀포시,266,2,126.913465,33.444805
2616,성산환승정류장(고성리회전교차로),33.44728,126.91378,8218,3768,11986,7889,3599,11488,제주특별자치도 서귀포시 성산읍 고성리 1099-5,서귀포시,267,2,126.91378499999999,33.44736
2617,성산환승정류장(고성리한국물류),33.44744,126.91378999999999,25173,6004,31177,24497,5639,30136,제주특별자치도 서귀포시 성산읍 고성리 1099-4,서귀포시,267,2,126.91378499999999,33.44736
2618,오조리상동입구,33.461999999999996,126.91033,114,12,126,113,12,125,제주특별자치도 서귀포시 성산읍 오조리 797-3,서귀포시,268,2,126.910305,33.46241
2619,오조리상동입구,33.46282,126.91028,127,40,167,125,38,163,제주특별자치도 서귀포시 성산읍 오조리 2210,서귀포시,268,2,126.910305,33.46241
2620,성산고입구삼거리,33.46503,126.90863,17,17,34,15,17,32,제주특별자치도 서귀포시 성산읍 오조리 1305-4,서귀포시,46,1,126.76076599999999,33.384136
2621,성산고입구삼거리,33.4657,126.90841999999999,363,77,440,359,69,428,제주특별자치도 서귀포시 성산읍 오조리 2210,서귀포시,46,1,126.76076599999999,33.384136
2622,성산국민체육센터,33.46885,126.90588000000001,499,95,594,492,91,583,제주특별자치도 서귀포시 성산읍 오조리 446-1,서귀포시,269,2,126.905835,33.468785000000004
2623,성산국민체육센터,33.468720000000005,126.90579,769,108,877,746,101,847,제주특별자치도 서귀포시 성산읍 오조리 447-2,서귀포시,269,2,126.905835,33.468785000000004
2624,시흥리,33.47663,126.89631999999999,986,123,1109,954,121,1075,제주특별자치도 서귀포시 성산읍 시흥리 1127-1,서귀포시,270,2,126.896525,33.47644
2625,시흥리,33.47625,126.89673,720,99,819,704,96,800,제주특별자치도 서귀포시 성산읍 시흥리 2644-11,서귀포시,270,2,126.896525,33.47644
2626,시흥리사무소,33.4743,126.89845,1205,42,1247,1182,33,1215,제주특별자치도 서귀포시 성산읍 시흥리 653-1,서귀포시,271,2,126.89871500000001,33.473825000000005
2627,시흥리사무소,33.47335,126.89898000000001,2183,89,2272,2155,82,2237,제주특별자치도 서귀포시 성산읍 시흥리 2644-12,서귀포시,271,2,126.89871500000001,33.473825000000005
2628,영실입구,33.333040000000004,126.45958999999999,135,29,164,122,25,147,제주특별자치도 서귀포시 중문동 산 1-1,서귀포시,272,2,126.45955000000001,33.333105
2629,위호텔,33.28502,126.4546,86,23,109,86,23,109,제주특별자치도 서귀포시 대포동 2603,서귀포시,273,2,126.45454000000001,33.28505
2631,위호텔,33.28508,126.45448,23,11,34,23,11,34,제주특별자치도 서귀포시 대포동 25-1,서귀포시,273,2,126.45454000000001,33.28505
2632,서귀포천문과학문화관,33.28846,126.45733,76,15,91,76,15,91,제주특별자치도 서귀포시 하원동 1885-4,서귀포시,476,4,126.45733,33.28846
2633,법정사입구,33.302440000000004,126.45822,26,4,30,25,3,28,제주특별자치도 서귀포시 대포동 산 6-2,서귀포시,177,2,126.458335,33.302620000000005
2634,거린사슴전망대,33.307629999999996,126.45473,30,8,38,26,7,33,제주특별자치도 서귀포시 대포동 산 2-3,서귀포시,176,2,126.45485500000001,33.307615
2635,서귀포자연휴양림,33.31201,126.45751000000001,668,211,879,628,192,820,제주특별자치도 서귀포시 대포동 산 1-7,서귀포시,175,2,126.45751000000001,33.311930000000004
2636,영실매표소,33.34025,126.48021999999999,2077,1006,3083,1878,941,2819,제주특별자치도 서귀포시 하원동 산 1-1,서귀포시,477,4,126.48021999999999,33.34025
2637,영실입구,33.33317,126.45951000000001,158,24,182,142,20,162,제주특별자치도 서귀포시 중문동 산 1-1,서귀포시,272,2,126.45955000000001,33.333105
2638,1100고지휴게소,33.357820000000004,126.46308,294,72,366,278,69,347,제주특별자치도 서귀포시 색달동 산 1-1,서귀포시,0,2,126.51989499999999,33.295381250000005
2639,올리수,33.32457,126.71366,538,17,555,518,15,533,제주특별자치도 서귀포시 남원읍 수망리 217-2,서귀포시,274,2,126.71381000000001,33.324535
2640,사리물,33.35065,126.69815,105,26,131,105,25,130,제주특별자치도 서귀포시 남원읍 수망리 산 126-1,서귀포시,275,2,126.69837,33.350435000000004
2641,수악교,33.337379999999996,126.61097,262,27,289,217,23,240,제주특별자치도 서귀포시 남원읍 신례리 산 2-1,서귀포시,20,3,126.50806625,33.26451
2643,"남원읍충혼묘지,물영아리",33.35954,126.69268000000001,18,7,25,17,3,20,제주특별자치도 서귀포시 남원읍 수망리 산 182-1,서귀포시,4,3,126.51396210526316,33.26277789473685
2644,사리물,33.35022,126.69859,54,8,62,51,8,59,제주특별자치도 서귀포시 남원읍 수망리 산 126-1,서귀포시,275,2,126.69837,33.350435000000004
2645,디삘레,33.33122,126.71093,510,18,528,509,16,525,제주특별자치도 서귀포시 남원읍 수망리 1086,서귀포시,276,2,126.71106,33.331075
2646,수망사거리,33.32808,126.7124,1246,46,1292,1230,45,1275,제주특별자치도 서귀포시 남원읍 수망리 322-1,서귀포시,277,2,126.71277,33.32761
2647,수망가름,33.32714,126.71314,1224,182,1406,1211,163,1374,제주특별자치도 서귀포시 남원읍 수망리 244,서귀포시,277,2,126.71277,33.32761
2648,올리수,33.3245,126.71396000000001,173,11,184,171,11,182,제주특별자치도 서귀포시 남원읍 수망리 217-5,서귀포시,274,2,126.71381000000001,33.324535
2649,돈물교,33.31478,126.71425,312,2,314,308,2,310,제주특별자치도 서귀포시 남원읍 의귀리 2008,서귀포시,278,2,126.714135,33.314735
2650,의귀교회앞,33.31235,126.71387,628,3,631,623,3,626,제주특별자치도 서귀포시 남원읍 의귀리 2008,서귀포시,279,2,126.71370999999999,33.31239
2651,의귀환승정류장(의귀초등학교),33.31082,126.71495,2824,240,3064,2770,208,2978,제주특별자치도 서귀포시 남원읍 의귀리 1485-3,서귀포시,56,1,126.66646600000001,33.284141999999996
2652,산하동,33.305640000000004,126.7191,126,8,134,123,7,130,제주특별자치도 서귀포시 남원읍 의귀리 893-5,서귀포시,280,2,126.719025,33.305155
2654,농협하나로마트,33.284079999999996,126.72072,679,13,692,669,13,682,제주특별자치도 서귀포시 남원읍 남원리 225-12,서귀포시,281,2,126.72066000000001,33.284079999999996
2655,남원1리사무소,33.27793,126.71463,5068,91,5159,5040,90,5130,제주특별자치도 서귀포시 남원읍 남원리 1345-8,서귀포시,282,2,126.71433,33.27793
2656,광지동,33.27643,126.70931999999999,2666,305,2971,2622,291,2913,제주특별자치도 서귀포시 남원읍 남원리 1419-2,서귀포시,283,2,126.709,33.27642
2657,남원생활체육관,33.2755,126.7059,1356,423,1779,1273,362,1635,제주특별자치도 서귀포시 남원읍 남원리 2377-1,서귀포시,284,2,126.70612,33.27561
2658,동부보건소,33.27511,126.70271000000001,2915,232,3147,2851,212,3063,제주특별자치도 서귀포시 남원읍 남원리 2368-2,서귀포시,241,2,126.703045,33.27518499999999
2659,남원생활체육관,33.27572,126.70634,752,76,828,725,74,799,제주특별자치도 서귀포시 남원읍 남원리 1451-2,서귀포시,284,2,126.70612,33.27561
2660,광지동,33.27641,126.70868,3074,140,3214,3015,134,3149,제주특별자치도 서귀포시 남원읍 남원리 1447-3,서귀포시,283,2,126.709,33.27642
2661,남원1리사무소,33.27793,126.71403000000001,7530,78,7608,7439,74,7513,제주특별자치도 서귀포시 남원읍 남원리 1339-2,서귀포시,282,2,126.71433,33.27793
2662,농협하나로마트,33.284079999999996,126.7206,50,8,58,49,3,52,제주특별자치도 서귀포시 남원읍 남원리 225-2,서귀포시,281,2,126.72066000000001,33.284079999999996
2663,의귀산하동,33.29888,126.72084,189,6,195,186,5,191,제주특별자치도 서귀포시 남원읍 의귀리 1032-5,서귀포시,478,4,126.72084,33.29888
2664,산하동,33.30467,126.71895,445,1,446,445,1,446,제주특별자치도 서귀포시 남원읍 의귀리 932-9,서귀포시,280,2,126.719025,33.305155
2665,의귀환승정류장(의귀초등학교),33.31067,126.71483,3512,37,3549,3420,36,3456,제주특별자치도 서귀포시 남원읍 의귀리 1484-3,서귀포시,56,1,126.66646600000001,33.284141999999996
2666,의귀교회앞,33.31243,126.71355,436,1,437,434,1,435,제주특별자치도 서귀포시 남원읍 의귀리 1523-3,서귀포시,279,2,126.71370999999999,33.31239
2667,돈물교,33.31469,126.71401999999999,446,3,449,446,3,449,제주특별자치도 서귀포시 남원읍 의귀리 1585-1,서귀포시,278,2,126.714135,33.314735
2668,디삘레,33.33093,126.71118999999999,301,7,308,301,7,308,제주특별자치도 서귀포시 남원읍 수망리 1086,서귀포시,276,2,126.71106,33.331075
2669,"남원읍충혼묘지,물영아리",33.36084,126.69166000000001,111,18,129,109,18,127,제주특별자치도 서귀포시 남원읍 수망리 산 182,서귀포시,4,3,126.51396210526316,33.26277789473685
2670,태흥목장,33.3798,126.68486000000001,45,7,52,41,7,48,제주특별자치도 서귀포시 표선면 가시리 산 133,서귀포시,479,4,126.68486000000001,33.3798
2673,수악교,33.33469,126.61036999999999,664,51,715,645,50,695,제주특별자치도 서귀포시 남원읍 신례리 산 2-36,서귀포시,20,3,126.50806625,33.26451
2674,성판악,33.38463,126.62035,1969,1177,3146,1786,1112,2898,제주특별자치도 서귀포시 남원읍 신례리 산 2-13,서귀포시,480,4,126.62035,33.38463
2675,온평초등학교,33.40745,126.897,37,1,38,36,1,37,제주특별자치도 서귀포시 성산읍 온평리 1577-6,서귀포시,57,1,126.77318199999999,33.343149999999994
2678,토산보건진료소,33.32648,126.76751000000002,411,3,414,410,3,413,제주특별자치도 서귀포시 표선면 토산리 1360-3,서귀포시,181,2,126.76783,33.32698
2679,수산초등학교,33.44635,126.88616,634,270,904,598,247,845,제주특별자치도 서귀포시 성산읍 수산리 4764,서귀포시,178,2,126.88624,33.4463
2682,수산2리,33.43975,126.86513000000001,488,143,631,468,131,599,제주특별자치도 서귀포시 성산읍 수산리 2412-1,서귀포시,151,2,126.8651,33.439674999999994
2685,신양리,33.43581,126.91632,28,22,50,27,21,48,제주특별자치도 서귀포시 성산읍 고성리 507-14,서귀포시,285,2,126.91626500000001,33.4357
2686,신양리,33.435590000000005,126.91621,440,176,616,425,175,600,제주특별자치도 서귀포시 성산읍 고성리 580-1,서귀포시,285,2,126.91626500000001,33.4357
2691,삼달1리,33.37427,126.8433,86,7,93,86,7,93,제주특별자치도 서귀포시 성산읍 삼달리 1152-4,서귀포시,161,2,126.84324000000001,33.374120000000005
2692,감산입구,33.26085,126.3622,284,16,300,284,16,300,제주특별자치도 서귀포시 안덕면 창천리 342-1,서귀포시,286,2,126.36216999999999,33.26074
2693,감산입구,33.26063,126.36214,296,20,316,295,19,314,제주특별자치도 서귀포시 안덕면 감산리 142-4,서귀포시,286,2,126.36216999999999,33.26074
2694,동홍사거리,33.25472,126.56838,9973,155,10128,9829,149,9978,제주특별자치도 서귀포시 동홍동 462-3,서귀포시,58,1,126.57301166666667,33.252878333333335
2695,동홍사거리,33.2545,126.56831000000001,5912,79,5991,5828,74,5902,제주특별자치도 서귀포시 동홍동 462-3,서귀포시,58,1,126.57301166666667,33.252878333333335
2696,(구)중앙파출소,33.24751,126.56088999999999,116,12,128,114,10,124,제주특별자치도 서귀포시 서귀동 341,서귀포시,22,1,126.579643,33.256641
2697,대포항,33.239740000000005,126.43773,231,258,489,231,258,489,제주특별자치도 서귀포시 대포동 2072-2,서귀포시,287,2,126.4377,33.239805000000004
2698,대포항,33.23987,126.43767,245,347,592,245,347,592,제주특별자치도 서귀포시 대포동 2072-2,서귀포시,287,2,126.4377,33.239805000000004
2699,약천사,33.24289,126.45083999999999,539,214,753,521,198,719,제주특별자치도 서귀포시 하원동 1878-4,서귀포시,59,1,126.50107599999998,33.246554
2700,약천사,33.243,126.45034,735,590,1325,698,569,1267,제주특별자치도 서귀포시 하원동 1662-4,서귀포시,59,1,126.50107599999998,33.246554
2703,광치기해변,33.45143,126.92336999999999,1312,1091,2403,1228,1042,2270,제주특별자치도 서귀포시 성산읍 고성리 224-33,서귀포시,288,2,126.92351500000001,33.451865
2704,광치기해변,33.4523,126.92366000000001,921,542,1463,880,532,1412,제주특별자치도 서귀포시 성산읍 고성리 224-40,서귀포시,288,2,126.92351500000001,33.451865
2706,수산2리입구,33.438829999999996,126.87388999999999,462,20,482,458,20,478,제주특별자치도 서귀포시 성산읍 수산리 1668-4,서귀포시,289,2,126.87387,33.43886499999999
2707,수산2리입구,33.4389,126.87385,281,9,290,277,9,286,제주특별자치도 서귀포시 성산읍 수산리 1668-1,서귀포시,289,2,126.87387,33.43886499999999
2708,일출랜드입구,33.38074,126.84506999999999,40,46,86,36,45,81,제주특별자치도 서귀포시 성산읍 삼달리 807-2,서귀포시,290,2,126.844995,33.380755
2709,일출랜드입구,33.38077,126.84492,73,20,93,66,20,86,제주특별자치도 서귀포시 성산읍 삼달리 1059-9,서귀포시,290,2,126.844995,33.380755
2710,사농동산,33.34422,126.70318999999999,250,5,255,248,5,253,제주특별자치도 서귀포시 남원읍 수망리 산 91-2,서귀포시,13,3,126.5886957142857,33.29717571428572
2711,사농동산,33.34279,126.70398,61,5,66,61,5,66,제주특별자치도 서귀포시 남원읍 수망리 산 89-1,서귀포시,13,3,126.5886957142857,33.29717571428572
2712,트릭아트뮤지엄,33.39946,126.78723000000001,421,192,613,407,183,590,제주특별자치도 서귀포시 표선면 성읍리 2375-5,서귀포시,481,4,126.78723000000001,33.39946
2714,문화마을,33.39302,126.7979,1383,216,1599,1330,210,1540,제주특별자치도 서귀포시 표선면 성읍리 1609,서귀포시,291,2,126.798055,33.393
2715,문화마을,33.39298,126.79821000000001,1413,86,1499,1396,83,1479,제주특별자치도 서귀포시 표선면 성읍리 1636-2,서귀포시,291,2,126.798055,33.393
2716,표선허브동산,33.33056,126.81652,171,59,230,165,56,221,제주특별자치도 서귀포시 표선면 표선리 2632-2,서귀포시,292,2,126.81625,33.33063
2717,선인장마을,33.39499,126.85942,7,1,8,6,1,7,제주특별자치도 서귀포시 성산읍 난산리 1961-14,서귀포시,482,4,126.85942,33.39499
2718,붉은오름,33.3946,126.68534,1013,461,1474,954,423,1377,제주특별자치도 서귀포시 표선면 가시리 산 158-1,서귀포시,293,2,126.685295,33.394909999999996
2719,붉은오름,33.39522,126.68525,2501,944,3445,2319,907,3226,제주특별자치도 서귀포시 표선면 가시리 산 158-5,서귀포시,293,2,126.685295,33.394909999999996
2720,표선허브동산,33.3307,126.81598000000001,162,45,207,157,45,202,제주특별자치도 서귀포시 표선면 표선리 2632-3,서귀포시,292,2,126.81625,33.33063
2721,탄산온천,33.25045,126.29808,1629,718,2347,1560,682,2242,제주특별자치도 서귀포시 안덕면 사계리 1030-1,서귀포시,294,2,126.297785,33.250515
2722,화순문화마을,33.25251,126.33018999999999,643,30,673,639,29,668,제주특별자치도 서귀포시 안덕면 화순리 1202-2,서귀포시,295,2,126.33010499999999,33.252605
2723,안덕면사무소,33.25731,126.33003000000001,713,76,789,705,73,778,제주특별자치도 서귀포시 안덕면 화순리 2029,서귀포시,296,2,126.32985,33.257515
2724,안덕면사무소,33.25772,126.32967,299,16,315,295,16,311,제주특별자치도 서귀포시 안덕면 화순리 2026-34,서귀포시,296,2,126.32985,33.257515
2725,화순문화마을,33.2527,126.33001999999999,187,10,197,187,9,196,제주특별자치도 서귀포시 안덕면 화순리 1202-7,서귀포시,295,2,126.33010499999999,33.252605
2726,산방산,33.23625,126.31142,12,11,23,12,11,23,제주특별자치도 서귀포시 안덕면 사계리 157-5,서귀포시,42,1,126.39550200000001,33.246428
2729,돈내코마을,33.3029,126.57366,3,1,4,3,1,4,제주특별자치도 서귀포시 상효동 2245,서귀포시,88,2,126.57359,33.302825
2730,충혼묘지광장,33.30751,126.57037,722,213,935,683,188,871,제주특별자치도 서귀포시 상효동 2190,서귀포시,483,4,126.57037,33.30751
2732,하례2리입구,33.30061,126.60208999999999,1406,195,1601,1388,188,1576,제주특별자치도 서귀포시 남원읍 하례리 1869-1,서귀포시,484,4,126.60208999999999,33.30061
2733,오설록,33.30507,126.28946,42,17,59,41,14,55,제주특별자치도 서귀포시 안덕면 서광리 1224-44,서귀포시,60,1,126.3705242857143,33.28986428571428
2734,오설록,33.30513,126.28913,508,547,1055,487,524,1011,제주특별자치도 서귀포시 안덕면 서광리 1224-58,서귀포시,60,1,126.3705242857143,33.28986428571428
2735,대정초등학교,33.224779999999996,126.25639,1175,80,1255,1161,78,1239,제주특별자치도 서귀포시 대정읍 상모리 3871-1,서귀포시,50,1,126.377458,33.239484000000004
2737,토요시장입구,33.22129,126.25192,589,119,708,584,119,703,제주특별자치도 서귀포시 대정읍 하모리 943-5,서귀포시,40,1,126.4694525,33.254366250000004
2738,하모체육공원,33.21845,126.25209,129,31,160,125,26,151,제주특별자치도 서귀포시 대정읍 하모리 2126-5,서귀포시,61,1,126.36891666666666,33.22575333333334
2739,구억리옹기체험관,33.27407,126.27868000000001,1450,385,1835,1407,364,1771,제주특별자치도 서귀포시 대정읍 구억리 979,서귀포시,485,4,126.27868000000001,33.27407
2740,하모체육공원,33.21875,126.25228999999999,39,20,59,36,15,51,제주특별자치도 서귀포시 대정읍 하모리 2148,서귀포시,61,1,126.36891666666666,33.22575333333334
2741,NLCS제주,33.296620000000004,126.28563,872,202,1074,862,188,1050,제주특별자치도 서귀포시 대정읍 구억리 1066,서귀포시,297,2,126.285395,33.296530000000004
2742,NLCS제주,33.296440000000004,126.28516,329,8,337,324,8,332,제주특별자치도 서귀포시 대정읍 구억리 1110,서귀포시,297,2,126.285395,33.296530000000004
2743,동광환승정류장2(영어교육도시방면),33.310340000000004,126.33936000000001,9580,3490,13070,9426,3322,12748,제주특별자치도 서귀포시 안덕면 동광리 942-3,서귀포시,52,1,126.38022545454545,33.30013272727273
2744,차남동산,33.45255,126.83808,6,5,11,6,5,11,제주특별자치도 서귀포시 성산읍 수산리 4200-1,서귀포시,298,2,126.838165,33.45259
2745,차남동산,33.45263,126.83825,200,32,232,199,30,229,제주특별자치도 서귀포시 성산읍 수산리 4200-1,서귀포시,298,2,126.838165,33.45259
2746,서귀포등기소,33.25314,126.56015,35570,4299,39869,34957,4153,39110,제주특별자치도 서귀포시 서홍동 441-39,서귀포시,9,1,126.57550250000001,33.25769583333333
2747,비안동,33.282109999999996,126.72055,59,5,64,59,2,61,제주특별자치도 서귀포시 남원읍 남원리 214-22,서귀포시,53,1,126.6864557142857,33.269752857142855
2748,비안동,33.281209999999994,126.72096,181,25,206,180,25,205,제주특별자치도 서귀포시 남원읍 남원리 211-2,서귀포시,53,1,126.6864557142857,33.269752857142855
2749,남원중학교,33.280640000000005,126.71763999999999,675,5,680,673,5,678,제주특별자치도 서귀포시 남원읍 남원리 2490-115,서귀포시,486,4,126.71763999999999,33.280640000000005
2751,남원포구입구,33.27887,126.71773,10277,240,10517,10060,229,10289,제주특별자치도 서귀포시 남원읍 남원리 116-6,서귀포시,299,2,126.71775,33.27879
2752,남원포구입구,33.27871,126.71777,11905,274,12179,11739,264,12003,제주특별자치도 서귀포시 남원읍 남원리 119-7,서귀포시,299,2,126.71775,33.27879
2754,풍력생태길입구,33.433170000000004,126.82412,7,16,23,7,16,23,제주특별자치도 서귀포시 성산읍 수산리 4711-4,서귀포시,487,4,126.82412,33.433170000000004
2755,모슬포항,33.21754,126.2524,765,107,872,731,100,831,제주특별자치도 서귀포시 대정읍 하모리 2148,서귀포시,61,1,126.36891666666666,33.22575333333334
2756,대포포구,33.23888,126.43565,771,405,1176,712,385,1097,제주특별자치도 서귀포시 대포동 2415,서귀포시,300,2,126.4357,33.238835
2757,대포포구,33.23879,126.43575,388,284,672,377,270,647,제주특별자치도 서귀포시 대포동 2415,서귀포시,300,2,126.4357,33.238835
2760,농기구수리센터,33.329840000000004,126.82171000000001,46,9,55,46,9,55,제주특별자치도 서귀포시 표선면 표선리 2050-4,서귀포시,301,2,126.82161500000001,33.329825
2761,농기구수리센터,33.329809999999995,126.82151999999999,67,25,92,65,25,90,제주특별자치도 서귀포시 표선면 표선리 2954,서귀포시,301,2,126.82161500000001,33.329825
2765,주공34단지,33.25115,126.5729,13432,100,13532,13297,93,13390,제주특별자치도 서귀포시 동홍동 145-4,서귀포시,10,1,126.50737875000002,33.25214
2767,LH12단지,33.25002,126.52263,465,80,545,465,80,545,제주특별자치도 서귀포시 서호동 1534,서귀포시,302,2,126.52289,33.249925
2768,LH12단지,33.249829999999996,126.52315,6042,68,6110,5888,66,5954,제주특별자치도 서귀포시 서호동 1577,서귀포시,302,2,126.52289,33.249925
2771,"테디밸리골프앤리조트,헬로키티아일랜드",33.2919,126.3512,713,340,1053,656,298,954,제주특별자치도 서귀포시 안덕면 상창리 2014,서귀포시,303,2,126.35135500000001,33.29183999999999
2772,산방복지회관,33.233290000000004,126.30192,1350,176,1526,1321,170,1491,제주특별자치도 서귀포시 안덕면 사계리 1839-1,서귀포시,304,2,126.302085,33.233245
2773,산방복지회관,33.2332,126.30225,334,22,356,328,21,349,제주특별자치도 서귀포시 안덕면 사계리 1841-2,서귀포시,304,2,126.302085,33.233245
2774,성박물관,33.25548,126.34533,745,358,1103,721,342,1063,제주특별자치도 서귀포시 안덕면 감산리 1736,서귀포시,16,3,126.48757857142856,33.25839714285715
2775,성박물관,33.25547,126.34407,243,99,342,236,98,334,제주특별자치도 서귀포시 안덕면 화순리 118-4,서귀포시,16,3,126.48757857142856,33.25839714285715
2778,"테디밸리골프앤리조트,헬로키티아일랜드",33.291779999999996,126.35151,1162,380,1542,1096,337,1433,제주특별자치도 서귀포시 안덕면 상창리 2888,서귀포시,303,2,126.35135500000001,33.29183999999999
2779,표선도서관,33.324909999999996,126.83859,17,2,19,17,2,19,제주특별자치도 서귀포시 표선면 표선리 40-8,서귀포시,305,2,126.83866499999999,33.32519
2780,표선도서관,33.32547,126.83873999999999,1423,67,1490,1380,67,1447,제주특별자치도 서귀포시 표선면 표선리 44-4,서귀포시,305,2,126.83866499999999,33.32519
2781,달산봉입구,33.34257,126.82661999999999,168,14,182,153,13,166,제주특별자치도 서귀포시 표선면 하천리 1100-3,서귀포시,62,1,126.733986,33.309762
2782,달산봉입구,33.343779999999995,126.82656000000001,261,13,274,259,13,272,제주특별자치도 서귀포시 표선면 하천리 1118-1,서귀포시,62,1,126.733986,33.309762
2783,세성로입구,33.37863,126.802,63,2,65,63,2,65,제주특별자치도 서귀포시 표선면 성읍리 1096-1,서귀포시,306,2,126.80205500000001,33.378645000000006
2784,세성로입구,33.37866,126.80211000000001,362,20,382,358,20,378,제주특별자치도 서귀포시 표선면 성읍리 3294,서귀포시,306,2,126.80205500000001,33.378645000000006
2785,진우파크빌,33.44613,126.90501,630,24,654,619,23,642,제주특별자치도 서귀포시 성산읍 고성리 1588-3,서귀포시,307,2,126.905315,33.4461
2786,진우파크빌,33.44607,126.90562,327,44,371,321,41,362,제주특별자치도 서귀포시 성산읍 고성리 1528-5,서귀포시,307,2,126.905315,33.4461
2788,수산1리사거리,33.44242,126.88377,592,22,614,590,22,612,제주특별자치도 서귀포시 성산읍 수산리 734-2,서귀포시,308,2,126.883905,33.442335
2789,수산1리사거리,33.44225,126.88403999999998,296,9,305,295,9,304,제주특별자치도 서귀포시 성산읍 수산리 796-18,서귀포시,308,2,126.883905,33.442335
2792,제주민속촌,33.32547,126.84103,8050,2043,10093,7700,1845,9545,제주특별자치도 서귀포시 표선면 표선리 44-7,서귀포시,31,3,126.61406500000001,33.26293875
2793,고성리성산농협,33.44611,126.91261000000002,3559,496,4055,3501,483,3984,제주특별자치도 서귀포시 성산읍 고성리 1093-13,서귀포시,309,2,126.912715,33.446169999999995
2794,농협하나로마트,33.44623,126.91282,507,203,710,483,193,676,제주특별자치도 서귀포시 성산읍 고성리 2747,서귀포시,309,2,126.912715,33.446169999999995
2796,탄산온천,33.25058,126.29749,1268,302,1570,1233,292,1525,제주특별자치도 서귀포시 안덕면 덕수리 3004,서귀포시,294,2,126.297785,33.250515
2797,혼착밭,33.23935,126.47111000000001,33,2,35,31,2,33,제주특별자치도 서귀포시 강정동 5508,서귀포시,310,2,126.47104,33.239285
2798,혼착밭,33.23922,126.47097,114,11,125,113,10,123,제주특별자치도 서귀포시 강정동 5508-1,서귀포시,310,2,126.47104,33.239285
2799,수산1리비석거리,33.44357,126.889,1395,227,1622,1377,225,1602,제주특별자치도 서귀포시 성산읍 수산리 271-2,서귀포시,36,1,126.6409257142857,33.35606571428571
2800,수산1리비석거리,33.44338,126.88893999999999,887,320,1207,877,314,1191,제주특별자치도 서귀포시 성산읍 수산리 246-11,서귀포시,36,1,126.6409257142857,33.35606571428571
2801,수산2리생태체험센터,33.43925,126.86307,339,50,389,338,49,387,제주특별자치도 서귀포시 성산읍 수산리 4764,서귀포시,311,2,126.86311,33.43921
2802,수산2리생태체험센터,33.439170000000004,126.86315,418,10,428,409,10,419,제주특별자치도 서귀포시 성산읍 수산리 4764,서귀포시,311,2,126.86311,33.43921
2804,미타요양원,33.44658,126.85212,63,6,69,62,6,68,제주특별자치도 서귀포시 성산읍 수산리 3069-2,서귀포시,488,4,126.85212,33.44658
2806,돔뱅이왓,33.235,126.3695,1090,134,1224,1064,127,1191,제주특별자치도 서귀포시 하예동 1810-1,서귀포시,312,2,126.369475,33.235079999999996
2807,관광단지입구,33.256209999999996,126.41473,19,9,28,19,9,28,제주특별자치도 서귀포시 색달동 2511-3,서귀포시,313,2,126.41467,33.256299999999996
2808,관광단지입구,33.25639,126.41461000000001,124,35,159,122,33,155,제주특별자치도 서귀포시 색달동 2511-4,서귀포시,313,2,126.41467,33.256299999999996
2809,색달마을입구,33.26031,126.41348,619,30,649,595,29,624,제주특별자치도 서귀포시 색달동 2233-1,서귀포시,314,2,126.413535,33.260355
2810,색달마을입구,33.2604,126.41358999999999,27,9,36,27,9,36,제주특별자치도 서귀포시 색달동 1926-7,서귀포시,314,2,126.413535,33.260355
2811,성산농협,33.447070000000004,126.91103999999999,2191,160,2351,2145,155,2300,제주특별자치도 서귀포시 성산읍 고성리 1063-5,서귀포시,315,2,126.911155,33.44699
2812,성산농협,33.446909999999995,126.91127,136,35,171,135,33,168,제주특별자치도 서귀포시 성산읍 고성리 2747,서귀포시,315,2,126.911155,33.44699
2813,송악도서관,33.22573,126.24824,461,26,487,459,25,484,제주특별자치도 서귀포시 대정읍 하모리 1235-5,서귀포시,219,2,126.24780000000001,33.22552
2814,동백동산,33.28935,126.36738999999999,454,602,1056,421,579,1000,제주특별자치도 서귀포시 안덕면 상창리 999,서귀포시,489,4,126.36738999999999,33.28935
2816,블랭섬홀아시아,33.29189,126.2848,2851,610,3461,2758,561,3319,제주특별자치도 서귀포시 대정읍 구억리 1117,서귀포시,12,3,126.45767142857143,33.284415714285714
2817,블랭섬홀아시아,33.29115,126.28391,769,37,806,759,36,795,제주특별자치도 서귀포시 대정읍 보성리 2373,서귀포시,12,3,126.45767142857143,33.284415714285714
2818,한국국제학교,33.28725,126.28173000000001,1542,60,1602,1508,55,1563,제주특별자치도 서귀포시 대정읍 보성리 2417,서귀포시,316,2,126.28207,33.287400000000005
2819,한국국제학교,33.28755,126.28241000000001,4253,868,5121,4117,786,4903,제주특별자치도 서귀포시 대정읍 구억리 1132,서귀포시,316,2,126.28207,33.287400000000005
2820,삼정지에듀,33.28481,126.2785,3951,871,4822,3830,800,4630,제주특별자치도 서귀포시 대정읍 보성리 2432,서귀포시,317,2,126.27808,33.284855
2821,삼정지에듀,33.2849,126.27766000000001,832,109,941,804,106,910,제주특별자치도 서귀포시 대정읍 보성리 2424,서귀포시,317,2,126.27808,33.284855
2825,중문관광단지여미지식물원입구,33.2517,126.41264,2048,1870,3918,2048,1870,3918,제주특별자치도 서귀포시 색달동 2822-1,서귀포시,21,1,126.55541500000001,33.29999375
2830,진군을리,33.283640000000005,126.36423,1,12,13,1,12,13,제주특별자치도 서귀포시 안덕면 상창리 899-3,서귀포시,318,2,126.364175,33.283730000000006
2831,진군을리,33.28382,126.36412,42,67,109,35,65,100,제주특별자치도 서귀포시 안덕면 상창리 897-1,서귀포시,318,2,126.364175,33.283730000000006
2833,방아동,33.2798,126.17493999999999,29,1,30,29,1,30,제주특별자치도 서귀포시 대정읍 신도리 2633-8,서귀포시,490,4,126.17493999999999,33.2798
2834,남원취락구조,33.27496,126.70031000000002,377,64,441,359,61,420,제주특별자치도 서귀포시 남원읍 남원리 2446,서귀포시,319,2,126.700255,33.275054999999995
2835,남원취락구조,33.27515,126.7002,399,41,440,384,39,423,제주특별자치도 서귀포시 남원읍 남원리 2447-3,서귀포시,319,2,126.700255,33.275054999999995
2836,주공6단지,33.26269,126.55905,2659,20,2679,2627,19,2646,제주특별자치도 서귀포시 동홍동 1577-5,서귀포시,491,4,126.55905,33.26269
2837,이교동삼거리,33.22619,126.27201000000001,156,3,159,148,3,151,제주특별자치도 서귀포시 대정읍 상모리 2151-5,서귀포시,320,2,126.27158,33.226215
2838,이교동삼거리,33.226240000000004,126.27115,1249,46,1295,1231,42,1273,제주특별자치도 서귀포시 대정읍 상모리 2659-3,서귀포시,320,2,126.27158,33.226215
2839,산지물,33.265370000000004,126.5647,637,15,652,603,13,616,제주특별자치도 서귀포시 동홍동 1701-3,서귀포시,321,2,126.564665,33.265275
2840,산지물,33.26518,126.56463000000001,155,2,157,153,2,155,제주특별자치도 서귀포시 동홍동 1702-1,서귀포시,321,2,126.564665,33.265275
2842,제주오설록티뮤지엄,33.30522,126.28801000000001,913,949,1862,856,917,1773,제주특별자치도 서귀포시 안덕면 서광리 산 50-13,서귀포시,60,1,126.3705242857143,33.28986428571428
2843,중문관광단지여미지식물원입구,33.252140000000004,126.41268000000001,168,312,480,168,312,480,제주특별자치도 서귀포시 색달동 2822-1,서귀포시,21,1,126.55541500000001,33.29999375
2844,제주월드컵경기장(600번),33.249340000000004,126.50903999999998,2496,1190,3686,2496,1190,3686,제주특별자치도 서귀포시 법환동 760,서귀포시,4,1,126.51396210526316,33.26277789473685
2845,동홍초등학교입구,33.25888,126.56848000000001,640,1,641,630,1,631,제주특별자치도 서귀포시 동홍동 588-6,서귀포시,125,2,126.568295,33.258725
2846,굿밭거리,33.257459999999995,126.52505,526,16,542,520,16,536,제주특별자치도 서귀포시 호근동 1841-1,서귀포시,322,2,126.525005,33.25740999999999
2847,굿밭거리,33.25736,126.52496000000001,1643,29,1672,1633,29,1662,제주특별자치도 서귀포시 호근동 1841-1,서귀포시,322,2,126.525005,33.25740999999999
2848,서귀포보건소,33.25212,126.55465,2839,48,2887,2789,48,2837,제주특별자치도 서귀포시 서귀동 973,서귀포시,323,2,126.55475,33.25223
2849,남양맨션,33.25592,126.5679,819,4,823,816,4,820,제주특별자치도 서귀포시 동홍동 518-5,서귀포시,58,1,126.57301166666667,33.252878333333335
2850,남양맨션,33.25584,126.56808000000001,793,2,795,789,2,791,제주특별자치도 서귀포시 동홍동 515,서귀포시,58,1,126.57301166666667,33.252878333333335
2851,제주월드컵경기장(600번),33.249109999999995,126.50907,425,276,701,425,276,701,제주특별자치도 서귀포시 법환동 816-9,서귀포시,4,1,126.51396210526316,33.26277789473685
2852,제주해안경비단,33.35691,126.82303999999999,748,24,772,739,23,762,제주특별자치도 서귀포시 표선면 하천리 1493-4,서귀포시,492,4,126.82303999999999,33.35691
2854,사거리,33.24475,126.43218,1809,18,1827,1784,18,1802,제주특별자치도 서귀포시 대포동 2606,서귀포시,324,2,126.432125,33.24486
2855,사거리,33.24497,126.43207,462,17,479,451,17,468,제주특별자치도 서귀포시 대포동 1672,서귀포시,324,2,126.432125,33.24486
2856,소보리당,33.26432,126.38418,596,106,702,575,104,679,제주특별자치도 서귀포시 상예동 4999,서귀포시,5,2,126.39661875,33.266799999999996
2857,상원동,33.275209999999994,126.66335,3802,72,3874,3723,71,3794,제주특별자치도 서귀포시 남원읍 위미리 1902-2,서귀포시,72,2,126.66344000000001,33.27513
2858,원물오름,33.3186,126.34651000000001,201,99,300,196,98,294,제주특별자치도 서귀포시 안덕면 동광리 386,서귀포시,325,2,126.34653,33.318445000000004
2859,원물오름,33.318290000000005,126.34655,95,4,99,92,4,96,제주특별자치도 서귀포시 안덕면 동광리 377-1,서귀포시,325,2,126.34653,33.318445000000004
2864,난산리노인복지회관,33.40098,126.87403,342,3,345,338,3,341,제주특별자치도 서귀포시 성산읍 난산리 301-3,서귀포시,493,4,126.87403,33.40098
2865,한남교,33.31258,126.69628999999999,83,4,87,82,4,86,제주특별자치도 서귀포시 남원읍 한남리 270-3,서귀포시,63,1,126.65415800000001,33.290906
2866,한남교,33.31257,126.69675,191,4,195,189,4,193,제주특별자치도 서귀포시 남원읍 한남리 1656,서귀포시,63,1,126.65415800000001,33.290906
2867,화순리생태탐방로,33.264179999999996,126.33355,16,1,17,16,1,17,제주특별자치도 서귀포시 안덕면 화순리 2045-4,서귀포시,326,2,126.33352500000001,33.264624999999995
2868,화순리생태탐방로,33.26507,126.3335,98,14,112,97,14,111,제주특별자치도 서귀포시 안덕면 화순리 2046,서귀포시,326,2,126.33352500000001,33.264624999999995
2869,서광리넙게오름(축협),33.29019,126.31806,89,11,100,88,11,99,제주특별자치도 서귀포시 안덕면 서광리 980-5,서귀포시,327,2,126.31813,33.290115
2870,서광리넙게오름(축협),33.290040000000005,126.3182,187,24,211,184,22,206,제주특별자치도 서귀포시 안덕면 서광리 985-3,서귀포시,327,2,126.31813,33.290115
2871,남원2리복지회관,33.29323,126.71003,175,1,176,175,1,176,제주특별자치도 서귀포시 남원읍 남원리 1015-7,서귀포시,494,4,126.71003,33.29323
2873,제주공천포전지훈련센터,33.27528,126.63896000000001,165,11,176,159,9,168,제주특별자치도 서귀포시 남원읍 신례리 364-1,서귀포시,495,4,126.63896000000001,33.27528
2875,송악펜션단지,33.21201,126.29236999999999,54,92,146,53,91,144,제주특별자치도 서귀포시 대정읍 상모리 87-27,서귀포시,328,2,126.29236,33.21215
2876,송악펜션단지,33.21229,126.29235,61,21,82,61,20,81,제주특별자치도 서귀포시 대정읍 상모리 73-1,서귀포시,328,2,126.29236,33.21215
2877,산이수동,33.20835,126.29012,312,268,580,305,257,562,제주특별자치도 서귀포시 대정읍 상모리 132,서귀포시,143,2,126.29018500000001,33.20841
2878,섭지코지,33.43665,126.92200000000001,208,163,371,195,156,351,제주특별자치도 서귀포시 성산읍 고성리 203-6,서귀포시,329,2,126.9222,33.43676
2879,섭지코지,33.43687,126.9224,975,752,1727,919,712,1631,제주특별자치도 서귀포시 성산읍 고성리 186-5,서귀포시,329,2,126.9222,33.43676
2880,동모루왓,33.43902,126.91925,207,118,325,197,116,313,제주특별자치도 서귀포시 성산읍 고성리 489-1,서귀포시,330,2,126.91954000000001,33.438959999999994
2881,동모루왓,33.4389,126.91983,55,17,72,54,16,70,제주특별자치도 서귀포시 성산읍 고성리 537-1,서귀포시,330,2,126.91954000000001,33.438959999999994
2882,서건도,33.23605,126.50425,460,370,830,458,370,828,제주특별자치도 서귀포시 강정동 579-1,서귀포시,20,1,126.50806625,33.26451
2883,서건도,33.23595,126.50491000000001,30,37,67,30,37,67,제주특별자치도 서귀포시 강정동 609-2,서귀포시,20,1,126.50806625,33.26451
2884,월평마을,33.24282,126.46083,1114,175,1289,1098,173,1271,제주특별자치도 서귀포시 월평동 510-5,서귀포시,6,1,126.4122775,33.2481775
2885,월평마을,33.24273,126.46096000000001,2143,177,2320,2118,174,2292,제주특별자치도 서귀포시 월평동 510-3,서귀포시,6,1,126.4122775,33.2481775
2886,보성리하동,33.250679999999996,126.27456000000001,186,7,193,178,7,185,제주특별자치도 서귀포시 대정읍 보성리 2138,서귀포시,331,2,126.27444500000001,33.25073999999999
2887,보성리상동,33.2508,126.27433,53,3,56,53,3,56,제주특별자치도 서귀포시 대정읍 보성리 1591-9,서귀포시,331,2,126.27444500000001,33.25073999999999
2888,비석거리,33.25473,126.57586,2564,129,2693,2525,125,2650,제주특별자치도 서귀포시 동홍동 657-4,서귀포시,35,1,126.55455285714287,33.24852714285714
2891,교래리보건소,33.43665,126.67669,637,283,920,588,266,854,제주특별자치도 제주시 조천읍 교래리 483-1,제주시,308,2,126.676445,33.436454999999995
2892,함덕리(4구),33.54011,126.67473999999999,2561,704,3265,2482,678,3160,제주특별자치도 제주시 조천읍 함덕리 4170,제주시,55,1,126.57922571428571,33.512727142857145
2893,삼화지구,33.51723,126.58124,5474,17,5491,5391,17,5408,제주특별자치도 제주시 도련일동 2002,제주시,32,3,126.4152257142857,33.42904285714286
2894,삼화지구,33.51743,126.57886,15485,90,15575,15301,90,15391,제주특별자치도 제주시 삼양이동 2338,제주시,32,3,126.4152257142857,33.42904285714286
2895,오름중학교,33.517109999999995,126.58563000000001,1124,6,1130,1105,5,1110,제주특별자치도 제주시 도련일동 1895-1,제주시,458,2,126.585725,33.5172
2896,오름중학교,33.51729,126.58582,11445,52,11497,11353,51,11404,제주특별자치도 제주시 삼양이동 2338,제주시,458,2,126.585725,33.5172
2897,삼화부영1차아파트,33.51696,126.58757,4258,26,4284,4207,25,4232,제주특별자치도 제주시 도련이동 552,제주시,459,2,126.587625,33.517065
2898,도련초등학교,33.51421,126.58301000000002,5428,15,5443,5365,14,5379,제주특별자치도 제주시 도련일동 1994-5,제주시,460,2,126.583145,33.51432
2899,삼화초등학교,33.51419,126.57673,3765,20,3785,3718,20,3738,제주특별자치도 제주시 화북이동 120,제주시,461,2,126.576845,33.51429
2900,수산저수지입구,33.4732,126.39013999999999,324,14,338,324,13,337,제주특별자치도 제주시 애월읍 수산리 785-1,제주시,462,2,126.390345,33.473164999999995
2901,수산저수지입구,33.47313,126.39055,101,7,108,100,7,107,제주특별자치도 제주시 애월읍 수산리 785-8,제주시,462,2,126.390345,33.473164999999995
2902,수산교차로,33.471140000000005,126.39578999999999,475,17,492,471,17,488,제주특별자치도 제주시 애월읍 하귀2리 2221,제주시,38,3,126.54743142857144,33.496007142857145
2903,수산교차로,33.4714,126.39443,144,15,159,144,14,158,제주특별자치도 제주시 애월읍 수산리 559-3,제주시,38,3,126.54743142857144,33.496007142857145
2904,신산머루,33.45006,126.43746999999999,1284,13,1297,1252,11,1263,제주특별자치도 제주시 애월읍 광령리 959,제주시,463,2,126.437525,33.449934999999996
2905,신산머루,33.44981,126.43758000000001,399,6,405,384,4,388,제주특별자치도 제주시 애월읍 광령리 909,제주시,463,2,126.437525,33.449934999999996
2908,자운당사거리,33.46667,126.35762,116,7,123,116,7,123,제주특별자치도 제주시 애월읍 하가리 297-3,제주시,47,1,126.44603000000001,33.468295000000005
2909,자운당사거리,33.466640000000005,126.35776000000001,83,3,86,83,3,86,제주특별자치도 제주시 애월읍 하가리 297-7,제주시,47,1,126.44603000000001,33.468295000000005
2910,어음2리,33.40247,126.33843,391,2,393,391,2,393,제주특별자치도 제주시 애월읍 어음리 2962-1,제주시,724,4,126.33843,33.40247
2911,명리동알동네,33.31691,126.26816000000001,42,4,46,29,4,33,제주특별자치도 제주시 한경면 저지리 3168,제주시,464,2,126.268205,33.316845
2912,명리동알동네,33.31678,126.26825,24,8,32,23,7,30,제주특별자치도 제주시 한경면 저지리 3166-2,제주시,464,2,126.268205,33.316845
2913,평화박물관입구,33.30466,126.25858999999998,50,15,65,50,13,63,제주특별자치도 제주시 한경면 청수리 147-2,제주시,725,4,126.25858999999998,33.30466
2915,테왓동네,33.319,126.24316999999999,134,3,137,134,3,137,제주특별자치도 제주시 한경면 청수리 2303-3,제주시,465,2,126.24306999999999,33.319
2916,테왓동네,33.319,126.24297,59,1,60,59,1,60,제주특별자치도 제주시 한경면 청수리 2263-6,제주시,465,2,126.24306999999999,33.319
2917,서부신협유통영농조합,33.33546,126.26125,560,10,570,559,10,569,제주특별자치도 제주시 한경면 저지리 2725-3,제주시,448,2,126.261195,33.33553
2918,못거리,33.39258,126.27786,17,5,22,17,5,22,제주특별자치도 제주시 한림읍 동명리 380-2,제주시,726,4,126.27786,33.39258
2922,목다운목,33.520140000000005,126.68843999999999,11,1,12,10,1,11,제주특별자치도 제주시 조천읍 선흘리 3620-2,제주시,466,2,126.68854999999999,33.520155
2923,목다운목,33.52017,126.68866000000001,65,6,71,62,4,66,제주특별자치도 제주시 조천읍 선흘리 3459-3,제주시,466,2,126.68854999999999,33.520155
2926,농굴왓입구,33.50806,126.82654,8,3,11,8,3,11,제주특별자치도 제주시 구좌읍 평대리 2541,제주시,467,2,126.82635,33.508070000000004
2927,농굴왓입구,33.50808,126.82616000000002,18,1,19,17,1,18,제주특별자치도 제주시 구좌읍 평대리 2544-5,제주시,467,2,126.82635,33.508070000000004
2933,벌탬못,33.50768,126.77183000000001,2,3,5,2,3,5,제주특별자치도 제주시 구좌읍 덕천리 321,제주시,727,4,126.77183000000001,33.50768
2934,뒷산길,33.49275,126.65061000000001,5,3,8,5,3,8,제주특별자치도 제주시 조천읍 대흘리 2628-1,제주시,728,4,126.65061000000001,33.49275
2936,앞밭가름,33.44273,126.40166,263,5,268,263,5,268,제주특별자치도 제주시 애월읍 유수암리 1928-9,제주시,468,2,126.40166,33.44278
2937,앞밭가름,33.44283,126.40166,634,24,658,627,24,651,제주특별자치도 제주시 애월읍 유수암리 2033-1,제주시,468,2,126.40166,33.44278
2939,막거리,33.42743,126.4014,75,2,77,75,2,77,제주특별자치도 제주시 애월읍 유수암리 1521,제주시,729,4,126.4014,33.42743
2940,평화동회관,33.30704,126.25355,16,5,21,15,5,20,제주특별자치도 제주시 한경면 청수리 3389,제주시,730,4,126.25355,33.30704
2945,신안동,33.515,126.63503999999999,32,5,37,32,5,37,제주특별자치도 제주시 조천읍 신촌리 308,제주시,731,4,126.63503999999999,33.515
2946,상하수도본부,33.499140000000004,126.64996000000001,13,8,21,13,8,21,제주특별자치도 제주시 조천읍 대흘리 2651-1,제주시,732,4,126.64996000000001,33.499140000000004
2948,한흘마을입구,33.49565,126.66202,18,2,20,16,1,17,제주특별자치도 제주시 조천읍 대흘리 1568-1,제주시,469,2,126.66206500000001,33.495695
2949,한흘마을입구,33.495740000000005,126.66211000000001,100,1,101,99,1,100,제주특별자치도 제주시 조천읍 대흘리 1038-3,제주시,469,2,126.66206500000001,33.495695
2950,와산리경로당,33.49276,126.68148000000001,225,110,335,215,106,321,제주특별자치도 제주시 조천읍 와산리 903-3,제주시,470,2,126.681285,33.492815
2951,와산리경로당,33.49287,126.68109,268,107,375,249,105,354,제주특별자치도 제주시 조천읍 와산리 909,제주시,470,2,126.681285,33.492815
2952,금산,33.49532,126.68012,93,25,118,92,24,116,제주특별자치도 제주시 조천읍 와산리 1707,제주시,471,2,126.680045,33.495189999999994
2953,금산,33.495059999999995,126.67997,163,10,173,161,10,171,제주특별자치도 제주시 조천읍 와산리 872-1,제주시,471,2,126.680045,33.495189999999994
2954,틀라목,33.50076,126.67753,173,13,186,165,13,178,제주특별자치도 제주시 조천읍 대흘리 197-1,제주시,472,2,126.677245,33.500865000000005
2955,틀라목,33.50097,126.67696000000001,123,2,125,123,2,125,제주특별자치도 제주시 조천읍 대흘리 198-7,제주시,472,2,126.677245,33.500865000000005
2956,원노형,33.48617,126.48319,3967,275,4242,3881,258,4139,제주특별자치도 제주시 노형동 913-7,제주시,208,2,126.48337,33.486075
2957,정든마을3단지,33.49007,126.47129,92,3,95,92,3,95,제주특별자치도 제주시 노형동 2712-1,제주시,473,2,126.471295,33.489940000000004
2958,정든마을3단지,33.48981,126.4713,342,1,343,339,1,340,제주특별자치도 제주시 노형동 2712-1,제주시,473,2,126.471295,33.489940000000004
2959,임항로,33.52071,126.54028000000001,486,51,537,473,49,522,제주특별자치도 제주시 건입동 918-13,제주시,69,2,126.49114,33.488147500000004
2961,소길장밭,33.4425,126.38427,46,2,48,44,2,46,제주특별자치도 제주시 애월읍 장전리 1797,제주시,733,4,126.38427,33.4425
2962,백화동,33.46699,126.71016999999999,7,5,12,7,5,12,제주특별자치도 제주시 조천읍 선흘리 4203,제주시,474,2,126.710295,33.46691
2963,백화동,33.46683,126.71042,13,7,20,13,7,20,제주특별자치도 제주시 조천읍 선흘리 547-1,제주시,474,2,126.710295,33.46691
2964,롯데시티호텔(600번),33.4899,126.48893999999999,145,172,317,145,172,317,제주특별자치도 제주시 연동 260,제주시,20,1,126.42909875,33.60540125
2965,제주도립미술관,33.45284,126.48787,1153,443,1596,1099,426,1525,제주특별자치도 제주시 연동 680-7,제주시,734,4,126.48787,33.45284
2966,롯데시티호텔(600번),33.49002,126.48856,461,1300,1761,461,1300,1761,제주특별자치도 제주시 연동 260,제주시,20,1,126.42909875,33.60540125
2967,관음사,33.42642,126.55787,1617,1081,2698,1524,1035,2559,제주특별자치도 제주시 아라일동 387-1,제주시,475,2,126.5578,33.426514999999995
2968,관음사,33.42661,126.55773,24,9,33,23,9,32,제주특별자치도 제주시 아라일동 산 64-4,제주시,475,2,126.5578,33.426514999999995
2969,제주버스터미널(종점),33.49919000000001,126.51632,835,54,889,827,52,879,제주특별자치도 제주시 삼도일동 560-2,제주시,476,2,126.516415,33.49879000000001
2970,제주시외버스터미널(종점),33.49993,126.51414,1638,189,1827,1607,184,1791,제주특별자치도 제주시 오라일동 2455-2,제주시,6,1,126.468044,33.475798999999995
2971,제주한라대학교(종점),33.47779,126.47573999999999,8380,669,9049,8231,647,8878,제주특별자치도 제주시 노형동 1490-2,제주시,23,1,126.48255285714285,33.48248285714286
2972,제주국제공항(종점),33.50571,126.49318999999998,2739,2532,5271,2678,2432,5110,제주특별자치도 제주시 용담이동 1462,제주시,28,1,126.48837428571427,33.499021428571425
2972,제주국제공항(종점),33.50571,126.49318999999998,2739,2532,5271,2678,2432,5110,제주특별자치도 제주시 용담이동 1462,제주시,28,1,126.48837428571427,33.499021428571425
2972,제주국제공항(종점),33.50571,126.49318999999998,2739,2532,5271,2678,2432,5110,제주특별자치도 제주시 용담이동 1462,제주시,28,1,126.48837428571427,33.499021428571425
2972,제주국제공항(종점),33.505720000000004,126.49328999999999,2739,2532,5271,2678,2432,5110,제주특별자치도 제주시 용담이동 1462,제주시,28,1,126.48837428571427,33.499021428571425
2972,제주국제공항(종점),33.505720000000004,126.49328999999999,2739,2532,5271,2678,2432,5110,제주특별자치도 제주시 용담이동 1462,제주시,28,1,126.48837428571427,33.499021428571425
2972,제주국제공항(종점),33.505720000000004,126.49328999999999,2739,2532,5271,2678,2432,5110,제주특별자치도 제주시 용담이동 1462,제주시,28,1,126.48837428571427,33.499021428571425
2972,제주국제공항(종점),33.505720000000004,126.49356,2739,2532,5271,2678,2432,5110,제주특별자치도 제주시 용담이동 1462,제주시,28,1,126.48837428571427,33.499021428571425
2972,제주국제공항(종점),33.505720000000004,126.49356,2739,2532,5271,2678,2432,5110,제주특별자치도 제주시 용담이동 1462,제주시,28,1,126.48837428571427,33.499021428571425
2972,제주국제공항(종점),33.505720000000004,126.49356,2739,2532,5271,2678,2432,5110,제주특별자치도 제주시 용담이동 1462,제주시,28,1,126.48837428571427,33.499021428571425
2973,제주국제공항,33.5045,126.49455,22301,8683,30984,20733,8048,28781,제주특별자치도 제주시 용담이동 1972-2,제주시,735,4,126.49455,33.5045
2975,신안동교차로,33.51912,126.63399,161,6,167,161,6,167,제주특별자치도 제주시 조천읍 조천리 3441,제주시,736,4,126.63399,33.51912
2977,하귀하나로마트,33.48464,126.41138000000001,3379,32,3411,3343,32,3375,제주특별자치도 제주시 애월읍 하귀1리 584,제주시,2,1,126.40150375000002,33.478381250000005
2978,성화마을회관,33.51227,126.50278999999999,525,33,558,511,31,542,제주특별자치도 제주시 용담이동 941-8,제주시,737,4,126.50278999999999,33.51227
2980,용담어린이집,33.51175,126.50532,4204,108,4312,4172,106,4278,제주특별자치도 제주시 용담이동 928-74,제주시,477,2,126.50540000000001,33.51173
2981,용담어린이집,33.51171,126.50548,4878,70,4948,4841,66,4907,제주특별자치도 제주시 용담이동 608-40,제주시,477,2,126.50540000000001,33.51173
2982,화북휴먼시아정문,33.51589,126.57656999999999,4933,30,4963,4860,28,4888,제주특별자치도 제주시 화북일동 1029,제주시,435,2,126.57644499999999,33.51593
2983,삼화초등학교,33.51439,126.57696000000001,4368,43,4411,4307,43,4350,제주특별자치도 제주시 화북일동 1027,제주시,461,2,126.576845,33.51429
2984,도련초등학교,33.51443,126.58328,6410,41,6451,6349,40,6389,제주특별자치도 제주시 도련일동 1895-1,제주시,460,2,126.583145,33.51432
2985,삼화부영1차아파트,33.51717,126.58768,6534,61,6595,6457,60,6517,제주특별자치도 제주시 삼양이동 2336,제주시,459,2,126.587625,33.517065
2986,존손이굴,33.452940000000005,126.35933999999999,87,3,90,86,3,89,제주특별자치도 제주시 애월읍 하가리 556-7,제주시,738,4,126.35933999999999,33.452940000000005
2988,동복리관광체험어장,33.553329999999995,126.71654,24,9,33,23,9,32,제주특별자치도 제주시 구좌읍 동복리 726-1,제주시,17,3,126.55606124999998,33.50669
2989,신흥1번지,33.30573,126.77368,83,14,97,80,14,94,제주특별자치도 서귀포시 남원읍 신흥리 33-4,서귀포시,332,2,126.773815,33.305935
2990,김영갑갤러리두모악,33.37194,126.85655,4,5,9,4,5,9,제주특별자치도 서귀포시 성산읍 삼달리 256-3,서귀포시,333,2,126.856695,33.37198
2991,김영갑갤러리두모악,33.37202,126.85683999999999,124,29,153,123,29,152,제주특별자치도 서귀포시 성산읍 삼달리 270-6,서귀포시,333,2,126.856695,33.37198
2993,바겟도동산,33.336909999999996,126.70822,34,6,40,34,6,40,제주특별자치도 서귀포시 남원읍 수망리 720-1,서귀포시,496,4,126.70822,33.336909999999996
2994,위미농협하례지소,33.29768,126.60955,629,7,636,627,7,634,제주특별자치도 서귀포시 남원읍 하례리 1367-3,서귀포시,497,4,126.60955,33.29768
2996,하례2리,33.28933,126.60623000000001,67,1,68,67,1,68,제주특별자치도 서귀포시 남원읍 하례리 1633-3,서귀포시,92,2,126.60611,33.28931
2998,장애인복지회관,33.28642,126.58431000000002,427,7,434,425,7,432,제주특별자치도 서귀포시 토평동 1940-2,서귀포시,498,4,126.58431000000002,33.28642
2999,하례2리,33.293009999999995,126.60836,101,5,106,99,5,104,제주특별자치도 서귀포시 남원읍 하례리 1887,서귀포시,499,4,126.60836,33.293009999999995
3003,가시리체육공원,33.35236,126.77491,109,1,110,109,1,110,제주특별자치도 서귀포시 표선면 가시리 1989-5,서귀포시,500,4,126.77491,33.35236
3004,논오름,33.27414,126.33348000000001,20,1,21,20,1,21,제주특별자치도 서귀포시 안덕면 덕수리 산 2-4,서귀포시,334,2,126.333595,33.27423
3005,논오름,33.27432,126.33371000000001,5,5,10,5,5,10,제주특별자치도 서귀포시 안덕면 덕수리 산 2-1,서귀포시,334,2,126.333595,33.27423
3006,동하동,33.347359999999995,126.77731999999999,122,2,124,121,2,123,제주특별자치도 서귀포시 표선면 가시리 1114-3,서귀포시,501,4,126.77731999999999,33.347359999999995
3010,삼달1리게이트볼장,33.37625,126.84345,101,13,114,101,12,113,제주특별자치도 서귀포시 성산읍 삼달리 1152-1,서귀포시,502,4,126.84345,33.37625
3011,삼달1리사무소,33.374359999999996,126.84705,477,8,485,477,6,483,제주특별자치도 서귀포시 성산읍 삼달리 723-1,서귀포시,503,4,126.84705,33.374359999999996
3012,상천리,33.30731,126.38148000000001,102,46,148,98,45,143,제주특별자치도 서귀포시 안덕면 상천리 470-2,서귀포시,335,2,126.38144500000001,33.307225
3013,상천리,33.307140000000004,126.38141,308,153,461,303,146,449,제주특별자치도 서귀포시 안덕면 상천리 470-5,서귀포시,335,2,126.38144500000001,33.307225
3014,서귀포보건소,33.252340000000004,126.55485,2112,39,2151,2082,38,2120,제주특별자치도 서귀포시 서홍동 449-13,서귀포시,323,2,126.55475,33.25223
3015,성산기상대관사,33.38425,126.86922,16,1,17,16,1,17,제주특별자치도 서귀포시 성산읍 신산리 1363,서귀포시,504,4,126.86922,33.38425
3019,동문로터리,33.24988,126.56776,174,9,183,172,9,181,제주특별자치도 서귀포시 서귀동 254-17,서귀포시,23,1,126.52565142857144,33.25023785714286
3020,동문로터리,33.24986,126.56792,1330,10,1340,1308,10,1318,제주특별자치도 서귀포시 서귀동 253-24,서귀포시,23,1,126.52565142857144,33.25023785714286
3021,서귀포초등학교,33.243159999999996,126.56506999999999,52,12,64,52,11,63,제주특별자치도 서귀포시 서귀동 723-5,서귀포시,24,1,126.50524000000001,33.24985777777778
3022,석교동,33.31033,126.34951000000001,61,12,73,57,9,66,제주특별자치도 서귀포시 안덕면 동광리 490,서귀포시,336,2,126.349345,33.310405
3023,석교동,33.31048,126.34918,138,34,172,126,31,157,제주특별자치도 서귀포시 안덕면 동광리 458,서귀포시,336,2,126.349345,33.310405
3026,비석거리,33.25489,126.57619,8532,477,9009,8399,454,8853,제주특별자치도 서귀포시 동홍동 657-4,서귀포시,35,1,126.55455285714287,33.24852714285714
3027,사계어촌체험어장,33.22793,126.30442,304,18,322,303,16,319,제주특별자치도 서귀포시 안덕면 사계리 2147-21,서귀포시,337,2,126.30459,33.227935
3028,사계어촌체험어장,33.227940000000004,126.30476000000002,133,33,166,130,32,162,제주특별자치도 서귀포시 안덕면 사계리 2147-21,서귀포시,337,2,126.30459,33.227935
3029,사계용해경로당,33.23081,126.30848999999999,86,16,102,86,16,102,제주특별자치도 서귀포시 안덕면 사계리 2029-5,서귀포시,338,2,126.30848499999999,33.23102
3030,사계용해경로당,33.23123,126.30848,260,13,273,259,13,272,제주특별자치도 서귀포시 안덕면 사계리 2029-3,서귀포시,338,2,126.30848499999999,33.23102
3031,서귀포칼호텔(종점),33.247009999999996,126.58078,193,416,609,193,416,609,제주특별자치도 서귀포시 토평동 486-3,서귀포시,132,2,126.58113499999999,33.246975
3032,강다리,33.40578,126.88895,98,7,105,96,6,102,제주특별자치도 서귀포시 성산읍 온평리 2131-3,서귀포시,505,4,126.88895,33.40578
3035,도린동산,33.35837,126.76827,17,1,18,17,1,18,제주특별자치도 서귀포시 표선면 가시리 2483-2,서귀포시,506,4,126.76827,33.35837
3037,제3의귀교,33.31235,126.71925,10,3,13,10,3,13,제주특별자치도 서귀포시 남원읍 의귀리 849-1,서귀포시,507,4,126.71925,33.31235
3038,화순해안경기안전센터사계출장소,33.226009999999995,126.30018000000001,103,15,118,103,12,115,제주특별자치도 서귀포시 안덕면 사계리 2294-41,서귀포시,339,2,126.29998499999999,33.22564
3040,신흥교,33.313959999999994,126.75096,24,1,25,24,1,25,제주특별자치도 서귀포시 남원읍 신흥리 1378-2,서귀포시,508,4,126.75096,33.313959999999994
3041,신흥1번지,33.30614,126.77395,87,15,102,86,14,100,제주특별자치도 서귀포시 남원읍 신흥리 2481-8,서귀포시,332,2,126.773815,33.305935
3042,모슬포항,33.21652,126.25223000000001,11,7,18,11,7,18,제주특별자치도 서귀포시 대정읍 하모리 2133-1,서귀포시,61,1,126.36891666666666,33.22575333333334
3045,불미터,33.31943,126.71481999999999,190,13,203,189,12,201,제주특별자치도 서귀포시 남원읍 의귀리 1714-8,서귀포시,509,4,126.71481999999999,33.31943
3046,새서귀초등학교,33.254329999999996,126.51297,841,28,869,709,27,736,제주특별자치도 서귀포시 서호동 1462-4,서귀포시,340,2,126.51295,33.254245
3048,대포동,33.24301,126.43182,3004,62,3066,2977,56,3033,제주특별자치도 서귀포시 대포동 1597-4,서귀포시,114,2,126.43175,33.24297
3050,공무원연금공단,33.25437,126.51794,1479,165,1644,1466,158,1624,제주특별자치도 서귀포시 서호동 1583,서귀포시,64,1,126.53915666666667,33.255085
3051,국세공무원교육원생활관,33.255559999999996,126.51943999999999,415,86,501,406,81,487,제주특별자치도 서귀포시 서호동 1607,서귀포시,341,2,126.519295,33.255595
3053,서귀포시중앙도서관,33.251870000000004,126.50769,1917,80,1997,1875,78,1953,제주특별자치도 서귀포시 강정동 187,서귀포시,67,2,126.50771,33.25177000000001
3054,대림아파트,33.25052,126.50556999999999,153,9,162,151,7,158,제주특별자치도 서귀포시 강정동 186-1,서귀포시,4,1,126.51396210526316,33.26277789473685
3055,하귀농협경제사업장,33.45816,126.42355,245,12,257,232,12,244,제주특별자치도 제주시 애월읍 광령리 3979-2,제주시,22,1,126.4479757142857,33.47316
3056,국세공무원교육원국토교통부인재개발원,33.254490000000004,126.51552,453,61,514,449,61,510,제주특별자치도 서귀포시 서호동 1513,서귀포시,342,2,126.515525,33.25439
3057,청화마을입구,33.45608,126.43023000000001,578,7,585,572,7,579,제주특별자치도 제주시 애월읍 광령리 3313-2,제주시,195,2,126.430175,33.45611
3058,안덕119센터,33.250609999999995,126.3289,486,33,519,481,32,513,제주특별자치도 서귀포시 안덕면 화순리 1773-2,서귀포시,23,3,126.52565142857144,33.25023785714286
3059,안덕119센터,33.250029999999995,126.32988999999999,187,29,216,187,27,214,제주특별자치도 서귀포시 안덕면 화순리 1770-3,서귀포시,23,3,126.52565142857144,33.25023785714286
3061,제주조각공원입구,33.25039,126.322,326,27,353,325,26,351,제주특별자치도 서귀포시 안덕면 사계리 3602-5,서귀포시,48,1,126.41514200000002,33.255396
3062,서귀포시외버스터미널(가상정류소),33.24985,126.50723,4225,995,5220,4176,980,5156,제주특별자치도 서귀포시 강정동 186-4,서귀포시,4,1,126.51396210526316,33.26277789473685
3063,이스트소프트,33.44722,126.57148000000001,1,1,2,1,1,2,제주특별자치도 제주시 영평동 2187-1,제주시,478,2,126.57154500000001,33.44739
3064,이스트소프트,33.447559999999996,126.57161,56,3,59,50,3,53,제주특별자치도 제주시 영평동 2273,제주시,478,2,126.57154500000001,33.44739
3065,서광동리웃네거리,33.294290000000004,126.32976000000001,105,21,126,102,21,123,제주특별자치도 서귀포시 안덕면 서광리 475,서귀포시,343,2,126.33012000000001,33.294455
3066,막동산,33.256240000000005,126.52346000000001,197,4,201,196,4,200,제주특별자치도 서귀포시 서호동 350-3,서귀포시,27,1,126.58037818181816,33.28037545454546
3067,막동산,33.25647,126.52343,726,24,750,713,23,736,제주특별자치도 서귀포시 호근동 1822-2,서귀포시,27,1,126.58037818181816,33.28037545454546
3068,국세공무원교육원국토교통부인재개발원,33.254290000000005,126.51553,282,54,336,282,52,334,제주특별자치도 서귀포시 서호동 1583,서귀포시,342,2,126.515525,33.25439
3069,공무원연금공단,33.25464,126.51773,737,157,894,729,153,882,제주특별자치도 서귀포시 서호동 1583,서귀포시,64,1,126.53915666666667,33.255085
3070,삼다체육공원입구,33.25158,126.51888999999998,5519,480,5999,5422,478,5900,제주특별자치도 서귀포시 서호동 1608,서귀포시,344,2,126.51875999999999,33.251585
3071,삼다체육공원입구,33.25159,126.51863,468,19,487,427,18,445,제주특별자치도 서귀포시 서호동 1605,서귀포시,344,2,126.51875999999999,33.251585
3072,회수마을회관,33.26323,126.44466000000001,3172,224,3396,3165,224,3389,제주특별자치도 서귀포시 회수동 376-7,서귀포시,5,1,126.39661875,33.266799999999996
3073,회수마을회관,33.26308,126.44471999999999,1432,27,1459,1428,27,1455,제주특별자치도 서귀포시 회수동 409-1,서귀포시,5,1,126.39661875,33.266799999999996
3074,법화사사거리,33.263059999999996,126.45946,334,113,447,331,113,444,제주특별자치도 서귀포시 하원동 684-11,서귀포시,10,3,126.50737875000002,33.25214
3075,법화사사거리,33.26299,126.46136000000001,289,12,301,286,12,298,제주특별자치도 서귀포시 하원동 650-2,서귀포시,10,3,126.50737875000002,33.25214
3076,새서귀초등학교,33.25416,126.51293000000001,2484,26,2510,2444,23,2467,제주특별자치도 서귀포시 서호동 1478-2,서귀포시,340,2,126.51295,33.254245
3077,제주월드컵경기장,33.24838,126.50723,2207,186,2393,2165,174,2339,제주특별자치도 서귀포시 강정동 232,서귀포시,4,1,126.51396210526316,33.26277789473685
3078,제주월드컵경기장서문,33.24647,126.50686,314,14,328,311,14,325,제주특별자치도 서귀포시 법환동 914,서귀포시,32,3,126.52956,33.25009
3079,제주월드컵경기장서문,33.24522,126.50605,297,20,317,287,19,306,제주특별자치도 서귀포시 법환동 1638,서귀포시,32,3,126.52956,33.25009
3080,유승한내들아파트,33.25265,126.50453,3820,200,4020,3728,199,3927,제주특별자치도 서귀포시 강정동 209,서귀포시,345,2,126.50448,33.252555
3081,유승한내들아파트,33.25246,126.50443,3036,750,3786,3021,750,3771,제주특별자치도 서귀포시 강정동 216,서귀포시,345,2,126.50448,33.252555
3082,중흥/골드클래스아파트,33.25255,126.50203,686,12,698,682,12,694,제주특별자치도 서귀포시 강정동 216,서귀포시,346,2,126.50212,33.252645
3083,중흥/골드클래스아파트,33.25274,126.50221,6277,32,6309,6068,31,6099,제주특별자치도 서귀포시 강정동 194,서귀포시,346,2,126.50212,33.252645
3084,대신중학교,33.256190000000004,126.505,668,19,687,652,18,670,제주특별자치도 서귀포시 강정동 213,서귀포시,347,2,126.505405,33.25607
3085,대신중학교,33.25595,126.50581000000001,4155,34,4189,4027,33,4060,제주특별자치도 서귀포시 강정동 186-1,서귀포시,347,2,126.505405,33.25607
3086,상창교차로,33.28047,126.35886,35,8,43,35,8,43,제주특별자치도 서귀포시 안덕면 상창리 1222-2,서귀포시,348,2,126.359015,33.280590000000004
3087,상창교차로,33.28071,126.35916999999999,8,4,12,8,4,12,제주특별자치도 서귀포시 안덕면 상창리 1222-2,서귀포시,348,2,126.359015,33.280590000000004
3088,해아미,33.4292,126.31846999999999,101,6,107,99,6,105,제주특별자치도 제주시 애월읍 곽지리 417-2,제주시,739,4,126.31846999999999,33.4292
3089,오당빌레,33.45337,126.35248999999999,49,11,60,48,11,59,제주특별자치도 제주시 애월읍 하가리 795-4,제주시,740,4,126.35248999999999,33.45337
3091,수산2리퐁낭거리,33.44103,126.86168,162,1,163,156,1,157,제주특별자치도 서귀포시 성산읍 수산리 2443-1,서귀포시,152,2,126.861805,33.44108
3093,교래분교,33.436409999999995,126.6794,242,44,286,229,41,270,제주특별자치도 제주시 조천읍 교래리 563,제주시,479,2,126.679335,33.43638
3099,동복리관광체험어장,33.553290000000004,126.7156,1269,622,1891,1216,601,1817,제주특별자치도 제주시 구좌읍 동복리 722-2,제주시,17,3,126.55606124999998,33.50669
3100,이도초등학교,33.48924,126.53275,2841,18,2859,2808,18,2826,제주특별자치도 제주시 이도이동 2034-8,제주시,480,2,126.532655,33.489320000000006
3103,교래분교,33.43635,126.67926999999999,44,14,58,43,14,57,제주특별자치도 제주시 조천읍 교래리 563-1,제주시,479,2,126.679335,33.43638
3104,어대오름,33.501059999999995,126.76082,4,1,5,4,1,5,제주특별자치도 제주시 구좌읍 덕천리 556,제주시,481,2,126.76091,33.501054999999994
3105,어대오름,33.50105,126.76100000000001,10,7,17,10,7,17,제주특별자치도 제주시 구좌읍 덕천리 555-1,제주시,481,2,126.76091,33.501054999999994
3106,행원목장,33.51767,126.76983,382,429,811,374,412,786,제주특별자치도 제주시 구좌읍 행원리 산 31,제주시,741,4,126.76983,33.51767
3108,동사라마을,33.467909999999996,126.44901999999999,26,4,30,25,4,29,제주특별자치도 제주시 해안동 2265-1,제주시,742,4,126.44901999999999,33.467909999999996
3109,생각하는정원,33.3263,126.25502,66,85,151,62,79,141,제주특별자치도 제주시 한경면 저지리 1529-4,제주시,482,2,126.25514000000001,33.32615
3110,생각하는정원,33.326,126.25526,435,201,636,419,195,614,제주특별자치도 제주시 한경면 저지리 1529-2,제주시,482,2,126.25514000000001,33.32615
3111,저지리중동,33.3353,126.25703999999999,44,11,55,44,11,55,제주특별자치도 제주시 한경면 저지리 1763-5,제주시,269,2,126.256795,33.335134999999994
3112,제6부두,33.5224,126.54445,1136,134,1270,1091,129,1220,제주특별자치도 제주시 건입동 908-26,제주시,0,1,126.528805,33.50356375
3113,우진교차로,33.460879999999996,126.69885,151,2,153,151,2,153,제주특별자치도 제주시 조천읍 선흘리 4070-12,제주시,483,2,126.69901999999999,33.46048
3114,우진교차로,33.46008,126.69918999999999,11,10,21,11,10,21,제주특별자치도 제주시 조천읍 선흘리 산 124-22,제주시,483,2,126.69901999999999,33.46048
3115,국제여객선터미널,33.52427,126.54453000000001,238,67,305,234,55,289,제주특별자치도 제주시 건입동 1453,제주시,0,1,126.528805,33.50356375
3116,제6부두,33.52312,126.54463,31,5,36,31,4,35,제주특별자치도 제주시 건입동 1453,제주시,0,1,126.528805,33.50356375
3117,제석머리,33.31507,126.17693999999999,54,18,72,53,16,69,제주특별자치도 제주시 한경면 용수리 2737-4,제주시,484,2,126.177055,33.31527
3118,제석머리,33.31547,126.17716999999999,119,14,133,108,14,122,제주특별자치도 제주시 한경면 용수리 4719-1,제주시,484,2,126.177055,33.31527
3119,각시물,33.32475,126.25931000000001,4,4,8,4,4,8,제주특별자치도 제주시 한경면 저지리 2891-4,제주시,485,2,126.25972000000002,33.32474
3120,각시물,33.324729999999995,126.26013,26,36,62,25,34,59,제주특별자치도 제주시 한경면 저지리 3258,제주시,485,2,126.25972000000002,33.32474
3121,하도리개긋물,33.50208,126.88235,37,12,49,37,12,49,제주특별자치도 제주시 구좌읍 하도리 산 56,제주시,486,2,126.88249,33.50179
3122,하도리개긋물,33.5015,126.88263,11,4,15,11,4,15,제주특별자치도 제주시 구좌읍 하도리 1038-1,제주시,486,2,126.88249,33.50179
3123,하도리서문동,33.52002,126.87133,540,22,562,528,22,550,제주특별자치도 제주시 구좌읍 하도리 3281-1,제주시,249,2,126.87132,33.519925
3124,금산목,33.55322,126.80452,758,162,920,749,157,906,제주특별자치도 제주시 구좌읍 행원리 1292-5,제주시,441,2,126.80488,33.55344
3127,해녀박물관,33.521809999999995,126.86305,209,80,289,209,77,286,제주특별자치도 제주시 구좌읍 상도리 471-32,제주시,49,1,126.67595750000001,33.484984999999995
3128,해녀박물관,33.52172,126.86291000000001,1963,473,2436,1900,457,2357,제주특별자치도 제주시 구좌읍 세화리 33-7,제주시,49,1,126.67595750000001,33.484984999999995
3129,해양맨션,33.53739,126.63999,12,1,13,12,1,13,제주특별자치도 제주시 조천읍 조천리 1328-5,제주시,130,2,126.639945,33.537825
3130,금능블루하와이,33.38172,126.21925,143,105,248,130,100,230,제주특별자치도 제주시 한림읍 금능리 2000-2,제주시,487,2,126.21939499999999,33.381695
3131,금능블루하와이,33.38167,126.21954,901,556,1457,809,534,1343,제주특별자치도 제주시 한림읍 금능리 1994-1,제주시,487,2,126.21939499999999,33.381695
3133,처남빌레,33.44781,126.33937,311,24,335,303,23,326,제주특별자치도 제주시 애월읍 상가리 1941-10,제주시,743,4,126.33937,33.44781
3136,삼화지구3단지,33.515229999999995,126.58598,5160,14,5174,5132,14,5146,제주특별자치도 제주시 도련일동 1911,제주시,488,2,126.586135,33.515175
3137,삼화지구3단지,33.51512,126.58628999999999,6380,13,6393,6354,13,6367,제주특별자치도 제주시 도련이동 550,제주시,488,2,126.586135,33.515175
3138,농림축산검역본부,33.51007,126.50469,808,37,845,804,35,839,제주특별자치도 제주시 용담이동 885,제주시,489,2,126.504685,33.509985
3139,동백동산습지센터,33.50932,126.71439,136,48,184,131,46,177,제주특별자치도 제주시 조천읍 선흘리 926,제주시,490,2,126.7145,33.50918
3140,동백동산습지센터,33.50904,126.71461000000001,51,39,90,50,38,88,제주특별자치도 제주시 조천읍 선흘리 922,제주시,490,2,126.7145,33.50918
3141,이도초등학교,33.4894,126.53256,2751,30,2781,2706,30,2736,제주특별자치도 제주시 이도이동 747,제주시,480,2,126.532655,33.489320000000006
3147,체오름,33.47404,126.76149,20,3,23,20,3,23,제주특별자치도 제주시 구좌읍 송당리 산 49-1,제주시,744,4,126.76149,33.47404
3151,까끄래기오름,33.43365,126.70553999999998,27,8,35,27,7,34,제주특별자치도 제주시 조천읍 교래리 산 10-5,제주시,745,4,126.70553999999998,33.43365
3152,한라도서관,33.47586,126.51525,16,2,18,16,2,18,제주특별자치도 제주시 오라이동 899-3,제주시,379,2,126.514985,33.476005
3153,연미월왓,33.48154,126.50804,679,12,691,666,11,677,제주특별자치도 제주시 오라이동 1698-4,제주시,48,3,126.40944571428574,33.456941428571426
3154,연미월왓,33.48109,126.50908000000001,711,6,717,707,6,713,제주특별자치도 제주시 오라이동 1770-2,제주시,48,3,126.40944571428574,33.456941428571426
3155,금백조로입구,33.44768,126.76536999999999,5,3,8,5,3,8,제주특별자치도 제주시 구좌읍 송당리 2236-8,제주시,746,4,126.76536999999999,33.44768
3158,"방선문3차,4차빌리지",33.48773,126.52623999999999,353,1,354,353,1,354,제주특별자치도 제주시 도남동 767-1,제주시,491,2,126.526455,33.487695
3159,"방선문3차,4차빌리지",33.48766,126.52667,1393,14,1407,1380,13,1393,제주특별자치도 제주시 도남동 659-7,제주시,491,2,126.526455,33.487695
3160,지방합동청사,33.49001,126.52308000000001,209,3,212,209,3,212,제주특별자치도 제주시 도남동 1058,제주시,747,4,126.52308000000001,33.49001
3162,고수동입구,33.322109999999995,126.75706000000001,75,1,76,72,1,73,제주특별자치도 서귀포시 남원읍 신흥리 2481,서귀포시,510,4,126.75706000000001,33.322109999999995
3164,돔뱅이왓,33.23516,126.36945,1,2,3,1,2,3,제주특별자치도 서귀포시 하예동 1810-1,서귀포시,312,2,126.369475,33.235079999999996
3165,광평교차로,33.33059,126.35501000000001,201,51,252,195,44,239,제주특별자치도 서귀포시 안덕면 동광리 산 28-1,서귀포시,511,4,126.35501000000001,33.33059
3166,보목포구(출발),33.23949,126.60626,1126,83,1209,1097,78,1175,제주특별자치도 서귀포시 보목동 1635,서귀포시,133,2,126.606565,33.239425
3167,향기마을,33.34386,126.79018,63,2,65,63,2,65,제주특별자치도 서귀포시 표선면 세화리 2176-3,서귀포시,512,4,126.79018,33.34386
3169,별내린전망대,33.24719,126.41673,44,56,100,41,53,94,제주특별자치도 서귀포시 색달동 2947-1,서귀포시,349,2,126.41679500000001,33.24721
3170,별내린전망대,33.24723,126.41686000000001,77,61,138,73,54,127,제주특별자치도 서귀포시 색달동 2947-1,서귀포시,349,2,126.41679500000001,33.24721
3171,서광동리웃네거리,33.29462,126.33048000000001,96,24,120,93,21,114,제주특별자치도 서귀포시 안덕면 동광리 1242-1,서귀포시,343,2,126.33012000000001,33.294455
3172,서복전시관,33.24519,126.57018000000001,667,992,1659,658,981,1639,제주특별자치도 서귀포시 서귀동 101-12,서귀포시,65,1,126.588856,33.252526
3173,서복전시관,33.245090000000005,126.5703,65,28,93,62,26,88,제주특별자치도 서귀포시 서귀동 101-14,서귀포시,65,1,126.588856,33.252526
3174,대정농협,33.22214,126.25226,13509,326,13835,13307,316,13623,제주특별자치도 서귀포시 대정읍 하모리 928-1,서귀포시,40,1,126.4694525,33.254366250000004
3175,국립기상과학원,33.25804,126.51732,124,7,131,123,7,130,제주특별자치도 서귀포시 서호동 1580,서귀포시,513,4,126.51732,33.25804
3176,위미감협,33.28107,126.66925,75,2,77,75,2,77,제주특별자치도 서귀포시 남원읍 위미리 1448-1,서귀포시,514,4,126.66925,33.28107
3178,국세공무원교육원생활관,33.25563,126.51915,195,82,277,194,77,271,제주특별자치도 서귀포시 서호동 1515,서귀포시,341,2,126.519295,33.255595
3179,활오름,33.26119,126.4832,181,5,186,181,5,186,제주특별자치도 서귀포시 강정동 3801-45,서귀포시,350,2,126.4832,33.261269999999996
3180,독벌은이동산,33.36885,126.68388999999999,356,37,393,350,35,385,제주특별자치도 서귀포시 남원읍 수망리 산 191-24,서귀포시,515,4,126.68388999999999,33.36885
3182,삼달2리사무소,33.36916,126.86783999999999,153,27,180,150,27,177,제주특별자치도 서귀포시 성산읍 삼달리 23-1,서귀포시,54,1,126.7603,33.31871399999999
3183,한라산둘레길,33.328109999999995,126.60586,332,22,354,317,21,338,제주특별자치도 서귀포시 남원읍 하례리 산 30-1,서귀포시,516,4,126.60586,33.328109999999995
3184,서귀포항입구,33.24009,126.5643,541,81,622,538,77,615,제주특별자치도 서귀포시 서귀동 786-6,서귀포시,30,1,126.48163400000001,33.238526
3185,중문관광단지,33.25238,126.41297,2582,1147,3729,2420,1043,3463,제주특별자치도 서귀포시 색달동 2484-1,서귀포시,21,1,126.55541500000001,33.29999375
3187,표선생활체육관,33.35311,126.81472,8,2,10,8,2,10,제주특별자치도 서귀포시 표선면 하천리 1832-1,서귀포시,39,3,126.71906142857142,33.322051428571434
3188,표선생활체육관,33.35329,126.81678000000001,192,4,196,190,2,192,제주특별자치도 서귀포시 표선면 하천리 1809-1,서귀포시,39,3,126.71906142857142,33.322051428571434
3189,모슬포남항여객선터미널(운진항),33.21119,126.25748,12783,2295,15078,12391,2120,14511,제주특별자치도 서귀포시 대정읍 하모리 634-31,서귀포시,351,2,126.257405,33.21108
3190,모슬포남항여객선터미널(운진항),33.21097,126.25733000000001,1885,294,2179,1813,280,2093,제주특별자치도 서귀포시 대정읍 하모리 646-20,서귀포시,351,2,126.257405,33.21108
3191,회수동,33.26393,126.44418999999999,191,39,230,184,38,222,제주특별자치도 서귀포시 회수동 384-5,서귀포시,5,1,126.39661875,33.266799999999996
3194,무릉손당호,33.272059999999996,126.21125,11,1,12,7,1,8,제주특별자치도 서귀포시 대정읍 무릉리 2329-1,서귀포시,517,4,126.21125,33.272059999999996
3196,선반로입구,33.24091,126.50509,108,5,113,107,5,112,제주특별자치도 서귀포시 강정동 424,서귀포시,352,2,126.505285,33.241145
3197,위미2리교차로,33.27775,126.66166000000001,65,2,67,65,2,67,제주특별자치도 서귀포시 남원읍 위미리 2794,서귀포시,353,2,126.66133500000001,33.277559999999994
3198,위미리(위미2리교차로),33.27737,126.66101,77,29,106,76,22,98,제주특별자치도 서귀포시 남원읍 위미리 2759-1,서귀포시,353,2,126.66133500000001,33.277559999999994
3198,위미리(위미2리교차로),33.27737,126.66101,77,29,106,76,22,98,제주특별자치도 서귀포시 남원읍 위미리 2759-1,서귀포시,518,4,126.66306999999999,33.277570000000004
3198,위미리(위미2리교차로),33.277570000000004,126.66306999999999,77,29,106,76,22,98,제주특별자치도 서귀포시 남원읍 위미리 2041,서귀포시,353,2,126.66133500000001,33.277559999999994
3198,위미리(위미2리교차로),33.277570000000004,126.66306999999999,77,29,106,76,22,98,제주특별자치도 서귀포시 남원읍 위미리 2041,서귀포시,518,4,126.66306999999999,33.277570000000004
3199,무릉리(사장동),33.26579,126.1995,222,72,294,199,68,267,제주특별자치도 서귀포시 대정읍 무릉리 3036-1,서귀포시,354,2,126.1995,33.265695
3200,무릉리(사장동),33.2656,126.1995,109,10,119,107,10,117,제주특별자치도 서귀포시 대정읍 무릉리 3036-1,서귀포시,354,2,126.1995,33.265695
3201,제주신화월드서머셋,33.29997,126.31878,26,2,28,25,2,27,제주특별자치도 서귀포시 안덕면 서광리 산 24-4,서귀포시,355,2,126.31866,33.299935000000005
3202,신화역사공원,33.305640000000004,126.31967,7359,372,7731,7221,345,7566,제주특별자치도 서귀포시 안덕면 서광리 산 24-4,서귀포시,356,2,126.31928500000001,33.305385
3203,제주오설록티뮤지엄,33.304520000000004,126.28862,1869,1891,3760,1779,1804,3583,제주특별자치도 서귀포시 안덕면 서광리 산 50-24,서귀포시,60,1,126.3705242857143,33.28986428571428
3204,오설록,33.30454,126.2888,417,267,684,403,257,660,제주특별자치도 서귀포시 안덕면 서광리 산 51-5,서귀포시,60,1,126.3705242857143,33.28986428571428
3205,제주항공우주박물관,33.30337,126.30123999999999,314,138,452,297,128,425,제주특별자치도 서귀포시 안덕면 서광리 산 39-1,서귀포시,357,2,126.30114499999999,33.30342
3206,제주항공우주박물관,33.303470000000004,126.30105,91,77,168,80,73,153,제주특별자치도 서귀포시 안덕면 서광리 산 39-1,서귀포시,357,2,126.30114499999999,33.30342
3208,헬스케어타운리조트,33.285959999999996,126.55771999999999,736,58,794,675,52,727,제주특별자치도 서귀포시 동홍동 2048,서귀포시,519,4,126.55771999999999,33.285959999999996
3209,함덕에덴빌리지,33.53031,126.66508,140,11,151,139,10,149,제주특별자치도 제주시 조천읍 함덕리 1748-4,제주시,748,4,126.66508,33.53031
3212,열방대학,33.53696,126.70166,492,10,502,464,10,474,제주특별자치도 제주시 조천읍 북촌리 82-2,제주시,749,4,126.70166,33.53696
3214,차귀포구,33.30898,126.16503999999999,128,63,191,121,60,181,제주특별자치도 제주시 한경면 고산리 3611-1,제주시,750,4,126.16503999999999,33.30898
3216,주전동,33.33602,126.17676999999999,72,2,74,72,2,74,제주특별자치도 제주시 한경면 용수리 1360-4,제주시,751,4,126.17676999999999,33.33602
3218,성산청소년수련원,33.36144,126.84023,64,4,68,64,3,67,제주특별자치도 서귀포시 성산읍 신풍리 455-2,서귀포시,520,4,126.84023,33.36144
3220,동광육거리,33.310140000000004,126.34119,306,267,573,290,250,540,제주특별자치도 서귀포시 안덕면 동광리 810-5,서귀포시,52,1,126.38022545454545,33.30013272727273
3221,선반로입구,33.24138,126.50548,921,24,945,912,24,936,제주특별자치도 서귀포시 강정동 350-3,서귀포시,352,2,126.505285,33.241145
3222,제주항공우주호텔,33.30212,126.29523999999999,11,67,78,11,62,73,제주특별자치도 서귀포시 안덕면 서광리 산 41,서귀포시,358,2,126.29526,33.302040000000005
3223,제주항공우주호텔,33.30196,126.29528,177,121,298,175,117,292,제주특별자치도 서귀포시 안덕면 서광리 산 41,서귀포시,358,2,126.29526,33.302040000000005
3225,노리매,33.28102,126.28735,326,126,452,322,124,446,제주특별자치도 서귀포시 대정읍 구억리 1055,서귀포시,521,4,126.28735,33.28102
3226,소인국테마파크,33.28965,126.32061999999999,146,71,217,144,66,210,제주특별자치도 서귀포시 안덕면 서광리 719-3,서귀포시,359,2,126.32059000000001,33.28957
3227,소인국테마파크,33.28949,126.32056000000001,48,17,65,46,17,63,제주특별자치도 서귀포시 안덕면 서광리 718-3,서귀포시,359,2,126.32059000000001,33.28957
3228,세계자동차제주박물관,33.28266,126.34867,32,26,58,29,23,52,제주특별자치도 서귀포시 안덕면 상창리 2065-1,서귀포시,360,2,126.348905,33.28242
3229,세계자동차제주박물관,33.28218,126.34913999999999,70,54,124,57,49,106,제주특별자치도 서귀포시 안덕면 상창리 2068-7,서귀포시,360,2,126.348905,33.28242
3230,동광환승정류장1,33.31021,126.33932,698,209,907,676,197,873,제주특별자치도 서귀포시 안덕면 동광리 942-4,서귀포시,52,1,126.38022545454545,33.30013272727273
3231,동광단지,33.31387,126.35966,144,19,163,142,18,160,제주특별자치도 서귀포시 안덕면 동광리 74-37,서귀포시,139,2,126.35952499999999,33.313874999999996
3232,토평사거리,33.268809999999995,126.58521,119,18,137,114,17,131,제주특별자치도 서귀포시 토평동 2226-1,서귀포시,361,2,126.58539999999999,33.26882
3233,토평사거리,33.26883,126.58559,899,377,1276,848,351,1199,제주특별자치도 서귀포시 토평동 2223-1,서귀포시,361,2,126.58539999999999,33.26882
3236,제주항공우주박물관,33.30186,126.30186,193,83,276,190,80,270,제주특별자치도 서귀포시 안덕면 서광리 산 39,서귀포시,362,2,126.301925,33.301734999999994
3237,제주항공우주박물관,33.30161,126.30198999999999,102,71,173,94,65,159,제주특별자치도 서귀포시 안덕면 서광리 산 35-7,서귀포시,362,2,126.301925,33.301734999999994
3238,"제주현대미술관,김창열미술관",33.33764,126.26653,240,118,358,236,115,351,제주특별자치도 제주시 한경면 저지리 2120-35,제주시,492,2,126.26650000000001,33.33775
3239,"제주현대미술관,김창열미술관",33.33786,126.26647,183,51,234,181,50,231,제주특별자치도 제주시 한경면 저지리 2120-103,제주시,492,2,126.26650000000001,33.33775
3240,선녀와나무꾼,33.479659999999996,126.70192,145,83,228,142,80,222,제주특별자치도 제주시 조천읍 선흘리 2014,제주시,493,2,126.701995,33.479905
3241,한울랜드,33.49906,126.75305,8,10,18,6,10,16,제주특별자치도 제주시 구좌읍 덕천리 769,제주시,494,2,126.75293,33.49923
3242,덕천리,33.50255,126.77083,122,84,206,119,80,199,제주특별자치도 제주시 구좌읍 덕천리 1796,제주시,44,1,126.58267,33.47515857142857
3243,종달항,33.497170000000004,126.91098000000001,136,96,232,123,95,218,제주특별자치도 제주시 구좌읍 종달리 478-14,제주시,495,2,126.91121,33.497325000000004
3244,환상숲곶자왈공원,33.32202,126.26343999999999,77,20,97,74,13,87,제주특별자치도 제주시 한경면 저지리 3258,제주시,496,2,126.26343,33.321875000000006
3245,환상숲곶자왈공원,33.32173,126.26342,138,149,287,131,146,277,제주특별자치도 제주시 한경면 저지리 2857-3,제주시,496,2,126.26343,33.321875000000006
3246,대천환승정류장,33.43628,126.73682,379,236,615,365,229,594,제주특별자치도 제주시 구좌읍 송당리 산 126-6,제주시,46,1,126.62861222222222,33.44766888888889
3247,제주세계자연유산센터입구,33.45543,126.7104,35,37,72,29,34,63,제주특별자치도 제주시 조천읍 선흘리 464-1,제주시,497,2,126.71036000000001,33.45543
3248,선녀와나무꾼,33.48015,126.70206999999999,105,91,196,102,88,190,제주특별자치도 제주시 조천읍 선흘리 1997,제주시,493,2,126.701995,33.479905
3249,한울랜드,33.4994,126.75281000000001,39,7,46,39,7,46,제주특별자치도 제주시 구좌읍 덕천리 산 62-24,제주시,494,2,126.75293,33.49923
3250,둔지오름,33.50611,126.79775,1,1,2,1,1,2,제주특별자치도 제주시 구좌읍 한동리 산 40,제주시,498,2,126.797855,33.50613
3251,둔지오름,33.50615,126.79796,44,47,91,44,47,91,제주특별자치도 제주시 구좌읍 한동리 4323,제주시,498,2,126.797855,33.50613
3252,메이즈랜드,33.49008,126.79953,10,12,22,10,12,22,제주특별자치도 제주시 구좌읍 송당리 353-4,제주시,56,1,126.64144142857143,33.49493857142857
3253,다랑쉬오름입구(북),33.48608,126.82988,28,25,53,28,24,52,제주특별자치도 제주시 구좌읍 세화리 2754,제주시,499,2,126.829755,33.486015
3254,다랑쉬오름입구(북),33.48595,126.82963000000001,36,37,73,36,34,70,제주특별자치도 제주시 구좌읍 세화리 2754-1,제주시,499,2,126.829755,33.486015
3255,제주레일바이크,33.464620000000004,126.83641999999999,136,149,285,131,135,266,제주특별자치도 제주시 구좌읍 상도리 산 373-2,제주시,500,2,126.836535,33.46463
3256,제주레일바이크,33.46464,126.83665,100,169,269,90,162,252,제주특별자치도 제주시 구좌읍 종달리 4639,제주시,500,2,126.836535,33.46463
3257,용눈이오름,33.46351,126.83188,2,5,7,1,5,6,제주특별자치도 제주시 구좌읍 상도리 1397-3,제주시,501,2,126.83203,33.463395
3258,용눈이오름,33.46328,126.83218000000001,160,245,405,153,235,388,제주특별자치도 제주시 구좌읍 종달리 4648,제주시,501,2,126.83203,33.463395
3259,송당리마을,33.469840000000005,126.78591000000002,94,91,185,89,89,178,제주특별자치도 제주시 구좌읍 송당리 1463-1,제주시,53,1,126.58769124999998,33.44820375
3260,송당리마을,33.46965,126.78596999999999,78,76,154,75,72,147,제주특별자치도 제주시 구좌읍 송당리 2774,제주시,53,1,126.58769124999998,33.44820375
3261,청수마을회관,33.318329999999996,126.24762,38,5,43,38,5,43,제주특별자치도 제주시 한경면 청수리 1572-1,제주시,502,2,126.247625,33.318225
3262,청수마을회관,33.31812,126.24763,85,3,88,85,3,88,제주특별자치도 제주시 한경면 청수리 1572-3,제주시,502,2,126.247625,33.318225
3263,제주평화박물관,33.3048,126.25667,196,44,240,194,43,237,제주특별자치도 제주시 한경면 청수리 161-1,제주시,503,2,126.25665000000001,33.304739999999995
3264,제주평화박물관,33.30468,126.25663,98,36,134,98,36,134,제주특별자치도 제주시 한경면 청수리 145-5,제주시,503,2,126.25665000000001,33.304739999999995
3265,아부오름,33.446290000000005,126.78112,96,78,174,91,76,167,제주특별자치도 제주시 구좌읍 송당리 산 315,제주시,504,2,126.78124,33.44641
3266,아부오름,33.446529999999996,126.78136,16,16,32,16,16,32,제주특별자치도 제주시 구좌읍 송당리 산 174-1,제주시,504,2,126.78124,33.44641
3269,종달항,33.497479999999996,126.91143999999998,27,16,43,27,16,43,제주특별자치도 제주시 구좌읍 종달리 477-16,제주시,495,2,126.91121,33.497325000000004
3270,제주시청(아라방면),33.499559999999995,126.52977,192611,5901,198512,189613,5680,195293,제주특별자치도 제주시 이도이동 1938-1,제주시,505,2,126.53005999999999,33.49924
3271,제주시청(광양방면),33.49892,126.53035,239964,7480,247444,236477,7218,243695,제주특별자치도 제주시 이도이동 1938-1,제주시,505,2,126.53005999999999,33.49924
3272,고산동산(아라방면),33.496,126.53228,43922,448,44370,43469,429,43898,제주특별자치도 제주시 이도이동 1085-4,제주시,59,1,126.55799571428572,33.507851428571435
3273,고산동산(광양방면),33.495540000000005,126.53291000000002,78799,1276,80075,78113,1237,79350,제주특별자치도 제주시 이도이동 1085-4,제주시,59,1,126.55799571428572,33.507851428571435
3274,제주지방법원(아라방면),33.493109999999994,126.53509,44013,971,44984,43412,896,44308,제주특별자치도 제주시 이도이동 1085-4,제주시,506,2,126.534925,33.49337
3275,제주지방법원(광양방면),33.493629999999996,126.53476,79035,2931,81966,78036,2797,80833,제주특별자치도 제주시 이도이동 1085-4,제주시,506,2,126.534925,33.49337
3276,제주중앙여자고등학교(아라방면),33.48941,126.53863999999999,40715,524,41239,40159,511,40670,제주특별자치도 제주시 이도이동 2060,제주시,507,2,126.53891999999999,33.489215
3277,제주중앙여자고등학교(광양방면),33.489020000000004,126.5392,89342,1379,90721,88113,1344,89457,제주특별자치도 제주시 이도이동 2060,제주시,507,2,126.53891999999999,33.489215
3278,제주여자중고등학교(아라방면),33.48486,126.54293,40075,673,40748,39303,656,39959,제주특별자치도 제주시 아라일동 2420-5,제주시,508,2,126.54290999999999,33.485029999999995
3279,제주여자중고등학교(광양방면),33.4852,126.54288999999999,74734,1163,75897,73365,1140,74505,제주특별자치도 제주시 아라일동 2420-5,제주시,508,2,126.54290999999999,33.485029999999995
3280,남국원(아라방면),33.47971,126.54381000000001,22605,320,22925,22415,310,22725,제주특별자치도 제주시 아라이동 1582-2,제주시,509,2,126.543845,33.47964
3281,남국원(광양방면),33.47957,126.54388,38262,859,39121,37724,821,38545,제주특별자치도 제주시 아라이동 1582-6,제주시,509,2,126.543845,33.47964
3282,대정환승정류장(대정읍사무소),33.225770000000004,126.25295,12797,1483,14280,12523,1364,13887,제주특별자치도 서귀포시 대정읍 하모리 1414-2,서귀포시,44,1,126.32166500000001,33.234591249999994
3283,대정환승정류장(대정읍사무소),33.22605,126.25173000000001,1379,61,1440,1370,59,1429,제주특별자치도 서귀포시 대정읍 하모리 1443-1,서귀포시,44,1,126.32166500000001,33.234591249999994
3284,대정읍사무소,33.225609999999996,126.25241000000001,18,12,30,18,12,30,제주특별자치도 서귀포시 대정읍 하모리 1423-13,서귀포시,44,1,126.32166500000001,33.234591249999994
3285,성읍환승정류장(성읍1리사무소),33.38943,126.79827,562,49,611,550,47,597,제주특별자치도 서귀포시 표선면 성읍리 666-6,서귀포시,363,2,126.798375,33.38945
3286,성읍환승정류장(성읍1리사무소),33.38947,126.79848,1759,509,2268,1657,459,2116,제주특별자치도 서귀포시 표선면 성읍리 667-1,서귀포시,363,2,126.798375,33.38945
3287,하례환승정류장(하례리입구),33.3,126.6007,5291,635,5926,5092,557,5649,제주특별자치도 서귀포시 상효동 1122-5,서귀포시,85,2,126.60059000000001,33.299989999999994
3288,남원환승정류장(남원읍사무소),33.28062,126.72081999999999,6518,160,6678,6411,153,6564,제주특별자치도 서귀포시 남원읍 남원리 207-10,서귀포시,53,1,126.6864557142857,33.269752857142855
3289,남원환승정류장(남원읍사무소),33.28053,126.72113999999999,10043,1596,11639,9776,1434,11210,제주특별자치도 서귀포시 남원읍 남원리 196-3,서귀포시,53,1,126.6864557142857,33.269752857142855
3290,"제주국제공항(대정,화순,일주서로)",33.506440000000005,126.49298,16578,20799,37377,15910,19562,35472,제주특별자치도 제주시 용담이동 1462-1,제주시,28,1,126.48837428571427,33.499021428571425
3291,애월환승정류장(애월리),33.46483,126.3187,2462,1402,3864,2415,1366,3781,제주특별자치도 제주시 애월읍 애월리 1534-2,제주시,45,3,126.55458375,33.445024999999994
3300,신사동(기점),33.52596,126.67788999999999,6979,190,7169,6889,186,7075,제주특별자치도 제주시 조천읍 함덕리 65-20,제주시,420,2,126.6779,33.525665000000004
3303,제주이야기,33.4291,126.40969,22,1,23,22,1,23,제주특별자치도 제주시 애월읍 유수암리 3234,제주시,510,2,126.409605,33.42903
3307,스위스마을입구,33.49169000000001,126.67463000000001,216,39,255,208,38,246,제주특별자치도 제주시 조천읍 와산리 1488-12,제주시,511,2,126.67450500000001,33.49161500000001
3308,스위스마을입구,33.49154,126.67438,23,11,34,22,8,30,제주특별자치도 제주시 조천읍 와산리 1505-6,제주시,511,2,126.67450500000001,33.49161500000001
3309,한라용사촌,33.53455,126.79616000000001,30,2,32,30,2,32,제주특별자치도 제주시 구좌읍 행원리 2333-18,제주시,512,2,126.79628500000001,33.53452
3310,한라용사촌,33.534490000000005,126.79641000000001,42,9,51,42,9,51,제주특별자치도 제주시 구좌읍 행원리 1927-11,제주시,512,2,126.79628500000001,33.53452
3317,수장동입구,33.3419,126.21141999999999,27,4,31,27,4,31,제주특별자치도 제주시 한경면 두모리 215-1,제주시,513,2,126.21141999999999,33.341785
3318,수장동입구,33.34167,126.21141999999999,6,1,7,6,1,7,제주특별자치도 제주시 한경면 두모리 215-4,제주시,513,2,126.21141999999999,33.341785
3319,영평알동네,33.48215,126.56043000000001,1098,11,1109,1069,11,1080,제주특별자치도 제주시 영평동 2483-7,제주시,514,2,126.56035500000002,33.48205
3320,영평알동네,33.48195,126.56028,250,9,259,240,8,248,제주특별자치도 제주시 영평동 2482-1,제주시,514,2,126.56035500000002,33.48205
3322,신성여자중고등학교,33.479859999999995,126.56331000000002,1503,2,1505,1462,2,1464,제주특별자치도 제주시 영평동 2466-6,제주시,181,2,126.56328,33.479585
3323,영산홍아파트,33.4952,126.53993,1626,6,1632,1623,6,1629,제주특별자치도 제주시 이도이동 539-5,제주시,17,1,126.55606124999998,33.50669
3324,영산홍아파트,33.495540000000005,126.53995,25,1,26,24,1,25,제주특별자치도 제주시 이도이동 405,제주시,17,1,126.55606124999998,33.50669
3325,탐라중학교,33.49085,126.54393999999999,786,6,792,775,6,781,제주특별자치도 제주시 아라이동 3011-7,제주시,515,2,126.54388999999999,33.491105000000005
3326,탐라중학교,33.49136,126.54383999999999,1450,39,1489,1439,36,1475,제주특별자치도 제주시 아라이동 3015,제주시,515,2,126.54388999999999,33.491105000000005
3329,광령2리,33.45033,126.42888,30,7,37,30,7,37,제주특별자치도 제주시 애월읍 광령리 3101-2,제주시,52,1,126.47459428571428,33.483898571428576
3330,광령2리,33.45041,126.42903000000001,1451,23,1474,1427,23,1450,제주특별자치도 제주시 애월읍 광령리 4227,제주시,52,1,126.47459428571428,33.483898571428576
3333,민속자연사박물관,33.50732,126.53087,2234,35,2269,2221,34,2255,제주특별자치도 제주시 일도이동 1050-1,제주시,516,2,126.530835,33.50712
3334,민속자연사박물관,33.50692,126.5308,382,16,398,376,16,392,제주특별자치도 제주시 일도이동 968-2,제주시,516,2,126.530835,33.50712
3336,부영3차아파트,33.476209999999995,126.48742,378,12,390,370,12,382,제주특별자치도 제주시 연동 1361-2,제주시,752,4,126.48742,33.476209999999995
3337,남조순오름입구,33.47741,126.49112,299,9,308,296,9,305,제주특별자치도 제주시 연동 1525-1,제주시,517,2,126.49124,33.47735
3338,남조순오름입구,33.47729,126.49136000000001,162,14,176,159,14,173,제주특별자치도 제주시 연동 1546,제주시,517,2,126.49124,33.47735
3343,오등상동,33.46284,126.53358999999999,96,2,98,96,2,98,제주특별자치도 제주시 오등동 459-4,제주시,518,2,126.53362999999999,33.462705
3344,오등상동,33.46257,126.53367,55,1,56,54,1,55,제주특별자치도 제주시 오등동 459-8,제주시,518,2,126.53362999999999,33.462705
3347,탐라광장,33.51384,126.52815,2067,140,2207,2033,131,2164,제주특별자치도 제주시 일도일동 1202-1,제주시,12,1,126.55788625000001,33.49230625
3348,탐라광장,33.51382,126.52838999999999,1726,262,1988,1702,247,1949,제주특별자치도 제주시 일도일동 1196,제주시,12,1,126.55788625000001,33.49230625
3349,고산1리,33.300940000000004,126.18026,435,32,467,433,31,464,제주특별자치도 제주시 한경면 고산리 2865-5,제주시,34,1,126.291986,33.375851
3350,"제주국제공항(평화로, 800번)",33.50659,126.49288,17732,14316,32048,17409,13981,31390,제주특별자치도 제주시 용담이동 2002,제주시,28,1,126.48837428571427,33.499021428571425
3350,"제주국제공항(평화로, 800번)",33.50659,126.49288,17732,14316,32048,17409,13981,31390,제주특별자치도 제주시 용담이동 2002,제주시,28,1,126.48837428571427,33.499021428571425
3350,"제주국제공항(평화로,800번)",33.50636,126.49271999999999,17732,14316,32048,17409,13981,31390,제주특별자치도 제주시 용담이동 2002,제주시,28,1,126.48837428571427,33.499021428571425
3350,"제주국제공항(평화로,800번)",33.50636,126.49271999999999,17732,14316,32048,17409,13981,31390,제주특별자치도 제주시 용담이동 2002,제주시,28,1,126.48837428571427,33.499021428571425
3351,"제주국제공항(일주동로,516도로)",33.50669,126.49335,16453,23556,40009,15759,22049,37808,제주특별자치도 제주시 용담이동 1462-1,제주시,28,1,126.48837428571427,33.499021428571425
3352,농림축산검역본부,33.5099,126.50468000000001,478,22,500,474,21,495,제주특별자치도 제주시 용담이동 865-1,제주시,489,2,126.504685,33.509985
3354,제주동여자중학교,33.50294,126.54024,3124,19,3143,3111,19,3130,제주특별자치도 제주시 이도이동 325-16,제주시,519,2,126.54026499999999,33.502785
3355,제주동여자중학교,33.502629999999996,126.54028999999998,1096,26,1122,1086,26,1112,제주특별자치도 제주시 이도이동 339,제주시,519,2,126.54026499999999,33.502785
3357,신천지아파트,33.506209999999996,126.54506,2733,21,2754,2721,21,2742,제주특별자치도 제주시 일도이동 46-1,제주시,753,4,126.54506,33.506209999999996
3359,삼화아파트,33.509370000000004,126.54383,620,44,664,613,44,657,제주특별자치도 제주시 일도이동 144-3,제주시,754,4,126.54383,33.509370000000004
3360,영락교회,33.511179999999996,126.54338,280,2,282,277,2,279,제주특별자치도 제주시 일도이동 153-5,제주시,520,2,126.54351,33.51115
3361,영락교회,33.51112,126.54364,521,49,570,519,49,568,제주특별자치도 제주시 일도이동 488-10,제주시,520,2,126.54351,33.51115
3362,사대부고,33.51338,126.51038,1016,65,1081,998,64,1062,제주특별자치도 제주시 용담삼동 581-14,제주시,24,1,126.512225,33.50131125
3363,사대부고,33.51339,126.51058,175,21,196,173,20,193,제주특별자치도 제주시 용담이동 576-2,제주시,24,1,126.512225,33.50131125
3364,용두암현대1차아파트,33.51593,126.50875,2692,483,3175,2626,471,3097,제주특별자치도 제주시 용담삼동 503-12,제주시,521,2,126.508535,33.516099999999994
3365,용두암현대1차아파트,33.51627,126.50832,1014,160,1174,1006,154,1160,제주특별자치도 제주시 용담삼동 510-3,제주시,521,2,126.508535,33.516099999999994
3367,제주성지,33.50983,126.52587,62,1,63,61,1,62,제주특별자치도 제주시 이도일동 1501-28,제주시,755,4,126.52587,33.50983
3368,일도초등학교,33.51109,126.52875,297,7,304,296,6,302,제주특별자치도 제주시 일도일동 1100-4,제주시,756,4,126.52875,33.51109
3372,국세공무원교육원공무원연금공단,33.25463,126.51778999999999,4323,1847,6170,4323,1847,6170,제주특별자치도 서귀포시 서호동 1583,서귀포시,64,1,126.53915666666667,33.255085
3373,국세공무원교육원공무원연금공단,33.25437,126.51799999999999,139,50,189,139,50,189,제주특별자치도 서귀포시 서호동 1583,서귀포시,64,1,126.53915666666667,33.255085
3374,상효원수목원,33.30511,126.58575,58,22,80,57,21,78,제주특별자치도 서귀포시 상효동 1555-2,서귀포시,522,4,126.58575,33.30511
3379,모구리야영장,33.405590000000004,126.81707,5,2,7,5,1,6,제주특별자치도 서귀포시 성산읍 삼달리 1982,서귀포시,8,3,126.56943375,33.28377125
3380,모구리야영장,33.40595,126.81815,74,7,81,72,6,78,제주특별자치도 서귀포시 성산읍 난산리 2968-3,서귀포시,8,3,126.56943375,33.28377125
3382,유건이오름,33.41684,126.84042,25,7,32,25,6,31,제주특별자치도 서귀포시 성산읍 난산리 2573-2,서귀포시,523,4,126.84042,33.41684
3385,서귀포동부도서관,33.260670000000005,126.60773,38,6,44,34,4,38,제주특별자치도 서귀포시 신효동 1120-3,서귀포시,364,2,126.60793000000001,33.26056
3386,서귀포동부도서관,33.26045,126.60813,22,1,23,22,1,23,제주특별자치도 서귀포시 신효동 1060-3,서귀포시,364,2,126.60793000000001,33.26056
3387,효돈축구공원,33.260709999999996,126.61182,83,9,92,82,9,91,제주특별자치도 서귀포시 신효동 895-3,서귀포시,365,2,126.61151999999998,33.260594999999995
3388,효돈축구공원,33.26048,126.61121999999999,22,5,27,22,5,27,제주특별자치도 서귀포시 신효동 919-3,서귀포시,365,2,126.61151999999998,33.260594999999995
3389,효돈농협하나로마트,33.26072,126.61724,851,51,902,848,47,895,제주특별자치도 서귀포시 하효동 641-2,서귀포시,66,1,126.612934,33.261552
3390,효돈농협하나로마트,33.26045,126.618,629,114,743,617,111,728,제주특별자치도 서귀포시 하효동 631-6,서귀포시,66,1,126.612934,33.261552
3391,맹살공원,33.26315,126.62162,149,29,178,148,27,175,제주특별자치도 서귀포시 하효동 313,서귀포시,11,1,126.54324,33.25177125
3392,맹살공원,33.26314,126.62198000000001,192,45,237,189,45,234,제주특별자치도 서귀포시 하효동 281-3,서귀포시,11,1,126.54324,33.25177125
3393,제지기오름,33.245490000000004,126.61105,106,13,119,106,13,119,제주특별자치도 서귀포시 하효동 1425,서귀포시,366,2,126.611095,33.245395
3394,제지기오름,33.2453,126.61113999999999,13,3,16,12,3,15,제주특별자치도 서귀포시 하효동 1407-3,서귀포시,366,2,126.611095,33.245395
3395,쇠소깍하효항입구,33.2529,126.61723,812,251,1063,786,223,1009,제주특별자치도 서귀포시 하효동 1090,서귀포시,367,2,126.617215,33.25277
3396,쇠소깍하효항입구,33.25264,126.6172,170,102,272,165,97,262,제주특별자치도 서귀포시 하효동 1068-3,서귀포시,367,2,126.617215,33.25277
3400,하효마을회관,33.2618,126.61758,271,14,285,270,12,282,제주특별자치도 서귀포시 하효동 190-1,서귀포시,66,1,126.612934,33.261552
3401,쇠소깍입구,33.25678,126.62173999999999,937,623,1560,906,592,1498,제주특별자치도 서귀포시 하효동 1460,서귀포시,524,4,126.62173999999999,33.25678
3405,앞동산,33.265679999999996,126.61395,690,15,705,681,13,694,제주특별자치도 서귀포시 신효동 694-2,서귀포시,25,3,126.5539542857143,33.25205285714286
3406,감귤박물관,33.27132,126.61075,97,23,120,96,23,119,제주특별자치도 서귀포시 신효동 510-10,서귀포시,368,2,126.61061999999998,33.27152
3407,감귤박물관,33.27172,126.61048999999998,205,30,235,199,30,229,제주특별자치도 서귀포시 신효동 506-18,서귀포시,368,2,126.61061999999998,33.27152
3410,대천동주민센터,33.249340000000004,126.47793999999999,26,3,29,26,3,29,제주특별자치도 서귀포시 도순동 1372,서귀포시,1,1,126.53914285714286,33.289225714285706
3415,강정의례회관,33.2381,126.47979,68,1,69,67,1,68,제주특별자치도 서귀포시 강정동 4511-1,서귀포시,525,4,126.47979,33.2381
3416,예천전문요양원,33.500029999999995,126.62007,1,5,6,1,5,6,제주특별자치도 제주시 회천동 3269,제주시,757,4,126.62007,33.500029999999995
3417,하귀휴먼시아2단지입구,33.48188,126.41408,1838,7,1845,1826,7,1833,제주특별자치도 제주시 애월읍 하귀1리 238-1,제주시,408,2,126.414465,33.48159
3419,신산로,33.507940000000005,126.53406000000001,232,42,274,229,41,270,제주특별자치도 제주시 일도이동 167-26,제주시,256,2,126.533905,33.507925
3420,문예회관,33.50548,126.53563,143,10,153,142,10,152,제주특별자치도 제주시 일도이동 470,제주시,257,2,126.53566,33.505215
3421,한림체육관,33.40898,126.26721,5554,88,5642,5424,86,5510,제주특별자치도 제주시 한림읍 한림리 915-11,제주시,522,2,126.267275,33.408950000000004
3422,조천체육관(종점),33.5401,126.64278999999999,14,5,19,14,5,19,제주특별자치도 제주시 조천읍 조천리 1198-3,제주시,129,2,126.64276,33.540085000000005
3425,신촌초등학교(종점),33.53273,126.61876000000001,37,2,39,37,1,38,제주특별자치도 제주시 조천읍 신촌리 4005,제주시,10,1,126.47669142857141,33.496474285714285
3426,고산환승정류장(종점),33.30077,126.18023000000001,783,14,797,781,14,795,제주특별자치도 제주시 한경면 고산리 2920-4,제주시,34,1,126.291986,33.375851
3428,대천환승정류장(종점),33.43616,126.73706000000001,10,1,11,10,1,11,제주특별자치도 제주시 구좌읍 송당리 산 126-7,제주시,46,1,126.62861222222222,33.44766888888889
3429,대천환승정류장(종점),33.43627,126.73676999999999,13,5,18,13,4,17,제주특별자치도 제주시 구좌읍 송당리 산 126-6,제주시,46,1,126.62861222222222,33.44766888888889
3434,용화로,33.509679999999996,126.50889,955,42,997,947,42,989,제주특별자치도 제주시 용담이동 616-12,제주시,523,2,126.50869499999999,33.50963
3435,용화로,33.50958,126.5085,1898,31,1929,1883,31,1914,제주특별자치도 제주시 용담이동 627-48,제주시,523,2,126.50869499999999,33.50963
3436,용마로,33.514829999999996,126.50595,594,150,744,593,148,741,제주특별자치도 제주시 용담삼동 531-26,제주시,524,2,126.506065,33.514995
3437,용마로,33.515159999999995,126.50618,801,68,869,790,62,852,제주특별자치도 제주시 용담삼동 519-17,제주시,524,2,126.506065,33.514995
3438,조천도서관,33.53706,126.66796000000001,3,1,4,3,1,4,제주특별자치도 제주시 조천읍 함덕리 915-1,제주시,62,3,126.5365675,33.501315000000005
3439,제주연구원,33.46765,126.51417,88,1,89,88,1,89,제주특별자치도 제주시 오라이동 44-13,제주시,60,1,126.49666142857143,33.48074571428571
3440,명월상동회관,33.37495,126.28303999999999,258,4,262,258,4,262,제주특별자치도 제주시 한림읍 명월리 421-3,제주시,758,4,126.28303999999999,33.37495
3444,명월리사무소,33.38675,126.26648999999999,6,10,16,6,10,16,제주특별자치도 제주시 한림읍 명월리 1714-8,제주시,216,2,126.26648,33.3869
3447,고산동산,33.49511,126.53437,2385,50,2435,2372,50,2422,제주특별자치도 제주시 이도이동 1085-4,제주시,525,2,126.534185,33.4952
3448,고산동산,33.49463,126.53302,11024,179,11203,10911,172,11083,제주특별자치도 제주시 이도이동 1019-11,제주시,59,1,126.55799571428572,33.507851428571435
3449,고산동산,33.495290000000004,126.53399999999999,380,21,401,372,21,393,제주특별자치도 제주시 이도이동 1058-15,제주시,525,2,126.534185,33.4952
3450,제주소방서,33.491659999999996,126.53581000000001,3501,73,3574,3458,72,3530,제주특별자치도 제주시 이도이동 1029,제주시,759,4,126.53581000000001,33.491659999999996
3451,삼양파출소사거리,33.52052,126.58753,1031,96,1127,1008,92,1100,제주특별자치도 제주시 삼양이동 2181-18,제주시,526,2,126.58763,33.52054
3452,삼양파출소사거리,33.520559999999996,126.58773000000001,413,21,434,398,21,419,제주특별자치도 제주시 삼양이동 1494-15,제주시,526,2,126.58763,33.52054
3454,황사평성지,33.4868,126.55506000000001,289,2,291,287,1,288,제주특별자치도 제주시 영평동 2662-11,제주시,760,4,126.55506000000001,33.4868
3455,동문성당,33.51007,126.53237,1703,16,1719,1696,16,1712,제주특별자치도 제주시 일도이동 1031-11,제주시,527,2,126.532445,33.510194999999996
3456,동문성당,33.51032,126.53251999999999,44,3,47,44,3,47,제주특별자치도 제주시 일도이동 1024-30,제주시,527,2,126.532445,33.510194999999996
3459,선흘분교입구,33.51599,126.70629,62,3,65,59,2,61,제주특별자치도 제주시 조천읍 선흘리 987-1,제주시,528,2,126.70636499999999,33.51557
3460,선흘분교입구,33.51515,126.70643999999999,4,1,5,4,1,5,제주특별자치도 제주시 조천읍 선흘리 1032,제주시,528,2,126.70636499999999,33.51557
3462,생이집동산,33.27001,126.61299,137,5,142,135,5,140,제주특별자치도 서귀포시 신효동 548-2,서귀포시,526,4,126.61299,33.27001
3465,동광환승정류장(종점),33.3102,126.33937,34,12,46,34,10,44,제주특별자치도 서귀포시 안덕면 동광리 942-4,서귀포시,52,1,126.38022545454545,33.30013272727273
3466,동광환승정류장(종점),33.310340000000004,126.33932,22,5,27,22,5,27,제주특별자치도 서귀포시 안덕면 동광리 942-3,서귀포시,52,1,126.38022545454545,33.30013272727273
3467,번개과학체험관,33.28918,126.58627,52,18,70,50,18,68,제주특별자치도 서귀포시 토평동 1890-8,서귀포시,527,4,126.58627,33.28918
3468,소암기념관,33.24501,126.56736000000001,91,3,94,91,3,94,제주특별자치도 서귀포시 서귀동 160-5,서귀포시,31,1,126.61406500000001,33.26293875
3469,소암기념관,33.24484,126.56763000000001,46,16,62,46,15,61,제주특별자치도 서귀포시 서귀동 60-2,서귀포시,31,1,126.61406500000001,33.26293875
3470,덕수2리교차로,33.27668,126.31418000000001,50,4,54,48,4,52,제주특별자치도 서귀포시 안덕면 덕수리 1453-1,서귀포시,5,3,126.39661875,33.266799999999996
3471,덕수2리교차로,33.275290000000005,126.31209,16,5,21,14,5,19,제주특별자치도 서귀포시 안덕면 덕수리 1605-5,서귀포시,5,3,126.39661875,33.266799999999996
3474,솜반천,33.253209999999996,126.55336000000001,101,5,106,100,5,105,제주특별자치도 서귀포시 서홍동 1219-1,서귀포시,369,2,126.55343500000001,33.253215
3475,솜반천,33.25322,126.55351,89,1,90,88,1,89,제주특별자치도 서귀포시 서홍동 1223-4,서귀포시,369,2,126.55343500000001,33.253215
3478,흙담솔사가,33.25885,126.5524,59,1,60,59,1,60,제주특별자치도 서귀포시 서홍동 1554-2,서귀포시,370,2,126.552335,33.25878
3479,흙담솔사가,33.25871,126.55227,332,5,337,329,5,334,제주특별자치도 서귀포시 서홍동 1530-3,서귀포시,370,2,126.552335,33.25878
3480,하효마을다목적회관,33.25815,126.61758,465,26,491,462,25,487,제주특별자치도 서귀포시 하효동 604-1,서귀포시,528,4,126.61758,33.25815
3481,신효웃동네,33.26741,126.61362,27,1,28,27,1,28,제주특별자치도 서귀포시 신효동 682-5,서귀포시,371,2,126.61375000000001,33.267405
3482,신효웃동네,33.2674,126.61388000000001,97,2,99,97,2,99,제주특별자치도 서귀포시 신효동 676-2,서귀포시,371,2,126.61375000000001,33.267405
3483,보목동동네,33.24305,126.60597,992,53,1045,988,50,1038,제주특별자치도 서귀포시 보목동 399-7,서귀포시,372,2,126.606225,33.24306
3484,보목동동네,33.24307,126.60648,133,33,166,131,30,161,제주특별자치도 서귀포시 보목동 396-1,서귀포시,372,2,126.606225,33.24306
3485,위미3리마을회관,33.27512,126.68907,1655,45,1700,1626,43,1669,제주특별자치도 서귀포시 남원읍 위미리 161-1,서귀포시,83,2,126.68887000000001,33.275075
3486,제주대학교병원,33.46784,126.54501,11428,143,11571,11334,138,11472,제주특별자치도 제주시 아라일동 1753-3,제주시,761,4,126.54501,33.46784
3487,첨단꿈에그린2단지아파트,33.45301,126.5764,4339,42,4381,4326,42,4368,제주특별자치도 제주시 월평동 745,제주시,529,2,126.57665500000002,33.45245
3491,사려니마을,33.426390000000005,126.6559,165,60,225,156,55,211,제주특별자치도 제주시 조천읍 교래리 산 86-3,제주시,530,2,126.655925,33.42633000000001
3492,사려니마을,33.42627,126.65595,45,40,85,42,38,80,제주특별자치도 제주시 조천읍 교래리 855,제주시,530,2,126.655925,33.42633000000001
3493,구좌정수장,33.50508,126.77245,1,1,2,1,1,2,제주특별자치도 제주시 구좌읍 덕천리 308-5,제주시,61,1,126.53408285714285,33.43949428571429
3494,아라뜨래별,33.437290000000004,126.55463999999999,17,5,22,16,5,21,제주특별자치도 제주시 아라일동 산 40-4,제주시,531,2,126.55469,33.437290000000004
3495,남용통상,33.29072,126.57892,97,27,124,90,26,116,제주특별자치도 서귀포시 토평동 3284-1,서귀포시,529,4,126.57892,33.29072
3496,용운사,33.25999,126.62346000000001,245,52,297,241,49,290,제주특별자치도 서귀포시 하효동 407-1,서귀포시,530,4,126.62346000000001,33.25999
3497,정혜재활원,33.287,126.57818999999999,712,126,838,677,120,797,제주특별자치도 서귀포시 토평동 3083-7,서귀포시,531,4,126.57818999999999,33.287
3498,온난화대응농업연구소,33.46625,126.51817,53,1,54,53,1,54,제주특별자치도 제주시 오등동 1730-1,제주시,26,1,126.56073375000001,33.4921825
3499,온난화대응농업연구소,33.46627,126.51841999999999,34,1,35,34,1,35,제주특별자치도 제주시 오등동 1730-10,제주시,26,1,126.56073375000001,33.4921825
3500,"거슨새미오름,안돌오름",33.44509,126.7569,84,87,171,81,83,164,제주특별자치도 제주시 구좌읍 송당리 2339-3,제주시,532,2,126.75687500000001,33.44512
3501,"거슨새미오름,안돌오름",33.44515,126.75685,288,32,320,284,31,315,제주특별자치도 제주시 구좌읍 송당리 2339-3,제주시,532,2,126.75687500000001,33.44512
3503,배낭골,33.3458,126.23028000000001,186,4,190,155,4,159,제주특별자치도 제주시 한경면 조수리 595-2,제주시,533,2,126.23021,33.345815
3505,홍수암,33.35326,126.22956,54,32,86,48,32,80,제주특별자치도 제주시 한림읍 월림리 951-2,제주시,762,4,126.22956,33.35326
3506,행장디,33.501129999999996,126.56221000000001,311,7,318,301,7,308,제주특별자치도 제주시 화북이동 3106-1,제주시,534,2,126.56245,33.501125
3507,행장디,33.50112,126.56268999999999,24,4,28,24,4,28,제주특별자치도 제주시 화북이동 3160-3,제주시,534,2,126.56245,33.501125
3508,한국전력변전소,33.49832,126.53716999999999,357,5,362,355,5,360,제주특별자치도 제주시 이도이동 996-7,제주시,535,2,126.53730499999999,33.49835
3509,한국전력변전소,33.49838,126.53743999999999,1349,26,1375,1337,26,1363,제주특별자치도 제주시 이도이동 444,제주시,535,2,126.53730499999999,33.49835
3510,NHF삼화1단지,33.51746,126.5821,17314,93,17407,17175,91,17266,제주특별자치도 제주시 삼양이동 2338,제주시,763,4,126.5821,33.51746
3511,첨단꿈에그린2단지아파트,33.45189,126.57691000000001,402,1,403,398,1,399,제주특별자치도 제주시 월평동 750,제주시,529,2,126.57665500000002,33.45245
3514,제주관광대학(가상),33.4482,126.43583000000001,16143,101,16244,15827,96,15923,제주특별자치도 제주시 애월읍 광령리 2619-3,제주시,182,2,126.43551500000001,33.447810000000004
3515,제주사대부설중학교,33.51497,126.51043999999999,541,284,825,519,269,788,제주특별자치도 제주시 용담삼동 581-13,제주시,536,2,126.51049499999999,33.51497
3516,제주사대부설중학교,33.51497,126.51055,221,145,366,215,143,358,제주특별자치도 제주시 용담이동 571-1,제주시,536,2,126.51049499999999,33.51497
3517,항몽유적지입구,33.4574,126.41046000000001,636,190,826,593,188,781,제주특별자치도 제주시 애월읍 상귀리 856-2,제주시,537,2,126.41058000000001,33.457409999999996
3518,항몽유적지입구,33.45742,126.4107,585,165,750,577,161,738,제주특별자치도 제주시 애월읍 고성리 1304-19,제주시,537,2,126.41058000000001,33.457409999999996
3519,명월상동,33.37509,126.27953000000001,168,3,171,168,3,171,제주특별자치도 제주시 한림읍 명월리 350,제주시,764,4,126.27953000000001,33.37509
3521,첨단로8길,33.44393,126.57193999999998,12,1,13,11,1,12,제주특별자치도 제주시 영평동 2192-1,제주시,538,2,126.57202999999998,33.44393
3522,첨단로8길,33.44393,126.57212,1212,20,1232,1206,20,1226,제주특별자치도 제주시 영평동 2273,제주시,538,2,126.57202999999998,33.44393
3525,지미봉입구,33.49515,126.90454,68,8,76,68,8,76,제주특별자치도 제주시 구좌읍 종달리 549-1,제주시,539,2,126.904315,33.495015
3526,지미봉입구,33.49488,126.90409,1,3,4,1,3,4,제주특별자치도 제주시 구좌읍 종달리 565-47,제주시,539,2,126.904315,33.495015
3527,아라초등학교,33.4777,126.54451999999999,975,17,992,964,17,981,제주특별자치도 제주시 아라이동 1574-2,제주시,5,1,126.52680249999999,33.47999624999999
3528,하늘정원,33.51377,126.78008999999999,16,8,24,16,8,24,제주특별자치도 제주시 구좌읍 행원리 3431,제주시,540,2,126.78018499999999,33.513745
3529,하늘정원,33.51372,126.78028,50,18,68,47,18,65,제주특별자치도 제주시 구좌읍 행원리 3431-1,제주시,540,2,126.78018499999999,33.513745
3530,동부경찰서,33.50178,126.53681,589,6,595,585,6,591,제주특별자치도 제주시 이도이동 1211-1,제주시,541,2,126.536935,33.501684999999995
3531,동부경찰서,33.50159,126.53706000000001,219,14,233,219,14,233,제주특별자치도 제주시 이도이동 444-1,제주시,541,2,126.536935,33.501684999999995
3534,첨단과기단지입구교학촌아파트,33.45776,126.57145,76,4,80,76,3,79,제주특별자치도 제주시 영평동 2273,제주시,765,4,126.57145,33.45776
3539,탐라도서관,33.477540000000005,126.47758999999999,657,13,670,648,10,658,제주특별자치도 제주시 노형동 765,제주시,142,2,126.47749999999999,33.47755
3540,으뜸마을,33.47894,126.48033999999998,642,9,651,632,9,641,제주특별자치도 제주시 노형동 737,제주시,141,2,126.480345,33.479020000000006
3542,상귀리,33.4735,126.40983999999999,585,16,601,573,16,589,제주특별자치도 제주시 애월읍 상귀리 264-6,제주시,766,4,126.40983999999999,33.4735
3543,제일교,33.51234,126.53191000000001,289,8,297,288,8,296,제주특별자치도 제주시 일도이동 995-78,제주시,16,1,126.51379375,33.50224
3550,구좌정수장,33.5048,126.77186999999999,10,5,15,10,5,15,제주특별자치도 제주시 구좌읍 덕천리 311,제주시,61,1,126.53408285714285,33.43949428571429
3551,구좌정수장,33.50529,126.7722,188,15,203,188,14,202,제주특별자치도 제주시 구좌읍 덕천리 308-4,제주시,61,1,126.53408285714285,33.43949428571429
3553,행원교차로,33.545790000000004,126.80458999999999,14,2,16,14,2,16,제주특별자치도 제주시 구좌읍 행원리 1145-2,제주시,767,4,126.80458999999999,33.545790000000004
3558,두문포노린당,33.49647,126.90913,115,43,158,107,42,149,제주특별자치도 제주시 구좌읍 종달리 486-6,제주시,542,2,126.90914000000001,33.496385000000004
3559,두문포노린당,33.4963,126.90915,1,5,6,1,5,6,제주특별자치도 제주시 구좌읍 종달리 565-40,제주시,542,2,126.90914000000001,33.496385000000004
3566,한림체육관,33.40892,126.26733999999999,682,17,699,670,16,686,제주특별자치도 제주시 한림읍 한림리 886-8,제주시,522,2,126.267275,33.408950000000004
3570,장전포제청,33.44413,126.38228000000001,5,2,7,5,2,7,제주특별자치도 제주시 애월읍 장전리 1595-8,제주시,768,4,126.38228000000001,33.44413
3573,장전초등학교,33.44963,126.39098,6,7,13,6,4,10,제주특별자치도 제주시 애월읍 장전리 430-5,제주시,43,1,126.41751714285714,33.46041714285714
3574,번대동,33.4777,126.39206999999999,3089,81,3170,3054,78,3132,제주특별자치도 제주시 애월읍 하귀2리 2965-1,제주시,58,1,126.44750285714285,33.48175428571429
3575,어썸브리즈,33.259159999999994,126.27569,46,1,47,44,1,45,제주특별자치도 서귀포시 대정읍 안성리 1801-1,서귀포시,532,4,126.27569,33.259159999999994
3580,통물,33.247679999999995,126.53115,94,21,115,90,20,110,제주특별자치도 서귀포시 호근동 2142,서귀포시,533,4,126.53115,33.247679999999995
3581,봉림사,33.25473,126.53996000000001,29,3,32,29,3,32,제주특별자치도 서귀포시 호근동 662-3,서귀포시,32,1,126.52956,33.25009
3582,봉림사,33.25473,126.54035,42,10,52,42,9,51,제주특별자치도 서귀포시 호근동 663-3,서귀포시,32,1,126.52956,33.25009
3583,배튼개입구,33.24157,126.44357,421,102,523,412,100,512,제주특별자치도 서귀포시 대포동 2606-20,서귀포시,373,2,126.44340499999998,33.241240000000005
3584,배튼개입구,33.24091,126.44323999999999,335,70,405,323,68,391,제주특별자치도 서귀포시 대포동 2229-3,서귀포시,373,2,126.44340499999998,33.241240000000005
3585,동물개동산앞,33.240120000000005,126.4312,1014,200,1214,982,197,1179,제주특별자치도 서귀포시 대포동 1812-1,서귀포시,374,2,126.43112500000001,33.240125000000006
3586,동물개동산앞,33.24013,126.43105,536,227,763,513,205,718,제주특별자치도 서귀포시 대포동 1816-3,서귀포시,374,2,126.43112500000001,33.240125000000006
3592,강정새마을금고,33.236470000000004,126.47731,678,12,690,654,12,666,제주특별자치도 서귀포시 강정동 4399-21,서귀포시,534,4,126.47731,33.236470000000004
3597,수산리사무소,33.44769,126.88238999999999,593,14,607,593,13,606,제주특별자치도 서귀포시 성산읍 수산리 1208-2,서귀포시,375,2,126.88246,33.447720000000004
3598,수산리사무소,33.44775,126.88253,89,6,95,88,6,94,제주특별자치도 서귀포시 성산읍 수산리 611-2,서귀포시,375,2,126.88246,33.447720000000004
3599,석부작박물관,33.249990000000004,126.53472,63,26,89,62,25,87,제주특별자치도 서귀포시 호근동 509-2,서귀포시,376,2,126.53499,33.25
3600,석부작박물관,33.250009999999996,126.53526000000001,73,25,98,71,23,94,제주특별자치도 서귀포시 호근동 512-5,서귀포시,376,2,126.53499,33.25
3601,외돌개,33.241240000000005,126.54763,334,245,579,310,233,543,제주특별자치도 서귀포시 서홍동 780-1,서귀포시,41,2,126.57285857142858,33.27642285714286
3605,성읍119지역센터,33.384029999999996,126.79449,8,4,12,8,4,12,제주특별자치도 서귀포시 표선면 성읍리 1381-1,서귀포시,535,4,126.79449,33.384029999999996
3610,국제교회,33.28203,126.27853,349,17,366,343,17,360,제주특별자치도 서귀포시 대정읍 보성리 2468,서귀포시,377,2,126.27829500000001,33.282495
3611,국제교회,33.282959999999996,126.27806000000001,947,27,974,940,25,965,제주특별자치도 서귀포시 대정읍 보성리 2478,서귀포시,377,2,126.27829500000001,33.282495
3612,위미중학교,33.280570000000004,126.66246000000001,281,2,283,265,2,267,제주특별자치도 서귀포시 남원읍 위미리 4591,서귀포시,536,4,126.66246000000001,33.280570000000004
3613,만지동,33.29315,126.62728999999999,2,5,7,2,5,7,제주특별자치도 서귀포시 남원읍 신례리 1279-1,서귀포시,12,1,126.45767142857143,33.284415714285714
3614,휴애리자연생활공원,33.30834,126.63287,202,176,378,197,162,359,제주특별자치도 서귀포시 남원읍 신례리 2010-1,서귀포시,378,2,126.633135,33.308234999999996
3615,휴애리자연생활공원,33.30813,126.6334,210,205,415,203,195,398,제주특별자치도 서귀포시 남원읍 신례리 2012-1,서귀포시,378,2,126.633135,33.308234999999996
3616,예래오마트,33.24972,126.39413,38,1,39,36,1,37,제주특별자치도 서귀포시 상예동 1178-12,서귀포시,29,1,126.48017374999999,33.25316
3617,예래오마트,33.24975,126.39426,1780,26,1806,1762,24,1786,제주특별자치도 서귀포시 상예동 802-4,서귀포시,29,1,126.48017374999999,33.25316
3618,예래동노인회관,33.24667,126.39282,58,3,61,56,3,59,제주특별자치도 서귀포시 상예동 1200-1,서귀포시,28,1,126.43984142857143,33.241957142857146
3619,예래동노인회관,33.24667,126.39303999999998,2148,27,2175,2109,27,2136,제주특별자치도 서귀포시 상예동 4999,서귀포시,28,1,126.43984142857143,33.241957142857146
3620,예래생태체험관,33.24426,126.3895,76,1,77,73,1,74,제주특별자치도 서귀포시 하예동 45-1,서귀포시,379,2,126.389415,33.24417
3621,예래생태체험관,33.24408,126.38933,1713,40,1753,1682,38,1720,제주특별자치도 서귀포시 하예동 45-3,서귀포시,379,2,126.389415,33.24417
3622,진양빌라,33.243590000000005,126.38733,71,6,77,71,6,77,제주특별자치도 서귀포시 하예동 221-1,서귀포시,380,2,126.38735,33.24354
3623,진양빌라,33.24349,126.38736999999999,1642,118,1760,1635,114,1749,제주특별자치도 서귀포시 하예동 221-1,서귀포시,380,2,126.38735,33.24354
3624,삼무공원,33.49116,126.49004,761,135,896,754,134,888,제주특별자치도 제주시 연동 260-13,제주시,62,1,126.5365675,33.501315000000005
3625,삼무공원,33.490790000000004,126.49023000000001,224,53,277,223,53,276,제주특별자치도 제주시 연동 271,제주시,62,1,126.5365675,33.501315000000005
3627,세곳못,33.441959999999995,126.38125,31,3,34,31,3,34,제주특별자치도 제주시 애월읍 소길리 542-2,제주시,769,4,126.38125,33.441959999999995
3628,명월리노인복지회관,33.38439,126.26736000000001,18,5,23,18,5,23,제주특별자치도 제주시 한림읍 명월리 1616-1,제주시,543,2,126.26735500000001,33.384545
3629,명월리노인복지회관,33.3847,126.26735,185,28,213,185,27,212,제주특별자치도 제주시 한림읍 명월리 1641-5,제주시,543,2,126.26735500000001,33.384545
3630,유수암리,33.42711,126.4103,280,9,289,280,9,289,제주특별자치도 제주시 애월읍 유수암리 336-3,제주시,298,2,126.410615,33.427459999999996
3631,한스빌타운하우스,33.43203,126.40706999999999,14,1,15,14,1,15,제주특별자치도 제주시 애월읍 유수암리 882-1,제주시,544,2,126.40736999999999,33.431685
3632,제주월드컵경기장,33.24913,126.50783999999999,1892,108,2000,1872,107,1979,제주특별자치도 서귀포시 법환동 816-9,서귀포시,4,1,126.51396210526316,33.26277789473685
3633,제주노인복지타운,33.25436,126.43887,47,7,54,46,3,49,제주특별자치도 서귀포시 회수동 658-13,서귀포시,381,2,126.43897,33.254225000000005
3634,제주노인복지타운,33.254090000000005,126.43907,4,6,10,4,6,10,제주특별자치도 서귀포시 회수동 637-3,서귀포시,381,2,126.43897,33.254225000000005
3636,서복전시관,33.245020000000004,126.57043999999999,472,88,560,470,86,556,제주특별자치도 서귀포시 서귀동 102-6,서귀포시,65,1,126.588856,33.252526
3638,정방동문화의집,33.2461,126.56853000000001,69,13,82,69,13,82,제주특별자치도 서귀포시 서귀동 137-6,서귀포시,23,1,126.52565142857144,33.25023785714286
3639,중문동주민센터,33.25359,126.43323999999998,35,4,39,35,3,38,제주특별자치도 서귀포시 중문동 1894-2,서귀포시,382,2,126.433275,33.25353
3640,중문동주민센터,33.25347,126.43331,116,44,160,115,40,155,제주특별자치도 서귀포시 중문동 1870-1,서귀포시,382,2,126.433275,33.25353
3978,새별오름,33.35913,126.36296000000002,12,1,13,10,1,11,제주특별자치도 제주시 애월읍 봉성리 산 53-12,제주시,33,3,126.30488375000002,33.38845875
3979,새별오름,33.3608,126.3644,45,16,61,45,15,60,제주특별자치도 제주시 애월읍 봉성리 산 53-8,제주시,33,3,126.30488375000002,33.38845875
4010,김만덕기념관,33.515809999999995,126.53003000000001,205,61,266,201,55,256,제주특별자치도 제주시 건입동 1148-1,제주시,545,2,126.52997500000001,33.515865
4011,김만덕기념관,33.51592,126.52991999999999,574,148,722,560,138,698,제주특별자치도 제주시 건입동 1430,제주시,545,2,126.52997500000001,33.515865
4012,도평로광평마을입구,33.47914,126.46198000000001,521,32,553,517,31,548,제주특별자치도 제주시 노형동 3104-9,제주시,546,2,126.46207000000001,33.479209999999995
4013,화북공업단지,33.51161,126.56546999999999,46,1,47,45,1,46,제주특별자치도 제주시 화북이동 2271-7,제주시,770,4,126.56546999999999,33.51161
4014,도평로광평마을입구,33.479279999999996,126.46216000000001,103,14,117,101,14,115,제주특별자치도 제주시 노형동 3104-9,제주시,546,2,126.46207000000001,33.479209999999995
4015,봉개초등학교,33.49005,126.59527,236,35,271,234,31,265,제주특별자치도 제주시 봉개동 1906-3,제주시,771,4,126.59527,33.49005
4016,이도수선화아파트,33.4944,126.55058000000001,1168,23,1191,1155,23,1178,제주특별자치도 제주시 이도이동 67-1,제주시,547,2,126.55058000000001,33.49422
4017,차고지(가상),33.49839,126.51651000000001,136,13,149,136,13,149,제주특별자치도 제주시 삼도일동 586,제주시,476,2,126.516415,33.49879000000001
4018,이도수선화아파트,33.494040000000005,126.55058000000001,209,8,217,208,8,216,제주특별자치도 제주시 이도이동 66-1,제주시,547,2,126.55058000000001,33.49422
4019,제주장애인요양원,33.45514,126.5713,522,6,528,514,6,520,제주특별자치도 제주시 영평동 2163,제주시,548,2,126.5714,33.45515
4020,제주장애인요양원,33.45516,126.5715,2561,61,2622,2530,59,2589,제주특별자치도 제주시 영평동 2273,제주시,548,2,126.5714,33.45515
4021,윗가시나물,33.4668,126.5697,354,2,356,349,2,351,제주특별자치도 제주시 영평동 2037-11,제주시,772,4,126.5697,33.4668
4022,승천로,33.49331,126.54165,744,1,745,738,1,739,제주특별자치도 제주시 아라이동 3012-3,제주시,549,2,126.54155500000002,33.49356
4024,승천로,33.493809999999996,126.54146000000001,1813,34,1847,1784,31,1815,제주특별자치도 제주시 이도이동 2075,제주시,549,2,126.54155500000002,33.49356
4025,이도수선화아파트,33.49064,126.55142,913,3,916,908,3,911,제주특별자치도 제주시 이도이동 105-1,제주시,550,2,126.55138,33.490555
4026,이도수선화아파트,33.49047,126.55134,153,1,154,152,1,153,제주특별자치도 제주시 이도이동 104-1,제주시,550,2,126.55138,33.490555
4027,한라도서관입구,33.48151,126.51572,100,3,103,99,3,102,제주특별자치도 제주시 오라이동 3828,제주시,63,1,126.5741,33.48683
4028,고지교,33.486779999999996,126.51732,121,1,122,119,1,120,제주특별자치도 제주시 오라이동 943-3,제주시,773,4,126.51732,33.486779999999996
4029,대원오등동입구,33.477340000000005,126.54233,135,2,137,135,2,137,제주특별자치도 제주시 아라일동 6049,제주시,171,2,126.54262,33.47748
4031,선돌목동길,33.449529999999996,126.55103000000001,175,8,183,169,8,177,제주특별자치도 제주시 아라일동 393-16,제주시,551,2,126.55092000000002,33.449329999999996
4032,선돌목동길,33.44913,126.55081000000001,35,9,44,34,8,42,제주특별자치도 제주시 오등동 산 182-8,제주시,551,2,126.55092000000002,33.449329999999996
4033,연동한일시티파크,33.49152,126.48878,9479,1239,10718,9046,1177,10223,제주특별자치도 제주시 연동 2335-4,제주시,62,1,126.5365675,33.501315000000005
4034,연동한일시티파크,33.49158,126.48935,2472,611,3083,2370,571,2941,제주특별자치도 제주시 연동 250,제주시,62,1,126.5365675,33.501315000000005
4035,용마마을,33.517070000000004,126.50353,28,14,42,26,13,39,제주특별자치도 제주시 용담삼동 1064-3,제주시,552,2,126.50362000000001,33.51696
4036,용마마을,33.51685,126.50371000000001,7,1,8,6,1,7,제주특별자치도 제주시 용담삼동 1020-1,제주시,552,2,126.50362000000001,33.51696
4038,물곧밭,33.457190000000004,126.40043,23,1,24,23,1,24,제주특별자치도 제주시 애월읍 수산리 57-4,제주시,553,2,126.40069500000001,33.456885
4039,물곧밭,33.456579999999995,126.40096000000001,220,3,223,219,3,222,제주특별자치도 제주시 애월읍 수산리 85-2,제주시,553,2,126.40069500000001,33.456885
4040,예원동,33.46095,126.39782,533,4,537,530,4,534,제주특별자치도 제주시 애월읍 상귀리 1584,제주시,49,3,126.67595750000001,33.484984999999995
4041,브릭캠퍼스,33.45828,126.486,22,20,42,22,20,42,제주특별자치도 제주시 노형동 244-16,제주시,774,4,126.486,33.45828
4043,첨단행복주택,33.455420000000004,126.57563999999999,530,5,535,528,5,533,제주특별자치도 제주시 월평동 751,제주시,554,2,126.57563999999999,33.45565500000001
4044,첨단행복주택,33.455890000000004,126.57563999999999,63,1,64,63,1,64,제주특별자치도 제주시 월평동 750,제주시,554,2,126.57563999999999,33.45565500000001
4047,소란마을,33.455330000000004,126.54928000000001,57,9,66,57,9,66,제주특별자치도 제주시 아라일동 408-4,제주시,775,4,126.54928000000001,33.455330000000004
4048,아라뜨래별,33.437290000000004,126.55474,327,19,346,326,19,345,제주특별자치도 제주시 아라일동 산 40-1,제주시,531,2,126.55469,33.437290000000004
4049,영등물,33.55532,126.73618,576,485,1061,541,474,1015,제주특별자치도 제주시 구좌읍 김녕리 4371,제주시,440,2,126.73616,33.555440000000004
4050,매일올레시장7번입구,33.24909,126.56706000000001,8822,2141,10963,8627,2036,10663,제주특별자치도 서귀포시 서귀동 335,서귀포시,23,1,126.52565142857144,33.25023785714286
4051,위미3리,33.27531,126.68672,583,41,624,566,40,606,제주특별자치도 서귀포시 남원읍 위미리 183-4,서귀포시,84,2,126.68690000000001,33.275355
4052,고산문화의집,33.30015,126.18323999999998,236,21,257,233,21,254,제주특별자치도 제주시 한경면 고산리 3147-4,제주시,555,2,126.18326499999998,33.30022
4053,소보리당입구,33.26403,126.38181999999999,111,34,145,111,32,143,제주특별자치도 서귀포시 상예동 4999,서귀포시,4,2,126.51396210526316,33.26277789473685
4054,고산문화의집,33.300290000000004,126.18328999999999,817,54,871,810,47,857,제주특별자치도 제주시 한경면 고산리 2901-3,제주시,555,2,126.18326499999998,33.30022
4055,송당리사무소,33.47167,126.78227,247,60,307,246,55,301,제주특별자치도 제주시 구좌읍 송당리 1370-13,제주시,776,4,126.78227,33.47167
4056,수산체육공원입구,33.45033,126.85083,36,4,40,35,4,39,제주특별자치도 서귀포시 성산읍 수산리 3038-11,서귀포시,537,4,126.85083,33.45033
4058,아부오름,33.44283,126.78041999999999,4,3,7,4,3,7,제주특별자치도 제주시 구좌읍 송당리 산 166-7,제주시,556,2,126.780435,33.442949999999996
4059,백약이오름,33.44103,126.79463,25,51,76,24,51,75,제주특별자치도 서귀포시 표선면 성읍리 1892,서귀포시,538,4,126.79463,33.44103
4062,백약이오름,33.44138,126.79426000000001,77,86,163,77,84,161,제주특별자치도 제주시 구좌읍 송당리 산 244-1,제주시,777,4,126.79426000000001,33.44138
4063,아부오름,33.44307,126.78045,33,14,47,30,13,43,제주특별자치도 제주시 구좌읍 송당리 산 166-3,제주시,556,2,126.780435,33.442949999999996
4064,명도암입구삼거리,33.42757,126.64043999999998,604,144,748,491,132,623,제주특별자치도 제주시 조천읍 교래리 777-2,제주시,557,2,126.640295,33.427595000000004
4065,명도암입구삼거리,33.427620000000005,126.64015,184,19,203,163,17,180,제주특별자치도 제주시 조천읍 교래리 산 137-25,제주시,557,2,126.640295,33.427595000000004
4066,성읍분투왓,33.40206,126.78348999999999,18,4,22,14,3,17,제주특별자치도 서귀포시 표선면 성읍리 2375-7,서귀포시,539,4,126.78348999999999,33.40206
4068,블루마운틴커피박물관,33.38041,126.83752,29,14,43,28,14,42,제주특별자치도 서귀포시 성산읍 삼달리 1510-1,서귀포시,383,2,126.837275,33.38065
4069,블루마운틴커피박물관,33.38089,126.83703,7,3,10,7,3,10,제주특별자치도 서귀포시 성산읍 삼달리 1507-2,서귀포시,383,2,126.837275,33.38065
4073,해양경찰청제주수련원,33.37892,126.79063000000001,4,11,15,3,11,14,제주특별자치도 서귀포시 표선면 성읍리 3294,서귀포시,540,4,126.79063000000001,33.37892
4076,옛성정문,33.31763,126.74512,2,1,3,2,1,3,제주특별자치도 서귀포시 남원읍 신흥리 1586-1,서귀포시,41,1,126.57285857142858,33.27642285714286
4077,의귀초등학교,33.31043,126.71523,99,1,100,99,1,100,제주특별자치도 서귀포시 남원읍 의귀리 1485-1,서귀포시,56,1,126.66646600000001,33.284141999999996
4078,노루생이삼거리,33.42292,126.49281,14,10,24,13,10,23,제주특별자치도 제주시 연동 산 146-3,제주시,558,2,126.49293,33.422685
4080,제주시공동묘지관리소,33.41948,126.49167,129,9,138,127,9,136,제주특별자치도 제주시 노형동 산 18-4,제주시,778,4,126.49167,33.41948
4081,노루생이삼거리,33.42245,126.49305,204,25,229,194,25,219,제주특별자치도 제주시 연동 산 146-3,제주시,558,2,126.49293,33.422685
4082,선담밭,33.271229999999996,126.27655,97,8,105,96,8,104,제주특별자치도 서귀포시 대정읍 보성리 469-6,서귀포시,384,2,126.276655,33.27119999999999
4083,선담밭,33.27117,126.27676000000001,49,2,51,49,2,51,제주특별자치도 서귀포시 대정읍 보성리 469-5,서귀포시,384,2,126.276655,33.27119999999999
4084,신화역사공원,33.30513,126.3189,626,124,750,611,114,725,제주특별자치도 서귀포시 안덕면 서광리 산 24-4,서귀포시,356,2,126.31928500000001,33.305385
4085,제주신화월드테마파크,33.30279,126.3155,1245,174,1419,1200,167,1367,제주특별자치도 서귀포시 안덕면 서광리 산 35-15,서귀포시,385,2,126.31548000000001,33.30272
4086,KIS빌리지,33.26933,126.27793,42,4,46,41,4,45,제주특별자치도 서귀포시 대정읍 보성리 479,서귀포시,386,2,126.27801,33.269369999999995
4087,KIS빌리지,33.26941,126.27808999999999,77,10,87,77,9,86,제주특별자치도 서귀포시 대정읍 안성리 1985-2,서귀포시,386,2,126.27801,33.269369999999995
4088,제주신화월드테마파크,33.30265,126.31546000000002,6981,606,7587,6729,575,7304,제주특별자치도 서귀포시 안덕면 서광리 산 35-15,서귀포시,385,2,126.31548000000001,33.30272
4089,지경동산,33.492,126.67176,55,19,74,55,19,74,제주특별자치도 제주시 조천읍 와산리 1642-13,제주시,559,2,126.671655,33.492104999999995
4090,송당북문,33.47312,126.78493,36,11,47,36,11,47,제주특별자치도 제주시 구좌읍 송당리 1387-13,제주시,779,4,126.78493,33.47312
4091,평대마장,33.500679999999996,126.81583,28,23,51,28,23,51,제주특별자치도 제주시 구좌읍 평대리 2866,제주시,560,2,126.81572,33.500715
4092,평대마장,33.50075,126.81561,37,9,46,37,8,45,제주특별자치도 제주시 구좌읍 평대리 2843-1,제주시,560,2,126.81572,33.500715
4094,지경동산,33.49221,126.67155,319,41,360,306,38,344,제주특별자치도 제주시 조천읍 대흘리 2787,제주시,559,2,126.671655,33.492104999999995
4095,상귀동카름,33.47282,126.41363999999999,316,3,319,312,3,315,제주특별자치도 제주시 애월읍 상귀리 20-3,제주시,780,4,126.41363999999999,33.47282
4097,한림농협주유소,33.40872,126.26223,385,35,420,381,34,415,제주특별자치도 제주시 한림읍 한림리 1548-2,제주시,781,4,126.26223,33.40872
4099,사장동,33.53347,126.65968000000001,2,1,3,2,1,3,제주특별자치도 제주시 조천읍 함덕리 2572,제주시,561,2,126.65978000000001,33.533445
4100,사장동,33.53342,126.65988,30,2,32,29,2,31,제주특별자치도 제주시 조천읍 함덕리 2540-3,제주시,561,2,126.65978000000001,33.533445
4102,이스트힐스,33.4816,126.63349,47,4,51,47,4,51,제주특별자치도 제주시 조천읍 와흘리 2814,제주시,782,4,126.63349,33.4816
4103,별진밭,33.4891,126.62796999999999,4,1,5,4,1,5,제주특별자치도 제주시 회천동 37-2,제주시,783,4,126.62796999999999,33.4891
4107,신흥리복지회관,33.54681,126.65216000000001,201,4,205,199,4,203,제주특별자치도 제주시 조천읍 신흥리 144-7,제주시,562,2,126.65208000000001,33.54679
4108,신흥리포구,33.54874,126.6508,213,15,228,213,15,228,제주특별자치도 제주시 조천읍 신흥리 530-15,제주시,784,4,126.6508,33.54874
4109,신흥리복지회관,33.54677,126.652,140,2,142,140,2,142,제주특별자치도 제주시 조천읍 신흥리 141-8,제주시,562,2,126.65208000000001,33.54679
4113,제주세계자연유산센터입구,33.45543,126.71032,12,2,14,12,2,14,제주특별자치도 제주시 조천읍 선흘리 1844,제주시,497,2,126.71036000000001,33.45543
4114,동방남비케길,33.482079999999996,126.69157,267,3,270,266,3,269,제주특별자치도 제주시 조천읍 와산리 1707,제주시,563,2,126.691675,33.482025
4115,동방남비케길,33.481970000000004,126.69178000000001,39,1,40,39,1,40,제주특별자치도 제주시 조천읍 와산리 307-2,제주시,563,2,126.691675,33.482025
4116,북촌리,33.54743,126.6947,15,3,18,14,3,17,제주특별자치도 제주시 조천읍 북촌리 639-1,제주시,50,1,126.62230625,33.503832499999994
4117,북촌리,33.54745,126.69479,103,13,116,99,13,112,제주특별자치도 제주시 조천읍 북촌리 639-7,제주시,50,1,126.62230625,33.503832499999994
4118,행원리오션뷰2차,33.526990000000005,126.78933,12,21,33,11,20,31,제주특별자치도 제주시 구좌읍 행원리 3559,제주시,564,2,126.789255,33.526945
4119,하도리신동,33.52359000000001,126.88373999999999,34,12,46,34,11,45,제주특별자치도 제주시 구좌읍 하도리 1681-1,제주시,565,2,126.883805,33.52357000000001
4120,하도리신동,33.52355,126.88387,213,13,226,213,13,226,제주특별자치도 제주시 구좌읍 하도리 1682,제주시,565,2,126.883805,33.52357000000001
4121,행원리오션뷰2차,33.5269,126.78918,9,8,17,9,8,17,제주특별자치도 제주시 구좌읍 행원리 2794,제주시,564,2,126.789255,33.526945
4123,법기동,33.33027,126.17285,62,7,69,60,7,67,제주특별자치도 제주시 한경면 용수리 3551-7,제주시,566,2,126.17278,33.330295
4124,청수리사거리,33.321740000000005,126.24507,235,11,246,230,11,241,제주특별자치도 제주시 한경면 청수리 1686-1,제주시,40,1,126.36481875,33.41299125
4125,청수리사거리,33.32164,126.24512,167,13,180,166,10,176,제주특별자치도 제주시 한경면 청수리 1634-2,제주시,40,1,126.36481875,33.41299125
4126,법기동,33.33032,126.17271000000001,61,6,67,61,6,67,제주특별자치도 제주시 한경면 용수리 3551-14,제주시,566,2,126.17278,33.330295
4127,용수리마을회관,33.32525,126.16873999999999,163,15,178,161,14,175,제주특별자치도 제주시 한경면 용수리 4107-12,제주시,387,2,126.16878999999999,33.32527
4128,주구동산,33.322790000000005,126.17015,149,11,160,149,11,160,제주특별자치도 제주시 한경면 용수리 4312-5,제주시,388,2,126.17020500000001,33.322805
4129,붉으내,33.31889,126.17239,15,1,16,15,1,16,제주특별자치도 제주시 한경면 용수리 4719-1,제주시,785,4,126.17239,33.31889
4131,방지물,33.296929999999996,126.22997,30,1,31,30,1,31,제주특별자치도 제주시 한경면 낙천리 856-3,제주시,786,4,126.22997,33.296929999999996
4136,상명리동카름,33.36482,126.27206000000001,310,1,311,310,1,311,제주특별자치도 제주시 한림읍 상명리 813-3,제주시,787,4,126.27206000000001,33.36482
4139,배낭골,33.34583,126.23013999999999,19,7,26,18,7,25,제주특별자치도 제주시 한경면 조수리 595-3,제주시,533,2,126.23021,33.345815
4140,낙천폭낭거리,33.32415,126.229,19,3,22,19,3,22,제주특별자치도 제주시 한경면 낙천리 1647-1,제주시,788,4,126.229,33.32415
4143,유수암리사무소,33.4414,126.40315,296,4,300,296,4,300,제주특별자치도 제주시 애월읍 유수암리 1892-1,제주시,215,2,126.40321999999999,33.441415
4144,웃거리,33.43935,126.40268,184,1,185,184,1,185,제주특별자치도 제주시 애월읍 유수암리 3234,제주시,57,1,126.45485,33.47211857142857
4145,한스빌타운하우스,33.43134000000001,126.40767,108,5,113,107,5,112,제주특별자치도 제주시 애월읍 유수암리 885-3,제주시,544,2,126.40736999999999,33.431685
4146,제주이야기,33.428960000000004,126.40952,13,2,15,13,2,15,제주특별자치도 제주시 애월읍 유수암리 354-7,제주시,510,2,126.409605,33.42903
4147,유수암상동경로당,33.423429999999996,126.4056,771,34,805,768,34,802,제주특별자치도 제주시 애월읍 유수암리 1042-27,제주시,214,2,126.405325,33.423185000000004
4148,더라목,33.45753,126.39025,22,1,23,20,1,21,제주특별자치도 제주시 애월읍 수산리 1315-1,제주시,789,4,126.39025,33.45753
4154,왕대왓,33.23465,126.48241000000002,1607,74,1681,1564,71,1635,제주특별자치도 서귀포시 강정동 2857-2,서귀포시,28,3,126.43984142857143,33.241957142857146
4155,왕대왓,33.23434,126.48362,1047,222,1269,1029,222,1251,제주특별자치도 서귀포시 강정동 2867-22,서귀포시,28,3,126.43984142857143,33.241957142857146
4160,제주세계자연유산센터거문오름,33.45683,126.7135,231,175,406,225,165,390,제주특별자치도 제주시 조천읍 선흘리 478-3,제주시,790,4,126.7135,33.45683
4161,인향동,33.2767,126.2438,32,5,37,32,5,37,제주특별자치도 서귀포시 대정읍 무릉리 322-7,서귀포시,387,2,126.24376,33.27648
4162,인향동,33.27626,126.24372,301,17,318,299,15,314,제주특별자치도 서귀포시 대정읍 무릉리 4097,서귀포시,387,2,126.24376,33.27648
4163,하효고막곶,33.2491,126.61393999999999,1,1,2,1,1,2,제주특별자치도 서귀포시 하효동 1213-4,서귀포시,388,2,126.61383,33.249075
4164,망동산,33.256809999999994,126.61885,526,15,541,520,14,534,제주특별자치도 서귀포시 하효동 905-4,서귀포시,541,4,126.61885,33.256809999999994
4165,하효고막곶,33.24905,126.61372,249,103,352,230,97,327,제주특별자치도 서귀포시 하효동 1232-4,서귀포시,388,2,126.61383,33.249075
4166,하례돈야로,33.29395,126.60711,307,4,311,305,4,309,제주특별자치도 서귀포시 남원읍 하례리 1715-5,서귀포시,542,4,126.60711,33.29395
4167,삼매봉중계소입구,33.24232,126.5522,10,3,13,10,3,13,제주특별자치도 서귀포시 서홍동 762-4,서귀포시,389,2,126.55249,33.24226
4168,삼매봉중계소입구,33.2422,126.55278,195,11,206,189,10,199,제주특별자치도 서귀포시 서홍동 753-10,서귀포시,389,2,126.55249,33.24226
4170,동상효회전교차로,33.2768,126.60591000000001,51,12,63,50,12,62,제주특별자치도 서귀포시 상효동 199-2,서귀포시,543,4,126.60591000000001,33.2768
4172,체육공원입구,33.27407,126.60831,63,9,72,62,9,71,제주특별자치도 서귀포시 신효동 1544-10,서귀포시,544,4,126.60831,33.27407
4174,헬스케어타운,33.28099,126.56379,421,32,453,411,29,440,제주특별자치도 서귀포시 토평동 3263,서귀포시,545,4,126.56379,33.28099
4175,소남동산,33.29445,126.6317,16,3,19,16,3,19,제주특별자치도 서귀포시 남원읍 신례리 1522-2,서귀포시,546,4,126.6317,33.29445
4181,자미성,33.29019,126.66063999999999,3,1,4,3,1,4,제주특별자치도 서귀포시 남원읍 위미리 2572-3,서귀포시,547,4,126.66063999999999,33.29019
4184,농협서부지점,33.25588,126.5244,114,6,120,113,5,118,제주특별자치도 서귀포시 호근동 1814-4,서귀포시,27,1,126.58037818181816,33.28037545454546
4185,약천사(출발지),33.243359999999996,126.45061000000001,402,133,535,375,121,496,제주특별자치도 서귀포시 하원동 1700-2,서귀포시,59,1,126.50107599999998,33.246554
4188,심향사,33.29456,126.62173999999999,129,2,131,128,2,130,제주특별자치도 서귀포시 남원읍 신례리 1647,서귀포시,87,2,126.621905,33.295015
4189,활오름,33.26135,126.4832,21,1,22,21,1,22,제주특별자치도 서귀포시 강정동 3791-2,서귀포시,350,2,126.4832,33.261269999999996
4191,토산1리송천교,33.32431,126.76141000000001,29,2,31,28,2,30,제주특별자치도 서귀포시 표선면 토산리 1879-1,서귀포시,390,2,126.761375,33.3244
4194,성산보건지소,33.446999999999996,126.91495,72,111,183,67,105,172,제주특별자치도 서귀포시 성산읍 고성리 2747,서귀포시,55,1,126.78752,33.366368
4197,토산1리송천교,33.324490000000004,126.76133999999999,69,6,75,69,6,75,제주특별자치도 서귀포시 표선면 토산리 1893,서귀포시,390,2,126.761375,33.3244
4200,흥덕사,33.399029999999996,126.876,19,2,21,19,2,21,제주특별자치도 서귀포시 성산읍 난산리 224-2,서귀포시,548,4,126.876,33.399029999999996
4202,달산봉입구,33.34321,126.82603,14,3,17,14,3,17,제주특별자치도 서귀포시 표선면 하천리 1100-4,서귀포시,62,1,126.733986,33.309762
4203,대진유토피아,33.34241,126.81477,478,39,517,470,39,509,제주특별자치도 서귀포시 표선면 표선리 2954,서귀포시,549,4,126.81477,33.34241
4204,예담요양원,33.342259999999996,126.81633000000001,141,10,151,140,8,148,제주특별자치도 서귀포시 표선면 표선리 2709,서귀포시,550,4,126.81633000000001,33.342259999999996
4205,크라운골프연습장,33.33979,126.8029,116,1,117,116,1,117,제주특별자치도 서귀포시 표선면 세화리 2489,서귀포시,551,4,126.8029,33.33979
4210,(구)화산초등학교,33.326229999999995,126.79726000000001,108,1,109,106,1,107,제주특별자치도 서귀포시 표선면 세화리 2489,서귀포시,552,4,126.79726000000001,33.326229999999995
4220,대정읍다목적회관,33.22094,126.26695,1,1,2,1,1,2,제주특별자치도 서귀포시 대정읍 상모리 2775-1,서귀포시,391,2,126.266985,33.220965
4221,화순해안경비안전센터사계출장소,33.22527,126.29978999999999,33,18,51,32,18,50,제주특별자치도 서귀포시 안덕면 사계리 2294-35,서귀포시,339,2,126.29998499999999,33.22564
4222,대정읍다목적회관,33.22099,126.26702,235,101,336,211,93,304,제주특별자치도 서귀포시 대정읍 상모리 2773-2,서귀포시,391,2,126.266985,33.220965
4223,화순리동하동경로당,33.24022,126.33795,36,5,41,35,5,40,제주특별자치도 서귀포시 안덕면 화순리 763-4,서귀포시,392,2,126.3383,33.24038
4224,화순금모래해수욕장,33.2396,126.33572,81,15,96,77,15,92,제주특별자치도 서귀포시 안덕면 화순리 776-8,서귀포시,553,4,126.33572,33.2396
4225,화순리동하동경로당,33.24054,126.33865,32,2,34,31,2,33,제주특별자치도 서귀포시 안덕면 화순리 742-1,서귀포시,392,2,126.3383,33.24038
4226,서광서리3교차로,33.29092,126.30065,15,2,17,15,2,17,제주특별자치도 서귀포시 안덕면 서광리 1394-5,서귀포시,393,2,126.300655,33.291
4227,진부동,33.288059999999994,126.30272,65,6,71,59,6,65,제주특별자치도 서귀포시 안덕면 서광리 1857-3,서귀포시,394,2,126.302795,33.288059999999994
4228,진부동,33.288059999999994,126.30287,259,17,276,150,16,166,제주특별자치도 서귀포시 안덕면 서광리 2471,서귀포시,394,2,126.302795,33.288059999999994
4229,서광서리3교차로,33.29108,126.30066000000001,44,9,53,44,9,53,제주특별자치도 서귀포시 안덕면 서광리 1393-5,서귀포시,393,2,126.300655,33.291
4230,제주신화월드서머셋,33.2999,126.31853999999998,39,14,53,38,13,51,제주특별자치도 서귀포시 안덕면 서광리 산 24-8,서귀포시,355,2,126.31866,33.299935000000005
4233,먼머루,33.27698,126.31021000000001,2,3,5,1,3,4,제주특별자치도 서귀포시 안덕면 덕수리 1614-1,서귀포시,554,4,126.31021000000001,33.27698
4235,인향동,33.27642,126.24358000000001,78,3,81,77,3,80,제주특별자치도 제주시 한경면 청수리 3389,제주시,791,4,126.24358000000001,33.27642
4236,향토오일시장,33.26623,126.57348999999999,989,33,1022,971,29,1000,제주특별자치도 서귀포시 동홍동 774-3,서귀포시,16,1,126.48757857142856,33.25839714285715
4237,칠십리음식특화거리,33.2441,126.56913999999999,362,64,426,356,63,419,제주특별자치도 서귀포시 서귀동 93-23,서귀포시,555,4,126.56913999999999,33.2441
4238,일과1리,33.23415,126.24243,23,1,24,23,1,24,제주특별자치도 서귀포시 대정읍 일과리 158,서귀포시,30,3,126.48163400000001,33.238526
4240,고내포구,33.4671,126.33717,40,9,49,39,7,46,제주특별자치도 제주시 애월읍 고내리 1156-4,제주시,567,2,126.337005,33.46719
4241,신엄포구,33.47298,126.35,45,23,68,43,19,62,제주특별자치도 제주시 애월읍 고내리 337-2,제주시,568,2,126.34995,33.473015000000004
4242,신엄입구,33.4784,126.36345,43,12,55,41,10,51,제주특별자치도 제주시 애월읍 신엄리 2730-3,제주시,569,2,126.363455,33.478445
4243,구엄포구,33.48406,126.37781000000001,73,19,92,72,18,90,제주특별자치도 제주시 애월읍 구엄리 600-2,제주시,792,4,126.37781000000001,33.48406
4244,가문동마을길,33.483509999999995,126.39577,42,11,53,40,11,51,제주특별자치도 제주시 애월읍 하귀2리 2615-2,제주시,570,2,126.39578,33.483549999999994
4245,가문동마을길,33.48359,126.39578999999999,18,10,28,18,9,27,제주특별자치도 제주시 애월읍 하귀2리 2615-5,제주시,570,2,126.39578,33.483549999999994
4247,신엄입구,33.47849,126.36346,63,14,77,59,14,73,제주특별자치도 제주시 애월읍 신엄리 2730-4,제주시,569,2,126.363455,33.478445
4248,신엄포구,33.47305,126.3499,26,25,51,26,24,50,제주특별자치도 제주시 애월읍 고내리 337-2,제주시,568,2,126.34995,33.473015000000004
4249,고내포구,33.46728,126.33684,3,7,10,3,7,10,제주특별자치도 제주시 애월읍 고내리 1156-4,제주시,567,2,126.337005,33.46719
6100732,구터미널,33.25203,126.56024,53617,2814,56431,52604,2689,55293,제주특별자치도 서귀포시 서귀동 337,서귀포시,9,1,126.57550250000001,33.25769583333333
6100848,제주시외버스터미널,33.49955,126.5148,1655,315,1970,1615,307,1922,제주특별자치도 제주시 오라일동 2441-4,제주시,6,1,126.468044,33.475798999999995
6103001,제주월드컵경기장,33.24948,126.50862,42357,4356,46713,41209,4124,45333,제주특별자치도 서귀포시 법환동 760,서귀포시,4,1,126.51396210526316,33.26277789473685
6103005,서귀포시구시외버스터미널,33.25217,126.56052,59541,2713,62254,58562,2553,61115,제주특별자치도 서귀포시 서귀동 337,서귀포시,9,1,126.57550250000001,33.25769583333333
6115000,여객선대합실,33.96269,126.29761,2012,116,2128,1696,100,1796,제주특별자치도 제주시 추자면 대서리 4-39,제주시,65,1,126.42995666666667,33.62573555555556
6115001,추자면자치센터,33.963640000000005,126.29681000000001,876,21,897,805,17,822,제주특별자치도 제주시 추자면 대서리 14-5,제주시,65,1,126.42995666666667,33.62573555555556
6115002,대서리사무소,33.96284,126.29563999999999,289,6,295,253,6,259,제주특별자치도 제주시 추자면 대서리 147-7,제주시,571,2,126.29576,33.962915
6115003,한의원,33.96232,126.29416,487,8,495,419,7,426,제주특별자치도 제주시 추자면 대서리 370,제주시,64,1,126.42354777777776,33.752810000000004
6115004,엘지마트,33.96141,126.29451999999999,868,13,881,790,13,803,제주특별자치도 제주시 추자면 영흥리 367-9,제주시,64,1,126.42354777777776,33.752810000000004
6115005,추자보건지소,33.96092,126.29553999999999,155,6,161,120,5,125,제주특별자치도 제주시 추자면 영흥리 367-9,제주시,64,1,126.42354777777776,33.752810000000004
6115006,영흥리,33.959990000000005,126.29642,529,7,536,516,6,522,제주특별자치도 제주시 추자면 영흥리 367-9,제주시,572,2,126.29680499999999,33.959785
6115007,영흥리부녀회사무실,33.959579999999995,126.29718999999999,223,8,231,193,7,200,제주특별자치도 제주시 추자면 영흥리 367-9,제주시,572,2,126.29680499999999,33.959785
6115009,추자교,33.95537,126.30091000000002,14,4,18,12,1,13,제주특별자치도 제주시 추자면 영흥리 94-1,제주시,573,2,126.300975,33.955355
6115010,묵리입구,33.95033,126.30689,130,4,134,94,4,98,제주특별자치도 제주시 추자면 묵리 산 124-1,제주시,20,3,126.42909875,33.60540125
6115011,묵리항,33.94683,126.31181000000001,10,2,12,9,2,11,제주특별자치도 제주시 추자면 묵리 683-1,제주시,793,4,126.31181000000001,33.94683
6115012,묵리,33.94464,126.31302,131,6,137,114,4,118,제주특별자치도 제주시 추자면 묵리 731-8,제주시,574,2,126.312995,33.94466
6115013,신양2리입구,33.94254,126.31511,150,2,152,147,2,149,제주특별자치도 제주시 추자면 묵리 227-2,제주시,575,2,126.31501,33.94258
6115015,한전사택,33.940670000000004,126.32203999999999,47,1,48,45,1,46,제주특별자치도 제주시 추자면 신양리 841-2,제주시,75,3,126.44789750000001,33.726627500000006
6115017,추자해변장여관,33.94209,126.32477,2,1,3,2,1,3,제주특별자치도 제주시 추자면 신양리 979-36,제주시,794,4,126.32477,33.94209
6115018,추자중학교,33.94384,126.32576999999999,90,1,91,81,1,82,제주특별자치도 제주시 추자면 신양리 434-7,제주시,576,2,126.32574,33.943815
6115019,신양1리,33.945609999999995,126.32767,220,3,223,204,2,206,제주특별자치도 제주시 추자면 신양리-2,제주시,577,2,126.32729499999999,33.9454
6115020,하추자보건소,33.94603,126.32886,427,19,446,394,18,412,제주특별자치도 제주시 추자면 신양리 421-1,제주시,72,3,126.47784000000001,33.740965
6115024,돈대산입구,33.95134,126.32771000000001,2155,95,2250,1871,81,1952,제주특별자치도 제주시 추자면 예초리 325-1,제주시,795,4,126.32771000000001,33.95134
6115025,모진이작지해수욕장입구,33.948640000000005,126.33098999999999,61,6,67,50,5,55,제주특별자치도 제주시 추자면 신양리 979,제주시,796,4,126.33098999999999,33.948640000000005
6115026,하추자보건소,33.946290000000005,126.33081000000001,566,13,579,507,11,518,제주특별자치도 제주시 추자면 신양리-2,제주시,72,3,126.47784000000001,33.740965
6115028,추자중학교,33.945190000000004,126.32692,1138,31,1169,1065,25,1090,제주특별자치도 제주시 추자면 신양리-2,제주시,577,2,126.32729499999999,33.9454
6115029,추자해변장여관,33.94379,126.32571000000002,189,18,207,159,16,175,제주특별자치도 제주시 추자면 신양리 434-7,제주시,576,2,126.32574,33.943815
6115031,한전사택,33.94032,126.32356999999999,47,1,48,44,1,45,제주특별자치도 제주시 추자면 신양리 874-13,제주시,75,3,126.44789750000001,33.726627500000006
6115034,묵리,33.94262,126.31491000000001,17,2,19,9,2,11,제주특별자치도 제주시 추자면 묵리 227-2,제주시,575,2,126.31501,33.94258
6115035,묵리항,33.94468,126.31296999999999,249,7,256,231,7,238,제주특별자치도 제주시 추자면 묵리 731-6,제주시,574,2,126.312995,33.94466
6115036,묵리입구,33.94794,126.30906,643,12,655,612,12,624,제주특별자치도 제주시 추자면 묵리 산 86-1,제주시,20,3,126.42909875,33.60540125
6115037,추자교,33.95284,126.30382,24,5,29,19,4,23,제주특별자치도 제주시 추자면 묵리 산 131-1,제주시,797,4,126.30382,33.95284
6115038,추자119지역센터,33.95534,126.30103999999999,75,5,80,58,5,63,제주특별자치도 제주시 추자면 영흥리 94-1,제주시,573,2,126.300975,33.955355
6115039,영흥리부녀회사무실,33.95966,126.30011,11,1,12,10,1,11,제주특별자치도 제주시 추자면 영흥리 23-4,제주시,798,4,126.30011,33.95966
6115042,엘지마트,33.96109000000001,126.29527,28,1,29,28,1,29,제주특별자치도 제주시 추자면 영흥리 367-9,제주시,64,1,126.42354777777776,33.752810000000004
6115043,한의원,33.96168,126.29411,58,2,60,53,2,55,제주특별자치도 제주시 추자면 대서리 147-16,제주시,64,1,126.42354777777776,33.752810000000004
6115045,추자면사무소,33.962990000000005,126.29588000000001,34,1,35,33,1,34,제주특별자치도 제주시 추자면 대서리 140-9,제주시,571,2,126.29576,33.962915
6115046,여객선대합실,33.96351,126.29717,36,4,40,34,4,38,제주특별자치도 제주시 추자면 대서리 14-6,제주시,65,1,126.42995666666667,33.62573555555556
6115047,우도천진항,33.49334,126.95151000000001,3647,1459,5106,2821,1286,4107,제주특별자치도 제주시 우도면 연평리 2656,제주시,799,4,126.95151000000001,33.49334
6115048,우도봉입구,33.49558,126.95411000000001,22,2,24,21,2,23,제주특별자치도 제주시 우도면 연평리 1666-2,제주시,800,4,126.95411000000001,33.49558
6115052,비양동,33.51123,126.96566999999999,1851,362,2213,1624,336,1960,제주특별자치도 제주시 우도면 연평리 133-1,제주시,801,4,126.96566999999999,33.51123
6115059,하우목동,33.50731,126.95093,339,147,486,273,135,408,제주특별자치도 제주시 우도면 연평리 2164-2,제주시,802,4,126.95093,33.50731
6115100,서귀포시외버스터미널,33.24873,126.50798999999999,3378,325,3703,3340,317,3657,제주특별자치도 서귀포시 법환동 843,서귀포시,4,1,126.51396210526316,33.26277789473685
6115101,서귀포시외버스터미널(가상정류소),33.248940000000005,126.50813000000001,35245,2736,37981,34610,2578,37188,제주특별자치도 서귀포시 법환동 843,서귀포시,4,1,126.51396210526316,33.26277789473685
