STATION_ID,STATION_NAME,STATION_Y,STATION_X,citizen_user_usage,tourist_user_usage,total_user_usage,citizen_station_usage,tourist_station_usage,total_station_usage,STATION_ADDRESS
1,국제여객선터미널,33.52438,126.54433,4003,2122,6125,3912,1875,5787,제주특별자치도 제주시 건입동 908-20
2,오광로입구,33.49527,126.45618,8422,2301,10723,8105,2210,10315,제주특별자치도 제주시 이호이동 1587-4
3,오광로입구,33.495459999999994,126.45623,940,288,1228,908,276,1184,제주특별자치도 제주시 이호이동 1587-1
4,이호2동,33.49488,126.46137,9892,206,10098,9827,188,10015,제주특별자치도 제주시 이호이동 803-6
5,이호2동,33.49508,126.46122,3007,113,3120,2979,109,3088,제주특별자치도 제주시 이호이동 803-5
6,노형주공아파트,33.4906,126.47393,4202,16,4218,4149,16,4165,제주특별자치도 제주시 노형동 2577-2
7,노형주공아파트,33.49068,126.47418,10200,173,10373,10124,172,10296,제주특별자치도 제주시 노형동 1238-1
8,못가름,33.48843,126.47678,1541,53,1594,1525,52,1577,제주특별자치도 제주시 노형동 1297-5
9,노형우체국,33.48765,126.47726000000002,28730,595,29325,28427,578,29005,제주특별자치도 제주시 노형동 1064-6
10,노형우체국,33.48709,126.47833,16780,283,17063,16540,269,16809,제주특별자치도 제주시 노형동 1297-5
11,노형오거리,33.48503,126.48013,34003,1269,35272,33396,1180,34576,제주특별자치도 제주시 노형동 919
12,롯데마트,33.4819,126.48218,11926,337,12263,11815,334,12149,제주특별자치도 제주시 노형동 767
13,롯데마트,33.48215,126.4824,19585,443,20028,19335,421,19756,제주특별자치도 제주시 노형동 767
14,비석동,33.48838,126.4179,1389,91,1480,1351,87,1438,제주특별자치도 제주시 애월읍 하귀1리 275-4
15,관전동,33.48883,126.41909,5096,167,5263,5041,160,5201,제주특별자치도 제주시 애월읍 하귀1리 264-7
16,관전동,33.48983,126.42015,570,19,589,565,19,584,제주특별자치도 제주시 애월읍 하귀1리 13
17,연대마을,33.49129,126.4228,1451,113,1564,1412,106,1518,제주특별자치도 제주시 외도일동 2111-1
18,연대마을,33.49174,126.42325,867,94,961,847,89,936,제주특별자치도 제주시 외도일동 2552-1
19,수정동,33.49264,126.42859,3766,532,4298,3700,505,4205,제주특별자치도 제주시 외도일동 646-1
20,연대마을,33.49282,126.42858,5355,478,5833,5210,459,5669,제주특별자치도 제주시 외도이동 2552
21,모감동,33.47573,126.38115,975,190,1165,938,184,1122,제주특별자치도 제주시 애월읍 구엄리 930-1
22,모감동,33.47591,126.38108,509,211,720,488,200,688,제주특별자치도 제주시 애월읍 구엄리 860-5
23,번대동,33.47889,126.39157,465,209,674,450,201,651,제주특별자치도 제주시 애월읍 구엄리 50-1
24,번대동,33.478840000000005,126.39264,1656,258,1914,1629,243,1872,제주특별자치도 제주시 애월읍 하귀2리 2970-1
25,하귀리,33.47955,126.39517,175,36,211,169,34,203,제주특별자치도 제주시 애월읍 하귀2리 2442
26,하귀초등학교,33.48017,126.40212,25532,1249,26781,25152,1192,26344,제주특별자치도 제주시 애월읍 하귀2리 1908-2
27,외도초등학교,33.49342,126.43321,18650,880,19530,18401,853,19254,제주특별자치도 제주시 외도이동 251-1
28,외도초등학교,33.4939,126.4344,11399,422,11821,11220,407,11627,제주특별자치도 제주시 외도이동 272-38
29,내도동서마을,33.49393,126.43848,3516,186,3702,3491,183,3674,제주특별자치도 제주시 내도동 580-8
30,내도동서마을,33.49415,126.43845,1490,82,1572,1468,80,1548,제주특별자치도 제주시 내도동 580-1
31,내도동동마을,33.49309,126.44243,4353,289,4642,4309,280,4589,제주특별자치도 제주시 내도동 310-8
32,내도동동마을,33.49324,126.44242,2237,79,2316,2199,76,2275,제주특별자치도 제주시 내도동 351-9
33,신산마을,33.493520000000004,126.44445,1891,151,2042,1865,136,2001,제주특별자치도 제주시 내도동 896
34,신산마을,33.493520000000004,126.44539,5668,427,6095,5616,394,6010,제주특별자치도 제주시 내도동 274-8
35,현사마을,33.4947,126.45023,141,25,166,137,25,162,제주특별자치도 제주시 이호일동 1905-8
36,현사마을,33.49473,126.44961,4690,1262,5952,4522,1229,5751,제주특별자치도 제주시 이호일동 1962
37,하귀초등학교,33.48022,126.40105,14511,802,15313,14350,779,15129,제주특별자치도 제주시 애월읍 하귀2리 3016
38,하귀우체국,33.48122,126.4045,17131,240,17371,16827,230,17057,제주특별자치도 제주시 애월읍 하귀2리 3016
39,하귀우체국,33.4813,126.40443,5000,273,5273,4939,267,5206,제주특별자치도 제주시 애월읍 하귀2리 3016
40,안남동,33.48238,126.40616,764,83,847,761,83,844,제주특별자치도 제주시 애월읍 하귀1리 3013
41,안남동,33.48251,126.40662,3631,106,3737,3595,103,3698,제주특별자치도 제주시 애월읍 하귀1리 1375
42,남주동,33.48368,126.40847,3717,166,3883,3657,153,3810,제주특별자치도 제주시 애월읍 하귀1리 1362-1
43,남주동,33.48405,126.40876000000002,3308,236,3544,3226,230,3456,제주특별자치도 제주시 애월읍 하귀1리 3013
44,하귀환승정류장(하귀하나로마트),33.48567,126.4121,10936,480,11416,10808,465,11273,제주특별자치도 제주시 애월읍 하귀1리 569-3
45,하귀환승정류장(하귀하나로마트),33.48578,126.41171,6012,358,6370,5925,342,6267,제주특별자치도 제주시 애월읍 하귀1리 492-19
46,큰구릉내,33.48655,126.41353,860,79,939,852,79,931,제주특별자치도 제주시 애월읍 하귀1리 477-2
47,학원동,33.47493,126.39766000000002,2116,19,2135,2101,17,2118,제주특별자치도 제주시 애월읍 하귀2리 3018
49,외도부영2차아파트,33.48488,126.43074,11427,55,11482,11264,54,11318,제주특별자치도 제주시 외도일동 644-6
50,외도부영2차아파트,33.48483,126.43098,15380,121,15501,15247,121,15368,제주특별자치도 제주시 외도일동 646-1
51,도평초등학교,33.48185,126.44562,5750,57,5807,5629,55,5684,제주특별자치도 제주시 도평동 1351-1
52,도평초등학교,33.48168,126.44555,3390,22,3412,3355,21,3376,제주특별자치도 제주시 도평동 1352-3
53,아름마을아파트,33.483979999999995,126.42908,5664,23,5687,5635,23,5658,제주특별자치도 제주시 외도일동 1587-2
54,아름마을아파트,33.48413,126.42834,979,1,980,975,1,976,제주특별자치도 제주시 외도일동 646-1
55,계명동,33.4855,126.4268,456,1,457,453,1,454,제주특별자치도 제주시 외도일동 646-1
56,계명동,33.48593,126.42662,3171,15,3186,3131,15,3146,제주특별자치도 제주시 외도일동 1609-1
57,한라주택,33.48807,126.4268,590,9,599,583,9,592,제주특별자치도 제주시 외도일동 646-1
58,계명동입구,33.48803,126.42665,3166,21,3187,3149,20,3169,제주특별자치도 제주시 외도일동 646-1
59,일우한란아파트,33.49251,126.43087,5860,74,5934,5778,69,5847,제주특별자치도 제주시 외도일동 646-1
60,일우한란아파트,33.4926,126.43102,12956,617,13573,12779,592,13371,제주특별자치도 제주시 외도일동 426-1
61,우령이마을,33.4885,126.4308,13211,39,13250,13079,39,13118,제주특별자치도 제주시 외도일동 498-9
62,우령마을입구,33.48846,126.43099,19186,209,19395,18995,202,19197,제주특별자치도 제주시 외도일동 646-1
63,외도부영1차아파트,33.48635,126.43097,23370,213,23583,23136,208,23344,제주특별자치도 제주시 외도일동 646-1
64,하귀리,33.47931,126.39564,20,4,24,19,4,23,제주특별자치도 제주시 애월읍 하귀2리 2424-7
65,연미마을회관,33.486540000000005,126.50489,337,2,339,336,2,338,제주특별자치도 제주시 오라이동 3044-3
66,연미마을회관,33.48665,126.5048,427,2,429,425,2,427,제주특별자치도 제주시 오라이동 3034-1
67,연미마을,33.486999999999995,126.50738,477,2,479,475,2,477,제주특별자치도 제주시 오라이동 1918-2
68,연미마을,33.48686,126.50709,440,13,453,437,12,449,제주특별자치도 제주시 오라이동 1946-1
69,연미입구,33.48762,126.50838,460,4,464,460,4,464,제주특별자치도 제주시 오라이동 1843-2
70,연미입구,33.48772,126.50846,421,2,423,416,2,418,제주특별자치도 제주시 오라이동 3827-6
72,오라초등학교,33.48916,126.5125,3061,5,3066,3033,5,3038,제주특별자치도 제주시 오라이동 1373-3
73,제주시보건소,33.49129,126.51937,909,10,919,907,10,917,제주특별자치도 제주시 오라일동 1044-12
74,보건소,33.49108,126.51957,2731,35,2766,2715,33,2748,제주특별자치도 제주시 도남동 1039-3
75,오라1동,33.49225,126.5173,4113,42,4155,4085,40,4125,제주특별자치도 제주시 오라일동 1042-6
76,오라1동,33.49263,126.51622,4031,39,4070,3997,36,4033,제주특별자치도 제주시 오라일동 1001-9
77,사평마을,33.49287,126.51245,6226,89,6315,6189,85,6274,제주특별자치도 제주시 오라이동 1209-4
78,사평마을,33.49257,126.51322,10273,67,10340,10218,66,10284,제주특별자치도 제주시 오라이동 1212-1
79,동성마을입구,33.4932,126.50753,2663,111,2774,2624,104,2728,제주특별자치도 제주시 오라삼동 2138-1
80,연미마을입구,33.49298,126.5075,3409,87,3496,3378,83,3461,제주특별자치도 제주시 오라삼동 2107-3
83,수산리사무소앞,33.46794000000001,126.39339,3437,81,3518,3387,79,3466,제주특별자치도 제주시 애월읍 수산리 506-7
84,수산리사무소앞,33.46765,126.39337,11029,238,11267,10876,228,11104,제주특별자치도 제주시 애월읍 수산리 463-12
85,수산리사무소,33.46954,126.39457,1096,19,1115,1085,19,1104,제주특별자치도 제주시 애월읍 수산리 531-1
86,수산리,33.46995,126.39454,84,3,87,83,3,86,제주특별자치도 제주시 애월읍 수산리 550-1
87,세기아파트,33.49335,126.5015,6802,135,6937,6762,131,6893,제주특별자치도 제주시 오라삼동 2724-2
88,세기아파트,33.493559999999995,126.50055,1574,38,1612,1559,34,1593,제주특별자치도 제주시 오라삼동 2728-2
89,신광사거리,33.49365,126.49318,3024,695,3719,2947,648,3595,제주특별자치도 제주시 연동 305-3
90,신성마을,33.49367,126.48916,5713,509,6222,5650,478,6128,제주특별자치도 제주시 연동 2335-4
91,신성마을,33.49383,126.48852,6711,1261,7972,6483,1167,7650,제주특별자치도 제주시 연동 1941-1
92,제성마을,33.49361,126.4854,5101,231,5332,5051,218,5269,제주특별자치도 제주시 연동 2335-4
93,제성마을,33.49374,126.48403,5659,724,6383,5448,668,6116,제주특별자치도 제주시 연동 2419-3
94,제주서중학교,33.49351,126.48168,1699,75,1774,1672,72,1744,제주특별자치도 제주시 연동 2395-1
95,제주서중학교,33.49367,126.48135,3555,172,3727,3448,166,3614,제주특별자치도 제주시 연동 2412-1
96,제주민속오일장,33.493759999999995,126.4767,27518,2002,29520,26960,1904,28864,제주특별자치도 제주시 노형동 1142-3
97,제주민속오일장,33.493520000000004,126.47763,27062,1162,28224,26661,1117,27778,제주특별자치도 제주시 노형동 1297-1
98,제주민속오일장입구,33.493759999999995,126.47495,706,138,844,694,137,831,제주특별자치도 제주시 노형동 1141-3
99,월랑로입구,33.49368,126.47213,5314,444,5758,5248,428,5676,제주특별자치도 제주시 도두일동 2270-2
100,월랑입구,33.49395,126.47156,6639,326,6965,6516,316,6832,제주특별자치도 제주시 도두일동 2270-3
107,수선화아파트,33.48923,126.52984,7900,40,7940,7855,40,7895,제주특별자치도 제주시 도남동 91-3
108,제주연안여객터미널,33.51898,126.53552,232,118,350,226,113,339,제주특별자치도 제주시 건입동 918-13
109,제주연안여객터미널,33.51915,126.53535,2620,621,3241,2594,579,3173,제주특별자치도 제주시 건입동 918-54
110,산지변전소,33.51713,126.53268,955,78,1033,935,76,1011,제주특별자치도 제주시 건입동 984-4
111,산지변전소,33.51692,126.53261,182,28,210,179,28,207,제주특별자치도 제주시 건입동 984-118
112,종합어시장,33.5164,126.52793,1073,292,1365,1036,277,1313,제주특별자치도 제주시 건입동 1429
113,탑동푸른쉼터,33.51656,126.52711,7162,758,7920,7013,715,7728,제주특별자치도 제주시 건입동 1388-18
114,탑동입구,33.51531,126.52467,6894,204,7098,6804,195,6999,제주특별자치도 제주시 일도일동 1279-9
115,탑동입구,33.51585,126.52483,845,293,1138,818,273,1091,제주특별자치도 제주시 일도일동 1278-11
116,남국사,33.46215,126.54958,1120,138,1258,1084,132,1216,제주특별자치도 제주시 아라일동 1918-9
117,남국사,33.46049,126.54979,171,26,197,165,25,190,제주특별자치도 제주시 아라일동 499-7
118,웃인다마을,33.464459999999995,126.54925,650,40,690,634,40,674,제주특별자치도 제주시 아라일동 628-2
119,죽성마을입구,33.46313,126.5491,510,25,535,497,25,522,제주특별자치도 제주시 아라일동 1918-13
120,제주대학교병원,33.469159999999995,126.54777,53554,780,54334,53040,759,53799,제주특별자치도 제주시 아라일동 1801-4
121,제주대학교병원,33.46909,126.54739,22954,453,23407,22538,441,22979,제주특별자치도 제주시 아라일동 1803-8
122,인다마을,33.47064,126.54582,36114,435,36549,35678,423,36101,제주특별자치도 제주시 아라일동 6174
123,인다마을,33.47145,126.5454,10026,172,10198,9903,169,10072,제주특별자치도 제주시 아라일동 6174
124,아라주공아파트,33.47308,126.54569,74238,840,75078,73422,800,74222,제주특별자치도 제주시 아라일동 6174
125,아라주공아파트,33.473659999999995,126.54542,14311,277,14588,14112,269,14381,제주특별자치도 제주시 아라일동 6092-7
126,케이티앤지,33.48207,126.48535,19052,323,19375,18832,316,19148,제주특별자치도 제주시 노형동 767
127,종합사격장,33.44028,126.56753,243,22,265,242,22,264,제주특별자치도 제주시 영평동 산 8-24
128,종합사격장,33.44183,126.56625,79,3,82,75,3,78,제주특별자치도 제주시 아라일동 3-44
129,제주의료원,33.44571,126.55843,5629,143,5772,5571,136,5707,제주특별자치도 제주시 아라일동 4-121
130,제주의료원,33.44567,126.55816000000002,1447,61,1508,1415,57,1472,제주특별자치도 제주시 아라일동 2986-1
131,아라동주민센터,33.4759,126.5449,44171,574,44745,43562,557,44119,제주특별자치도 제주시 아라일동 6174
132,아라초등학교,33.47653,126.54428,11883,214,12097,11645,211,11856,제주특별자치도 제주시 아라일동 6174
135,산천단,33.44786,126.55539,8238,668,8906,8119,639,8758,제주특별자치도 제주시 아라일동 371-4
136,산천단한국폴리텍대학,33.447990000000004,126.55558,24595,525,25120,24167,522,24689,제주특별자치도 제주시 아라일동 370-10
137,사회복지법인춘강,33.45265,126.55125,28,5,33,28,5,33,제주특별자치도 제주시 아라일동 2995-25
138,사회복지법인춘강,33.45264,126.55164,1466,38,1504,1453,37,1490,제주특별자치도 제주시 아라일동 415-14
139,영주고등학교,33.457190000000004,126.57786000000002,13325,76,13401,12821,73,12894,제주특별자치도 제주시 월평동 1378-1
140,영주고등학교,33.45712,126.57775,2488,69,2557,2434,69,2503,제주특별자치도 제주시 월평동 651-73
141,정부제주지방합동청사,33.49205,126.52738,21493,135,21628,21353,131,21484,제주특별자치도 제주시 도남동 91-2
142,정부제주지방합동청사,33.4923,126.5266,22383,213,22596,22244,207,22451,제주특별자치도 제주시 도남동 91-2
143,양지(추모)공원,33.43865,126.57652,683,37,720,650,34,684,제주특별자치도 제주시 영평동 2255-2
144,양지(추모)공원,33.43848,126.5764,159,23,182,150,23,173,제주특별자치도 제주시 영평동 2255-5
145,제주국제대학교,33.43863,126.56944,2771,214,2985,2705,207,2912,제주특별자치도 제주시 영평동 산 8-10
146,제주국제대학교,33.43842,126.56936,1857,139,1996,1847,135,1982,제주특별자치도 제주시 영평동 산 8-6
147,용천마을,33.49991,126.52135,19164,1322,20486,19036,1250,20286,제주특별자치도 제주시 삼도일동 585-35
148,남서광마을입구,33.49968,126.52126,44728,2133,46861,44363,2017,46380,제주특별자치도 제주시 삼도일동 585-35
149,제주버스터미널,33.49993,126.51486,112199,11887,124086,109996,11231,121227,제주특별자치도 제주시 오라일동 2455-2
150,제주버스터미널,33.5002,126.51471,55708,7830,63538,54706,7454,62160,제주특별자치도 제주시 용담일동 2830-6
151,한국병원,33.499790000000004,126.51769,42711,5048,47759,41989,4775,46764,제주특별자치도 제주시 삼도일동 585-35
152,한국병원,33.50005,126.51807,18924,851,19775,18792,813,19605,제주특별자치도 제주시 삼도일동 585-35
153,중앙마을,33.50163,126.5197,1004,24,1028,994,24,1018,제주특별자치도 제주시 삼도일동 533-6
154,용천마을,33.50155,126.51995,2752,275,3027,2723,269,2992,제주특별자치도 제주시 삼도일동 585-13
155,삼도1동주민센터,33.50318,126.51971,1997,27,2024,1985,27,2012,제주특별자치도 제주시 삼도일동 531-14
157,보건소,33.49238,126.52088,8133,115,8248,8056,109,8165,제주특별자치도 제주시 도남동 1035-1
158,보건소,33.49212,126.52207,11183,62,11245,11086,60,11146,제주특별자치도 제주시 도남동 792-4
164,광양사거리,33.50047,126.5271,44200,2896,47096,43657,2767,46424,제주특별자치도 제주시 이도일동 1775-21
165,탐라장애인종합복지관,33.50023,126.52563,10041,304,10345,9949,296,10245,제주특별자치도 제주시 이도일동 1938
166,탐라장애인종합복지관,33.50002,126.52583,41760,1587,43347,41252,1532,42784,제주특별자치도 제주시 이도이동 1781-9
167,홍랑로입구,33.499970000000005,126.52387,15564,654,16218,15459,633,16092,제주특별자치도 제주시 삼도일동 585-35
168,남서광마을,33.499790000000004,126.52376,26464,561,27025,26320,542,26862,제주특별자치도 제주시 삼도일동 585-35
169,동성마을,33.50005,126.51103,5906,265,6171,5859,260,6119,제주특별자치도 제주시 오라이동 2424-7
170,동산교,33.50028,126.51027,13264,2047,15311,13110,1965,15075,제주특별자치도 제주시 용담이동 2637-7
171,월구마을,33.50013,126.507,6584,831,7415,6490,814,7304,제주특별자치도 제주시 오라삼동 2341-3
172,오라3동,33.49925,126.50318,7116,304,7420,7045,300,7345,제주특별자치도 제주시 오라삼동 2574-1
173,명신마을,33.49962,126.50303,5529,494,6023,5420,482,5902,제주특별자치도 제주시 용담이동 2775
174,명주주택,33.49579,126.49349,1742,860,2602,1680,835,2515,제주특별자치도 제주시 용담이동 1815
175,명주주택,33.495670000000004,126.49376,886,309,1195,859,285,1144,제주특별자치도 제주시 연동 2514-1
176,문서교,33.52815,126.61419,428,20,448,425,20,445,제주특별자치도 제주시 조천읍 신촌리 2793
177,문서교,33.527770000000004,126.61328,2176,50,2226,2160,48,2208,제주특별자치도 제주시 조천읍 신촌리 3170-2
178,진드르,33.5242,126.60813,37,5,42,37,5,42,제주특별자치도 제주시 조천읍 신촌리 3096-10
179,진드르,33.52367,126.60692,233,6,239,232,6,238,제주특별자치도 제주시 조천읍 신촌리 4005
180,삼양검문소,33.52095,126.60085,104,11,115,102,10,112,제주특별자치도 제주시 조천읍 신촌리 3901-3
181,삼양검문소,33.52102,126.60003,407,18,425,405,17,422,제주특별자치도 제주시 삼양일동 604-2
184,제원아파트,33.48845,126.49013,13492,657,14149,13171,620,13791,제주특별자치도 제주시 연동 272
185,제원아파트,33.48753,126.48989,33491,2149,35640,32563,2015,34578,제주특별자치도 제주시 연동 262-5
186,은남동,33.485820000000004,126.4909,48717,5664,54381,47602,5326,52928,제주특별자치도 제주시 연동 273
187,은남동,33.48588,126.49248,20611,1032,21643,20362,997,21359,제주특별자치도 제주시 연동 283
188,도호동,33.48566,126.49492,31471,2235,33706,31020,2111,33131,제주특별자치도 제주시 연동 293
189,도호동,33.48581,126.49501,19946,442,20388,19641,420,20061,제주특별자치도 제주시 연동 293
190,제주중앙중학교,33.48553,126.49938,1107,13,1120,1093,12,1105,제주특별자치도 제주시 연동 313
191,제주중앙중학교,33.485690000000005,126.5001,656,8,664,643,8,651,제주특별자치도 제주시 연동 323-14
192,함덕환승정류장(함덕해수욕장),33.54101,126.66913999999998,42076,9698,51774,40772,9057,49829,제주특별자치도 제주시 조천읍 함덕리 4143
193,함덕리(4구),33.53998,126.67323,6937,540,7477,6761,521,7282,제주특별자치도 제주시 조천읍 함덕리 286-6
195,함덕광명샤인빌앞,33.53823,126.67461000000002,7541,209,7750,7377,201,7578,제주특별자치도 제주시 조천읍 함덕리 4171
196,신사동,33.53483,126.67575,10863,172,11035,10718,168,10886,제주특별자치도 제주시 조천읍 함덕리 72-5
197,신사동,33.534659999999995,126.6756,200,4,204,200,4,204,제주특별자치도 제주시 조천읍 함덕리 72-60
198,함덕환승정류장(함덕해수욕장),33.54101,126.66877,20820,4467,25287,20304,4263,24567,제주특별자치도 제주시 조천읍 함덕리 1002-73
199,제주모자원입구,33.46286,126.56644,1217,61,1278,1197,57,1254,제주특별자치도 제주시 영평동 2796
200,제주대학교,33.45989,126.56162,39652,1182,40834,39144,1127,40271,제주특별자치도 제주시 아라일동 1
201,제주대학교,33.46011,126.56166,154142,2093,156235,151976,2027,154003,제주특별자치도 제주시 아라이동 35-4
202,제대아파트,33.45878,126.55735,49,10,59,49,10,59,제주특별자치도 제주시 아라일동 349-5
203,제대아파트,33.4589,126.5573,5237,290,5527,5125,279,5404,제주특별자치도 제주시 아라일동 349-4
204,제대마을,33.45772,126.55401,127,8,135,126,8,134,제주특별자치도 제주시 아라일동 452-9
205,제대마을,33.45785,126.55394,3487,316,3803,3457,309,3766,제주특별자치도 제주시 아라일동 452-2
206,제주대학교입구,33.45627,126.55175,3541,184,3725,3522,179,3701,제주특별자치도 제주시 아라일동 428-2
207,제주대학교입구,33.456720000000004,126.55076,6837,436,7273,6749,425,7174,제주특별자치도 제주시 아라일동 426-11
208,서해아파트,33.504259999999995,126.54152,14781,77,14858,14653,74,14727,제주특별자치도 제주시 일도이동 414
209,서해아파트,33.50488,126.54153,14425,137,14562,14269,135,14404,제주특별자치도 제주시 일도이동 459
210,인화동,33.50888,126.53982,10155,185,10340,10078,178,10256,제주특별자치도 제주시 일도이동 432
211,인화동,33.50923,126.5394,4952,78,5030,4934,77,5011,제주특별자치도 제주시 일도이동 330-26
212,일도2동주민센터,33.51068,126.53906,4441,61,4502,4423,58,4481,제주특별자치도 제주시 일도이동 432
213,일도2동주민센터,33.5113,126.53853,6580,47,6627,6557,46,6603,제주특별자치도 제주시 일도이동 161-21
214,인화동입구,33.51272,126.53852,4853,59,4912,4836,59,4895,제주특별자치도 제주시 일도이동 421
215,인화동입구,33.51362,126.53827,2450,110,2560,2428,110,2538,제주특별자치도 제주시 일도이동 1050-1
216,제주해양경찰서,33.52042,126.5397,79,21,100,79,21,100,제주특별자치도 제주시 건입동 918-13
218,제4부두,33.52018,126.53818,1263,267,1530,1186,230,1416,제주특별자치도 제주시 건입동 918-13
219,원당분화원,33.52107,126.59493,536,14,550,523,14,537,제주특별자치도 제주시 삼양일동 1354-6
220,원당봉,33.52166,126.59325,2191,21,2212,2172,20,2192,제주특별자치도 제주시 삼양일동 1509-4
221,삼양초등학교,33.52112,126.58611,27785,829,28614,27358,788,28146,제주특별자치도 제주시 삼양이동 2186-1
222,삼양동주민센터,33.52128,126.58567,48438,1273,49711,47679,1207,48886,제주특별자치도 제주시 삼양이동 2186-1
223,삼양2동,33.52128,126.58236,26373,364,26737,26100,357,26457,제주특별자치도 제주시 삼양이동 2186-1
224,삼양2동,33.52118,126.58042,7007,100,7107,6899,94,6993,제주특별자치도 제주시 삼양이동 2186-1
225,조천리,33.535779999999995,126.6365,5849,148,5997,5710,139,5849,제주특별자치도 제주시 조천읍 조천리 2229-9
226,조천리,33.535779999999995,126.63625,14924,203,15127,14755,200,14955,제주특별자치도 제주시 조천읍 조천리 2385
228,조천리새마을공장,33.53497,126.63271,5678,145,5823,5601,142,5743,제주특별자치도 제주시 조천읍 조천리 3205-1
229,조천읍사무소,33.534859999999995,126.63217,1366,108,1474,1309,103,1412,제주특별자치도 제주시 조천읍 조천리 3231
230,대섬입구,33.53568,126.62565,1845,196,2041,1793,193,1986,제주특별자치도 제주시 조천읍 신촌리 541-4
231,대섬입구,33.53586,126.62604,2618,235,2853,2576,228,2804,제주특별자치도 제주시 조천읍 신촌리 529-17
232,신촌리,33.53463,126.62168,14578,214,14792,14415,207,14622,제주특별자치도 제주시 조천읍 신촌리 4005
233,신촌리,33.53439,126.62156,5172,161,5333,5075,158,5233,제주특별자치도 제주시 조천읍 신촌리 1791-3
234,신촌초등학교,33.53275,126.61877,22164,602,22766,21836,579,22415,제주특별자치도 제주시 조천읍 신촌리 4005
235,신촌초등학교,33.5323,126.61856,7722,272,7994,7520,260,7780,제주특별자치도 제주시 조천읍 신촌리 4005
236,명도암입구,33.48465,126.60386,13,4,17,13,2,15,제주특별자치도 제주시 봉개동 2736
237,명도암입구,33.48495,126.60411,92,13,105,90,12,102,제주특별자치도 제주시 봉개동 601-12
239,봉개동주민센터,33.49073,126.59445,11273,70,11343,11168,69,11237,제주특별자치도 제주시 봉개동 1829-3
240,화북주공아파트,33.52123,126.57589,8727,80,8807,8621,79,8700,제주특별자치도 제주시 화북일동 29-1
241,화북주공아파트,33.521209999999996,126.57471,27490,319,27809,27251,310,27561,제주특별자치도 제주시 화북일동 1265-4
242,화북주공아파트입구,33.51882,126.57271,2318,16,2334,2264,15,2279,제주특별자치도 제주시 화북일동 1221-13
243,화북주공아파트입구,33.51899,126.57295,8652,60,8712,8567,60,8627,제주특별자치도 제주시 화북일동 29-4
244,동화로입구,33.51312,126.57286,4990,31,5021,4887,31,4918,제주특별자치도 제주시 화북이동 826-7
245,동화로입구,33.5124,126.57312,78,3,81,78,1,79,제주특별자치도 제주시 화북이동 824-9
246,혜원정사,33.49038,126.60065,605,11,616,600,11,611,제주특별자치도 제주시 봉개동 1504-5
248,서회천,33.49855,126.60688,97,3,100,96,3,99,제주특별자치도 제주시 회천동 2939-2
249,서회천,33.49858,126.60673,1830,20,1850,1803,20,1823,제주특별자치도 제주시 회천동 2929-3
250,조천리상동,33.53522,126.6358,261,5,266,260,5,265,제주특별자치도 제주시 조천읍 조천리 2202-1
251,신설동,33.49788,126.54662,5709,61,5770,5676,58,5734,제주특별자치도 제주시 일도이동 115
252,신설동,33.49865,126.54843,4030,30,4060,4010,30,4040,제주특별자치도 제주시 일도이동 115
253,대림아파트,33.49962,126.55023,7681,72,7753,7632,72,7704,제주특별자치도 제주시 일도이동 115
254,대림아파트,33.49988,126.55038,11458,64,11522,11389,64,11453,제주특별자치도 제주시 일도이동 115
255,대유대림아파트,33.50245,126.55272,12358,78,12436,12308,77,12385,제주특별자치도 제주시 일도이동 91-1
256,대유대림아파트,33.5024,126.5526,12671,53,12724,12583,52,12635,제주특별자치도 제주시 일도이동 91-1
257,신천동,33.50393,126.54959,6711,83,6794,6670,82,6752,제주특별자치도 제주시 일도이동 115-13
258,신천동,33.50343,126.54907,5461,27,5488,5438,27,5465,제주특별자치도 제주시 일도이동 115-13
259,동광초등학교,33.5017,126.54576000000002,3480,30,3510,3444,30,3474,제주특별자치도 제주시 일도이동 115
260,동광초등학교,33.5014,126.54475,5884,158,6042,5836,146,5982,제주특별자치도 제주시 일도이동 115
261,연수마을,33.50163,126.54336,8384,84,8468,8302,83,8385,제주특별자치도 제주시 일도이동 115
262,제주학생문화원,33.5015,126.54317,6221,39,6260,6171,37,6208,제주특별자치도 제주시 이도이동 443
263,회천입구,33.489000000000004,126.5984,14932,334,15266,14764,322,15086,제주특별자치도 제주시 봉개동 2736
264,봉개큰동네,33.48935,126.59881,72,4,76,72,4,76,제주특별자치도 제주시 봉개동 1585-5
265,화북동마을,33.52352,126.56751,1071,5,1076,1068,5,1073,제주특별자치도 제주시 화북일동 1995-7
266,화북중마을,33.52333,126.56472,1398,3,1401,1389,3,1392,제주특별자치도 제주시 화북일동 1995-3
267,화북서마을,33.522870000000005,126.56287,2137,3,2140,2126,3,2129,제주특별자치도 제주시 화북일동 1995
268,화북남문,33.5189,126.56512,67653,509,68162,67082,495,67577,제주특별자치도 제주시 화북일동 1995-5
269,삼성초등학교,33.5041,126.52664,24121,711,24832,23933,687,24620,제주특별자치도 제주시 이도일동 1938
270,보성시장,33.50342,126.52726,23733,1250,24983,23559,1197,24756,제주특별자치도 제주시 이도일동 1938
271,광양,33.502320000000005,126.52806,25331,721,26052,25099,702,25801,제주특별자치도 제주시 이도일동 1938
272,광양,33.502109999999995,126.52796,27691,272,27963,27572,266,27838,제주특별자치도 제주시 이도일동 1789-3
273,동광양,33.50202,126.5322,58749,3519,62268,57820,3381,61201,제주특별자치도 제주시 이도이동 1174-26
274,동광양,33.5022,126.53222,29711,1758,31469,29441,1687,31128,제주특별자치도 제주시 이도일동 1938
275,문예회관,33.504490000000004,126.53703,17586,842,18428,17367,818,18185,제주특별자치도 제주시 이도이동 326
276,문예회관,33.50463,126.53691,26665,592,27257,26445,577,27022,제주특별자치도 제주시 일도이동 449
277,인화초등학교,33.50602,126.53888,32022,321,32343,31789,310,32099,제주특별자치도 제주시 일도이동 449
278,인화초등학교,33.50668,126.53937,60638,703,61341,59992,681,60673,제주특별자치도 제주시 일도이동 449
279,동문로터리(동문시장),33.51315,126.52706,66596,13712,80308,64707,12998,77705,제주특별자치도 제주시 일도일동 1478-9
280,동문로터리(동문시장),33.512950000000004,126.52795,97255,4594,101849,95998,4423,100421,제주특별자치도 제주시 일도일동 1491-1
281,중앙로(중앙성당),33.512,126.52447,22361,2037,24398,22023,1960,23983,제주특별자치도 제주시 이도일동 1369-1
282,중앙로(동문시장),33.51168,126.52457,31916,1150,33066,31717,1113,32830,제주특별자치도 제주시 이도일동 1410-3
283,중앙로(현대약국),33.51089,126.52421,54839,5487,60326,54094,5213,59307,제주특별자치도 제주시 이도일동 1471-3
284,중앙로(국민은행),33.51073,126.5239,91095,2272,93367,89887,2187,92074,제주특별자치도 제주시 이도일동 1466-1
285,시민회관,33.50733,126.5247,32640,1003,33643,32330,977,33307,제주특별자치도 제주시 이도일동 1938
286,시민회관,33.5071,126.52455,42192,458,42650,41752,450,42202,제주특별자치도 제주시 삼도이동 231-3
288,명도암마을회관,33.47099,126.61086,1210,1,1211,1205,1,1206,제주특별자치도 제주시 봉개동 418-1
291,천수동,33.50847,126.5419,55770,2144,57914,55001,2083,57084,제주특별자치도 제주시 일도이동 449
292,천수동,33.50934,126.54257,42726,1285,44011,42345,1229,43574,제주특별자치도 제주시 일도이동 449
293,국립제주박물관,33.51248,126.54997,10568,554,11122,10422,528,10950,제주특별자치도 제주시 건입동 1427-5
294,고으니모르국립제주박물관,33.512609999999995,126.55096,10193,1804,11997,9975,1737,11712,제주특별자치도 제주시 화북이동 4947-3
295,거로남쪽입구,33.50493,126.5613,578,3,581,572,3,575,제주특별자치도 제주시 화북이동 3254-2
296,거로남쪽입구,33.50495,126.56168999999998,567,8,575,562,8,570,제주특별자치도 제주시 화북이동 3254-1
297,부록마을,33.50136,126.56927,290,11,301,288,11,299,제주특별자치도 제주시 화북이동 2780-4
298,부록마을,33.50185,126.56875,1821,44,1865,1804,44,1848,제주특별자치도 제주시 화북이동 2650-3
299,화물청사입구,33.50418,126.50448,1475,499,1974,1457,475,1932,제주특별자치도 제주시 용담이동 746-3
300,용문마을회관,33.50495,126.50765,8927,415,9342,8805,396,9201,제주특별자치도 제주시 용담이동 2813-1
301,용문마을회관,33.50565,126.50825,8231,1128,9359,8112,1084,9196,제주특별자치도 제주시 용담이동 674-3
302,용문마을,33.507259999999995,126.50936000000002,11970,401,12371,11865,395,12260,제주특별자치도 제주시 용담이동 2681-47
303,용문마을,33.50765,126.50941,4176,477,4653,4127,469,4596,제주특별자치도 제주시 용담이동 2580-42
304,용문사거리,33.50866,126.51023,36586,1089,37675,36199,1042,37241,제주특별자치도 제주시 용담이동 2679-7
305,용문사거리,33.50881,126.51005,27509,1895,29404,27210,1825,29035,제주특별자치도 제주시 용담이동 641-29
306,용담1동주민센터,33.50973,126.51323,30445,644,31089,30190,619,30809,제주특별자치도 제주시 용담일동 2583
307,용담1동주민센터,33.50995,126.51333,18267,1899,20166,18022,1820,19842,제주특별자치도 제주시 용담일동 2579-1
308,제주중학교/제주향교,33.51078,126.5157,15050,750,15800,14811,728,15539,제주특별자치도 제주시 용담일동 288-1
309,사라봉오거리,33.51367,126.54045,1868,57,1925,1852,56,1908,제주특별자치도 제주시 일도이동 421
310,제주여자상업고등학교,33.51383,126.53696,21485,188,21673,21247,179,21426,제주특별자치도 제주시 일도이동 981-43
311,제주여자상업고등학교,33.51393,126.53652,54349,1226,55575,53888,1202,55090,제주특별자치도 제주시 건입동 1047-1
312,제주동초등학교,33.51328,126.5328,19095,309,19404,18895,297,19192,제주특별자치도 제주시 일도이동 1050-1
313,제주동초등학교,33.51332,126.53221,30960,610,31570,30793,595,31388,제주특별자치도 제주시 건입동 1109-10
314,사라봉,33.51294,126.54435,3169,146,3315,3151,139,3290,제주특별자치도 제주시 건입동 1427-5
315,사라봉,33.51316,126.54285,5277,53,5330,5238,52,5290,제주특별자치도 제주시 일도이동 421
316,사라봉오거리,33.51353,126.54158,10333,497,10830,10256,480,10736,제주특별자치도 제주시 건입동 711
317,신제주초등학교,33.4843,126.49648,1954,115,2069,1946,111,2057,제주특별자치도 제주시 연동 304
318,연동주민센터,33.48815,126.49636,21013,729,21742,20680,698,21378,제주특별자치도 제주시 연동 302
319,연동주민센터,33.48731,126.49662,50002,2510,52512,49561,2430,51991,제주특별자치도 제주시 연동 303
320,제주도청신제주로터리,33.49143,126.49678,93702,8978,102680,92859,8669,101528,제주특별자치도 제주시 연동 301
321,제주도청신제주로터리,33.4911,126.49647,62807,5204,68011,62143,5037,67180,제주특별자치도 제주시 연동 301
322,서문시장,33.511759999999995,126.51767,18223,2647,20870,17978,2553,20531,제주특별자치도 제주시 용담일동 2579-1
323,서문시장,33.51203,126.51845,25272,1209,26481,24924,1170,26094,제주특별자치도 제주시 용담일동 124-6
324,관덕정,33.51293,126.52096,27423,2368,29791,27114,2290,29404,제주특별자치도 제주시 삼도이동 955-3
325,관덕정,33.513220000000004,126.52088,45177,7798,52975,44331,7427,51758,제주특별자치도 제주시 삼도이동 995-1
326,농협지역본부,33.508070000000004,126.52006000000002,1333,91,1424,1328,90,1418,제주특별자치도 제주시 삼도이동 1230-4
327,농협지역본부,33.50772,126.51982,6425,325,6750,6400,320,6720,제주특별자치도 제주시 삼도일동 794-1
328,제주중앙여자중학교,33.50553,126.51976,6374,63,6437,6347,59,6406,제주특별자치도 제주시 삼도일동 787-25
329,제주중앙여자중학교,33.50493,126.51998,2382,41,2423,2371,33,2404,제주특별자치도 제주시 삼도이동 1230-4
330,수선화아파트,33.48892,126.52982,4502,20,4522,4476,19,4495,제주특별자치도 제주시 도남동 97-1
331,이도주공아파트,33.4902,126.53399,2481,18,2499,2457,18,2475,제주특별자치도 제주시 이도이동 747
332,이도주공아파트,33.49053,126.53418,5497,19,5516,5430,19,5449,제주특별자치도 제주시 이도이동 777
333,남광로입구,33.49251,126.53747,4090,27,4117,4058,27,4085,제주특별자치도 제주시 이도이동 1994-7
334,남광초등학교,33.49293,126.53768,3569,13,3582,3529,13,3542,제주특별자치도 제주시 이도이동 1084-6
335,제주제일중학교,33.49385,126.53937,2526,11,2537,2491,10,2501,제주특별자치도 제주시 이도이동 538-18
336,제주제일중학교,33.4942,126.53968,4187,41,4228,4105,41,4146,제주특별자치도 제주시 이도이동 538-18
337,혜성무지개타운,33.4954,126.54178,4866,30,4896,4845,29,4874,제주특별자치도 제주시 이도이동 443
338,혜성무지개타운,33.49551,126.54236000000002,2717,14,2731,2677,14,2691,제주특별자치도 제주시 이도이동 443
339,이도근린공원,33.49708,126.54507,3532,36,3568,3506,36,3542,제주특별자치도 제주시 이도이동 443
340,한마음근린공원,33.497040000000005,126.54538,2457,19,2476,2438,19,2457,제주특별자치도 제주시 이도이동 443
341,삼무공원,33.48997,126.49127,9739,1004,10743,9553,961,10514,제주특별자치도 제주시 연동 271
342,삼무공원,33.4898,126.4924,11481,4138,15619,10926,3850,14776,제주특별자치도 제주시 연동 281
343,제주썬호텔,33.48972,126.4937,27,163,190,27,163,190,제주특별자치도 제주시 연동 291
344,제주썬호텔,33.4899,126.49373,1221,2178,3399,1221,2178,3399,제주특별자치도 제주시 연동 291
345,수협제주도지회,33.48987,126.49503,7524,537,8061,7388,501,7889,제주특별자치도 제주시 연동 291
346,수협제주도지회,33.4897,126.49522,3878,1151,5029,3776,1074,4850,제주특별자치도 제주시 연동 291
347,이호동동마을,33.5004,126.46154,1940,142,2082,1908,132,2040,제주특별자치도 제주시 이호일동 613-6
348,이호동동마을,33.5003,126.46095,1104,45,1149,1097,43,1140,제주특별자치도 제주시 이호일동 1961
349,이호동주민센터,33.49905,126.45878,3257,317,3574,3213,308,3521,제주특별자치도 제주시 이호일동 647-1
350,이호동주민센터,33.49877,126.45827,1464,48,1512,1455,48,1503,제주특별자치도 제주시 이호일동 1961
351,이호테우해수욕장,33.49623,126.45546000000002,2543,942,3485,2445,905,3350,제주특별자치도 제주시 이호일동 1962
352,이호테우해수욕장,33.496320000000004,126.45539,217,32,249,205,30,235,제주특별자치도 제주시 이호일동 1600-18
353,월랑초등학교,33.49265,126.4791,10441,173,10614,10340,170,10510,제주특별자치도 제주시 노형동 1085
354,월랑초등학교,33.49253,126.47925,7072,45,7117,6903,44,6947,제주특별자치도 제주시 연동 2335-1
355,남녕마트,33.48993,126.48185,9393,492,9885,9204,469,9673,제주특별자치도 제주시 연동 2335-1
356,남녕마트,33.4897,126.48186,8918,267,9185,8777,258,9035,제주특별자치도 제주시 노형동 1273-6
357,한라병원,33.48944,126.48508,136315,5587,141902,133894,5357,139251,제주특별자치도 제주시 연동 2335-4
358,한라병원,33.48963,126.486,119199,5206,124405,117568,4939,122507,제주특별자치도 제주시 연동 251-66
359,노형오거리,33.48666,126.48057,37658,1054,38712,36938,998,37936,제주특별자치도 제주시 노형동 1297-5
360,노형오거리,33.486670000000004,126.48092,78292,2581,80873,77155,2444,79599,제주특별자치도 제주시 노형동 948
361,남녕고등학교,33.488040000000005,126.48311,32801,3065,35866,32172,2861,35033,제주특별자치도 제주시 노형동 948
362,월랑마을남녕고등학교,33.4877,126.48219,27072,2211,29283,26467,2089,28556,제주특별자치도 제주시 노형동 1297-3
363,신안동,33.51957,126.63523,95,5,100,93,5,98,제주특별자치도 제주시 조천읍 조천리 1937-5
364,신안동,33.51912,126.63493,6,3,9,6,3,9,제주특별자치도 제주시 조천읍 조천리 3437-3
367,대기고등학교,33.49168,126.59361,12516,45,12561,12297,41,12338,제주특별자치도 제주시 봉개동 1812-1
368,대기고등학교,33.49205,126.59353,1924,2,1926,1886,2,1888,제주특별자치도 제주시 봉개동 1795-3
370,아르미아파트,33.49604,126.59447,3121,8,3129,3100,8,3108,제주특별자치도 제주시 도련일동 1205-5
372,밤나무골,33.50202,126.59453,1084,5,1089,1083,5,1088,제주특별자치도 제주시 도련일동 1083-2
373,도련반석스위트타운,33.50666,126.59107,693,3,696,688,3,691,제주특별자치도 제주시 도련일동 1585-3
374,도련반석스위트타운,33.50666,126.59122,3443,18,3461,3415,18,3433,제주특별자치도 제주시 도련일동 1588-2
375,도련1동,33.50906,126.59003,17295,79,17374,17174,74,17248,제주특별자치도 제주시 도련일동 1731-14
376,도련1동,33.50932,126.58975,2420,15,2435,2402,14,2416,제주특별자치도 제주시 도련일동 1729-4
377,하나로아파트,33.51097,126.58918,436,1,437,435,1,436,제주특별자치도 제주시 도련일동 1767-2
378,하나로아파트,33.51098,126.58928,4929,17,4946,4865,16,4881,제주특별자치도 제주시 도련일동 1767-2
379,도련1동입구,33.51263,126.58896,920,2,922,913,2,915,제주특별자치도 제주시 도련이동 1819-7
380,도련2동,33.51288,126.58905,2050,24,2074,2012,24,2036,제주특별자치도 제주시 도련이동 1821-7
381,제주자동차검사소,33.51456,126.58898,5422,31,5453,5390,31,5421,제주특별자치도 제주시 도련이동 568-2
382,자동차검사소,33.51456,126.58883,164,1,165,161,1,162,제주특별자치도 제주시 도련이동 564-19
383,용담사거리,33.51093,126.51372,867,113,980,845,109,954,제주특별자치도 제주시 용담일동 309-14
384,용담사거리,33.51091,126.51387,2227,325,2552,2187,316,2503,제주특별자치도 제주시 용담일동 2579-1
385,용담새마을금고,33.5097,126.51488,1040,54,1094,1033,53,1086,제주특별자치도 제주시 용담일동 2583
386,용담새마을금고,33.50958,126.51526,269,11,280,268,11,279,제주특별자치도 제주시 용담일동 2583
387,병문교,33.50883,126.51831,186,13,199,185,13,198,제주특별자치도 제주시 삼도일동 1230
388,병문교,33.50897,126.51849,412,62,474,405,62,467,제주특별자치도 제주시 삼도일동 1230
389,서문로터리,33.51173,126.51932,1398,371,1769,1368,360,1728,제주특별자치도 제주시 용담일동 153-4
390,삼무공원사거리,33.49001,126.48853,18497,1012,19509,18166,971,19137,제주특별자치도 제주시 연동 260
391,삼무공원사거리,33.4899,126.48892,33331,3394,36725,32583,3120,35703,제주특별자치도 제주시 연동 260
392,월성마을회관,33.50202,126.50518,1425,315,1740,1415,306,1721,제주특별자치도 제주시 용담이동 2749-35
393,월성마을회관,33.502320000000005,126.50475,2737,80,2817,2710,76,2786,제주특별자치도 제주시 용담이동 2747-4
394,함덕리(3구),33.541709999999995,126.6666,10649,2109,12758,10199,2011,12210,제주특별자치도 제주시 조천읍 함덕리 1270-1
395,함덕리(3구),33.54176,126.66574,6545,1070,7615,6406,1019,7425,제주특별자치도 제주시 조천읍 함덕리 1268-7
396,함덕농협지소,33.542320000000004,126.66449,14504,1120,15624,14219,1067,15286,제주특별자치도 제주시 조천읍 함덕리 1252-47
397,함덕농협지소,33.54235,126.66417,2298,371,2669,2247,352,2599,제주특별자치도 제주시 조천읍 함덕리 4139
398,함덕비석거리,33.54315,126.66225,7378,1166,8544,7193,1072,8265,제주특별자치도 제주시 조천읍 함덕리 1016
399,함덕비석거리,33.543209999999995,126.66167,2479,580,3059,2392,546,2938,제주특별자치도 제주시 조천읍 함덕리 1047-1
400,해양연구소,33.54385,126.65773,5782,556,6338,5622,533,6155,제주특별자치도 제주시 조천읍 함덕리 3230-1
401,해양연구소,33.54375,126.65856,1688,358,2046,1634,348,1982,제주특별자치도 제주시 조천읍 함덕리 3039-2
402,신흥리(마을입구)함덕고등학교,33.5436,126.65364,12227,511,12738,11852,489,12341,제주특별자치도 제주시 조천읍 신흥리 230-1
403,신흥리(마을입구)함덕고등학교,33.54335,126.6534,3350,269,3619,3213,249,3462,제주특별자치도 제주시 조천읍 신흥리 235-2
404,충혼묘지,33.541920000000005,126.64983,536,43,579,525,40,565,제주특별자치도 제주시 조천읍 신흥리 346-1
405,충혼묘지,33.54157,126.6492,200,11,211,184,11,195,제주특별자치도 제주시 조천읍 조천리 3462
406,주암주택,33.54072,126.64567,1240,27,1267,1216,27,1243,제주특별자치도 제주시 조천읍 조천리 803-2
407,주암주택,33.54085,126.64543,2948,53,3001,2930,49,2979,제주특별자치도 제주시 조천읍 조천리 836-1
408,조천만세동산,33.53958,126.6417,5275,201,5476,5188,193,5381,제주특별자치도 제주시 조천읍 조천리 1205-2
409,조천체육관,33.54007,126.64273,1699,152,1851,1632,147,1779,제주특별자치도 제주시 조천읍 조천리 1198-3
410,조천환승정류장(조천리사무소),33.53826,126.6399,6409,329,6738,6229,311,6540,제주특별자치도 제주시 조천읍 조천리 1220-2
411,조천환승정류장(조천우체국),33.5377,126.63877,18056,657,18713,17840,635,18475,제주특별자치도 제주시 조천읍 조천리 2360-1
412,용담레포츠공원,33.51801,126.49992,986,177,1163,962,173,1135,제주특별자치도 제주시 용담삼동 1089-5
413,용담레포츠공원,33.51938,126.49945,135,42,177,133,41,174,제주특별자치도 제주시 용담삼동 1092-2
414,서해안로,33.51982,126.4937,326,119,445,311,118,429,제주특별자치도 제주시 용담삼동 2292-2
415,서해안로,33.51971,126.49375,1320,461,1781,1283,443,1726,제주특별자치도 제주시 용담삼동 2293-6
416,어영마을,33.519009999999994,126.49008,1268,258,1526,1243,245,1488,제주특별자치도 제주시 용담삼동 2580
417,어영마을,33.519009999999994,126.48947,427,52,479,419,50,469,제주특별자치도 제주시 용담삼동 2292-26
418,몰래물,33.51051,126.48283,520,176,696,504,168,672,제주특별자치도 제주시 도두이동 706-12
419,제주대학교교육대학,33.51312,126.553,3435,95,3530,3378,91,3469,제주특별자치도 제주시 화북이동 4948-1
420,제주대학교교육대학,33.5137,126.55388,14472,148,14620,14271,147,14418,제주특별자치도 제주시 화북일동 4810-1
421,거로입구,33.51464,126.55624,11321,117,11438,11212,115,11327,제주특별자치도 제주시 화북일동 5749
422,거로입구,33.51453,126.55653,6945,68,7013,6835,65,6900,제주특별자치도 제주시 화북일동 4701-5
423,오현중고등학교,33.51518,126.55707,32780,403,33183,31844,390,32234,제주특별자치도 제주시 화북일동 4668-5
424,오현중고등학교,33.515609999999995,126.55861000000002,12563,381,12944,12056,373,12429,제주특별자치도 제주시 화북일동 4723
425,화북초등학교,33.51762,126.56172,9429,153,9582,9225,145,9370,제주특별자치도 제주시 화북일동 3994-11
427,월산마을,33.47305,126.46346,12993,171,13164,12901,169,13070,제주특별자치도 제주시 노형동 3378-1
428,월산마을,33.47317,126.46305,5668,343,6011,5615,335,5950,제주특별자치도 제주시 노형동 3278-16
429,월산정수장입구,33.4784,126.46869,3241,367,3608,3186,351,3537,제주특별자치도 제주시 노형동 2267-9
430,월산정수장입구,33.47871,126.46893,2973,384,3357,2925,368,3293,제주특별자치도 제주시 노형동 3766
431,정존마을,33.481320000000004,126.4733,20904,1711,22615,20619,1650,22269,제주특별자치도 제주시 노형동 3815
432,정존마을,33.48181,126.47352,36036,1324,37360,35601,1299,36900,제주특별자치도 제주시 노형동 2617-2
433,노형초등학교,33.48353,126.47596,16264,380,16644,16083,363,16446,제주특별자치도 제주시 노형동 3815
434,노형초등학교,33.483709999999995,126.47578,8522,141,8663,8424,137,8561,제주특별자치도 제주시 노형동 2617-3
435,노형오거리,33.485209999999995,126.47796,14696,456,15152,14447,443,14890,제주특별자치도 제주시 노형동 1297-4
436,고성1리사무소,33.45805,126.41264,772,11,783,769,10,779,제주특별자치도 제주시 애월읍 고성리 1241-9
437,고성1리사무소,33.457840000000004,126.41286,259,150,409,242,147,389,제주특별자치도 제주시 애월읍 고성리 1241-4
438,고성1리종합운동장,33.45845,126.41517,1122,153,1275,1095,152,1247,제주특별자치도 제주시 애월읍 고성리 1556
439,고성1리종합운동장,33.45843,126.41561000000002,3289,259,3548,3186,253,3439,제주특별자치도 제주시 애월읍 고성리 443
440,광령3리,33.45893,126.42388,219,10,229,217,10,227,제주특별자치도 제주시 애월읍 광령리 3945-7
441,광령3리,33.45875,126.42445,599,18,617,588,18,606,제주특별자치도 제주시 애월읍 광령리 3944-1
442,으뜸마을,33.4791,126.48035,99,3,102,99,3,102,제주특별자치도 제주시 노형동 787
443,제주한라대학교,33.47833,126.47512,45798,1305,47103,44979,1252,46231,제주특별자치도 제주시 노형동 1518-1
444,탐라도서관,33.47756,126.47741,1655,39,1694,1628,39,1667,제주특별자치도 제주시 노형동 3812-2
445,제주한라대학교,33.47808,126.47516,16207,261,16468,15968,252,16220,제주특별자치도 제주시 노형동 1518-1
446,시티주유소,33.4764,126.47976,4879,75,4954,4819,74,4893,제주특별자치도 제주시 노형동 765
447,제주고등학교/중흥S클래스,33.47626,126.48141,73928,1616,75544,72743,1524,74267,제주특별자치도 제주시 노형동 765
448,중흥S클래스아파트,33.47639,126.48214,7902,282,8184,7784,272,8056,제주특별자치도 제주시 노형동 765
449,부영아파트,33.4769,126.48313,17334,354,17688,17092,346,17438,제주특별자치도 제주시 노형동 768
450,으뜸마을,33.477990000000005,126.48253,4628,238,4866,4565,224,4789,제주특별자치도 제주시 노형동 768
451,대학동,33.51305,126.50667,11287,240,11527,11194,232,11426,제주특별자치도 제주시 용담이동 592-4
452,대학동,33.513000000000005,126.5076,4349,104,4453,4313,98,4411,제주특별자치도 제주시 용담이동 594-1
453,사대부고,33.512570000000004,126.50997,9480,460,9940,9249,444,9693,제주특별자치도 제주시 용담이동 599-8
454,사대부고,33.51279,126.50945,6922,312,7234,6785,297,7082,제주특별자치도 제주시 용담삼동 581-12
455,광령초등학교,33.4607,126.43644,957,17,974,932,17,949,제주특별자치도 제주시 애월읍 광령리 1345-1
456,광령초등학교,33.46053,126.43615,3222,26,3248,3189,25,3214,제주특별자치도 제주시 애월읍 광령리 1227-1
457,광령1리사무소,33.46099,126.43976,920,10,930,912,10,922,제주특별자치도 제주시 애월읍 광령리 4227
458,광령1리사무소,33.46088,126.43989,4580,46,4626,4528,44,4572,제주특별자치도 제주시 애월읍 광령리 1276-2
459,제일빌리지,33.46083,126.44484,1330,40,1370,1326,40,1366,제주특별자치도 제주시 애월읍 광령리 30-3
460,제일빌리지,33.460679999999996,126.44484,5191,30,5221,5139,28,5167,제주특별자치도 제주시 애월읍 광령리 29-4
461,무수천,33.46106,126.44859,5374,261,5635,5305,251,5556,제주특별자치도 제주시 해안동 2382-4
462,무수천,33.46137,126.44867,2161,94,2255,2142,90,2232,제주특별자치도 제주시 해안동 2382-3
463,해안동입구,33.46276,126.45115,2930,172,3102,2892,167,3059,제주특별자치도 제주시 해안동 2350-4
464,제주고등학교,33.47221,126.48439,265,45,310,261,43,304,제주특별자치도 제주시 노형동 607-1
465,제주고등학교,33.47433,126.48392,7845,417,8262,7630,397,8027,제주특별자치도 제주시 노형동 768
466,화북남문,33.51858,126.56598,27984,253,28237,27715,245,27960,제주특별자치도 제주시 화북일동 2034-7
467,제주동중학교,33.52001,126.5723,41759,341,42100,41385,327,41712,제주특별자치도 제주시 화북일동 1235-5
468,제주동중학교,33.51958,126.57078,46685,942,47627,46214,916,47130,제주특별자치도 제주시 화북일동 1239-11
469,원동,33.39925,126.37917,338,66,404,330,63,393,제주특별자치도 제주시 애월읍 상가리 10-3
470,원동,33.40061,126.37917,125,36,161,122,35,157,제주특별자치도 제주시 애월읍 상가리 4-4
471,운전면허시험장,33.40595,126.38644,5635,201,5836,5523,193,5716,제주특별자치도 제주시 애월읍 소길리 산 210-14
472,운전면허시험장,33.40645,126.3862,3717,243,3960,3650,231,3881,제주특별자치도 제주시 애월읍 소길리 산 195-12
473,유수암상동,33.42269,126.40879,2773,187,2960,2731,178,2909,제주특별자치도 제주시 애월읍 유수암리 1082-1
474,유수암상동,33.42299000000001,126.40795,829,128,957,815,126,941,제주특별자치도 제주시 애월읍 유수암리 1028-3
475,한화아파트,33.47902,126.48308,1861,63,1924,1824,62,1886,제주특별자치도 제주시 노형동 767
476,한라중학교/부영아파트,33.47887,126.48383,19611,235,19846,19375,231,19606,제주특별자치도 제주시 노형동 767
477,한라초등학교,33.479,126.48629,1172,31,1203,1158,29,1187,제주특별자치도 제주시 노형동 767
478,대림2차아파트,33.479,126.488,1984,52,2036,1964,51,2015,제주특별자치도 제주시 연동 1399-1
479,대림2차아파트,33.47885,126.48835,15312,271,15583,15148,265,15413,제주특별자치도 제주시 연동 1546
480,연동대림1차아파트,33.48028,126.48975,4702,381,5083,4612,364,4976,제주특별자치도 제주시 연동 1546
481,연동대림1차아파트,33.4807,126.48993,29278,694,29972,29048,671,29719,제주특별자치도 제주시 연동 1546
482,신제주오피스텔,33.4832,126.48996,3220,451,3671,3187,424,3611,제주특별자치도 제주시 연동 334
483,신제주오피스텔,33.4833,126.48972,1242,126,1368,1215,122,1337,제주특별자치도 제주시 연동 268-5
484,신사수동,33.50874,126.47751,554,130,684,537,124,661,제주특별자치도 제주시 도두이동 1667-12
485,신사수동,33.50881,126.47713,244,54,298,232,49,281,제주특별자치도 제주시 도두이동 1669-4
486,해안로,33.50932,126.47231,403,200,603,388,193,581,제주특별자치도 제주시 도두일동 1734
487,해안로,33.50921,126.47241,1209,583,1792,1153,564,1717,제주특별자치도 제주시 도두일동 1687
488,오래물광장,33.50486,126.46722,4774,521,5295,4711,507,5218,제주특별자치도 제주시 도두일동 2605-7
489,오래물광장,33.50501,126.46718,743,143,886,715,140,855,제주특별자치도 제주시 도두일동 2605-5
490,도두동,33.50258,126.46656000000002,2171,228,2399,2135,217,2352,제주특별자치도 제주시 도두일동 2510-2
491,도리초등학교,33.50117,126.46618,4833,445,5278,4745,423,5168,제주특별자치도 제주시 이호일동 304-1
492,도리초등학교,33.50141,126.46585,1684,127,1811,1658,120,1778,제주특별자치도 제주시 이호일동 1961
494,해안,33.45857,126.45434,877,11,888,871,11,882,제주특별자치도 제주시 해안동 1970-1
496,해안동입구,33.463159999999995,126.453,13408,180,13588,13225,175,13400,제주특별자치도 제주시 해안동 2793-1
497,제주아트리움,33.46559,126.45606,500,86,586,489,82,571,제주특별자치도 제주시 해안동 2793
498,제주아트리움,33.46613,126.45683,1049,54,1103,1024,53,1077,제주특별자치도 제주시 해안동 2170-4
499,제주제일고등학교,33.48055,126.48157,5297,148,5445,5192,138,5330,제주특별자치도 제주시 노형동 768
500,제주제일고등학교,33.48008,126.48197,13322,121,13443,13193,119,13312,제주특별자치도 제주시 노형동 768
501,한라수목원,33.469840000000005,126.48491,18317,3205,21522,17749,3009,20758,제주특별자치도 제주시 노형동 103-4
502,하귀반석,33.47768,126.40798999999998,146,1,147,145,1,146,제주특별자치도 제주시 애월읍 상귀리 354-1
503,히귀반석,33.47755,126.40786,382,1,383,380,1,381,제주특별자치도 제주시 애월읍 하귀2리 1286-1
504,광석동,33.47464,126.40904,267,4,271,267,4,271,제주특별자치도 제주시 애월읍 상귀리 283-3
505,광석동,33.47445,126.40888,340,5,345,337,5,342,제주특별자치도 제주시 애월읍 상귀리 382-1
506,상귀리,33.472,126.40919,500,5,505,495,5,500,제주특별자치도 제주시 애월읍 상귀리 106-2
507,상귀리,33.47202,126.40911,593,20,613,589,19,608,제주특별자치도 제주시 애월읍 상귀리 538-3
508,소앵동입구,33.46945,126.40829,247,2,249,247,2,249,제주특별자치도 제주시 애월읍 상귀리 556-1
509,소앵동입구,33.46927,126.4081,152,5,157,151,5,156,제주특별자치도 제주시 애월읍 상귀리 567-2
510,보로미마을,33.46545,126.40911,2254,11,2265,2220,11,2231,제주특별자치도 제주시 애월읍 상귀리 679-3
511,보로미마을,33.46545,126.40936,2228,3,2231,2205,3,2208,제주특별자치도 제주시 애월읍 고성리 1579
512,평화로광령1리입구,33.4558,126.44179,395,45,440,385,44,429,제주특별자치도 제주시 애월읍 광령리 103-1
513,평화로광령1리입구,33.455659999999995,126.44279,5081,105,5186,4970,98,5068,제주특별자치도 제주시 애월읍 광령리 108-4
514,해병대아파트입구,33.48045,126.4971,57,5,62,57,5,62,제주특별자치도 제주시 연동 524-6
515,해병대아파트입구,33.48036,126.4973,241,12,253,238,12,250,제주특별자치도 제주시 연동 524-5
516,월정사,33.46778,126.51052,819,5,824,768,5,773,제주특별자치도 제주시 오라이동 664-9
518,정실마을,33.46918,126.50971,1017,8,1025,1015,8,1023,제주특별자치도 제주시 오라이동 696-18
519,정실,33.46962,126.50967,2087,23,2110,2064,23,2087,제주특별자치도 제주시 오라이동 707-4
520,오름가름,33.47165,126.50787,371,1,372,369,1,370,제주특별자치도 제주시 오라이동 744-2
521,오름가름,33.47169,126.50816,1414,19,1433,1407,18,1425,제주특별자치도 제주시 오라이동 739-3
522,새가름,33.47325,126.50414,733,3,736,732,3,735,제주특별자치도 제주시 오라이동 3295-3
523,새가름,33.47347,126.50397,1764,11,1775,1756,11,1767,제주특별자치도 제주시 오라이동 3295-1
524,예비군훈련장,33.47517,126.50167,173,3,176,171,3,174,제주특별자치도 제주시 연동 584-2
525,예비군훈련장,33.47535,126.5017,361,10,371,360,10,370,제주특별자치도 제주시 연동 2477-36
526,대원오등동입구,33.47762,126.54291,29,1,30,28,1,29,제주특별자치도 제주시 아라일동 2999
528,대원마을,33.4765,126.5345,875,6,881,873,6,879,제주특별자치도 제주시 아라일동 2738-9
529,대원마을,33.476440000000004,126.53474,3490,30,3520,3386,30,3416,제주특별자치도 제주시 아라일동 2745-5
530,장구마을,33.47637,126.53248,179,1,180,179,1,180,제주특별자치도 제주시 아라일동 2905-5
531,장구마을,33.47531,126.53203,428,5,433,422,5,427,제주특별자치도 제주시 아라일동 2894-4
532,오등동,33.47527,126.5298,300,3,303,299,3,302,제주특별자치도 제주시 오등동 604-2
533,오등동,33.47514,126.52941,1027,6,1033,1023,6,1029,제주특별자치도 제주시 오등동 619-5
534,오봉교,33.474740000000004,126.52627,476,15,491,468,15,483,제주특별자치도 제주시 오등동 1377-15
535,오봉교,33.47466,126.52636,1909,27,1936,1883,27,1910,제주특별자치도 제주시 오등동 1366-3
536,진평연립입구,33.47055,126.5222,604,1,605,545,1,546,제주특별자치도 제주시 오등동 1555-3
537,진평연립입구,33.47053,126.52233,1458,2,1460,1431,2,1433,제주특별자치도 제주시 오등동 1899
538,GM빌라,33.46673,126.52079,810,3,813,792,3,795,제주특별자치도 제주시 오등동 1678-1
539,GM빌라,33.46663,126.52081,1330,9,1339,1317,9,1326,제주특별자치도 제주시 오등동 1899
540,온난화대응농업연구소,33.46688,126.51863,1073,8,1081,1068,8,1076,제주특별자치도 제주시 오등동 1899
541,온난화대응농업연구소,33.46676,126.51928999999998,2222,6,2228,2152,6,2158,제주특별자치도 제주시 오등동 1720-1
542,정실오거리,33.46708,126.51448,1114,7,1121,1098,7,1105,제주특별자치도 제주시 오라이동 44-5
543,정실오거리,33.46723,126.51363,958,25,983,953,25,978,제주특별자치도 제주시 오라이동 73-2
544,신성여자중고등학교,33.47808,126.56175,2039,1,2040,1991,1,1992,제주특별자치도 제주시 영평동 2407-2
545,신성여자중고등학교,33.4781,126.56139,12718,28,12746,12364,28,12392,제주특별자치도 제주시 영평동 2408-2
546,제주교통방송아라아이파크,33.47763,126.54936,138,6,144,136,5,141,제주특별자치도 제주시 아라일동 884-2
547,제주교통방송아라아이파크,33.47783,126.54931,8413,68,8481,8346,64,8410,제주특별자치도 제주시 아라이동 914-7
548,아라초등학교,33.47748,126.5447,5262,71,5333,5190,68,5258,제주특별자치도 제주시 아라이동 1574-2
549,영평상동마을회관,33.476659999999995,126.56822,1594,13,1607,1556,13,1569,제주특별자치도 제주시 영평동 1878-10
550,영평상동마을회관,33.47679,126.56824,7431,39,7470,7331,39,7370,제주특별자치도 제주시 영평동 1878-15
551,영평동,33.47931,126.56325,11196,19,11215,10890,19,10909,제주특별자치도 제주시 영평동 2444-5
553,제주관광대학,33.44742,126.4352,9344,427,9771,9224,414,9638,제주특별자치도 제주시 애월읍 광령리 2613-6
554,제주관광대학,33.447309999999995,126.43653,15252,560,15812,14934,545,15479,제주특별자치도 제주시 애월읍 광령리 4227
555,월평마을,33.46976,126.57519,5954,77,6031,5888,75,5963,제주특별자치도 제주시 월평동 1039-1
557,제주중앙고등학교,33.47162,126.57158,15377,25,15402,14968,25,14993,제주특별자치도 제주시 월평동 1141-2
558,반석아파트,33.48795,126.59027,446,4,450,437,4,441,제주특별자치도 제주시 봉개동 2374-2
563,용강동,33.47929,126.58611,341,3,344,340,3,343,제주특별자치도 제주시 용강동 1777
565,용강동퐁낭밭,33.47133,126.58424,715,1,716,715,1,716,제주특별자치도 제주시 용강동 1184-2
567,시각장애인복지관,33.47072,126.58068,1642,5,1647,1629,5,1634,제주특별자치도 제주시 월평동 419-4
569,황사평,33.49457,126.56367,1305,6,1311,1298,5,1303,제주특별자치도 제주시 화북이동 5756
571,반석주택,33.48207,126.57108999999998,1668,4,1672,1634,4,1638,제주특별자치도 제주시 영평동 791-3
573,월광로,33.4932,126.47537,74,12,86,71,9,80,제주특별자치도 제주시 노형동 1137
574,월광로,33.48833,126.4692,468,3,471,467,3,470,제주특별자치도 제주시 노형동 2572
576,광평,33.48397,126.46808,7743,177,7920,7683,171,7854,제주특별자치도 제주시 노형동 2431-5
577,광평,33.48389,126.46841,3877,119,3996,3815,112,3927,제주특별자치도 제주시 노형동 2598-5
578,광평동로노형성당,33.48207,126.47042,3864,128,3992,3826,119,3945,제주특별자치도 제주시 노형동 2598-5
579,광평동로,33.4823,126.47038,3933,230,4163,3860,226,4086,제주특별자치도 제주시 노형동 2598-5
580,오광로,33.48525,126.461,109,3,112,108,3,111,제주특별자치도 제주시 노형동 3740-3
581,오광로,33.48566,126.46057,432,23,455,430,22,452,제주특별자치도 제주시 노형동 3744-1
582,오도마을,33.4909,126.45767,443,6,449,438,6,444,제주특별자치도 제주시 이호이동 1023-7
583,오도마을,33.49107,126.45737,2535,37,2572,2523,36,2559,제주특별자치도 제주시 이호이동 1380-2
585,갈왓,33.49366,126.45589,1162,253,1415,1111,247,1358,제주특별자치도 제주시 이호이동 1553-2
586,오라오거리,33.500029999999995,126.50465,8545,2080,10625,8411,2022,10433,제주특별자치도 제주시 용담이동 2756-5
588,우당도서관,33.51231,126.54815,6193,491,6684,6087,475,6562,제주특별자치도 제주시 건입동 602-18
589,큰동네,33.48923,126.59697,21126,450,21576,20908,428,21336,제주특별자치도 제주시 봉개동 1878-1
590,큰동네,33.48949,126.59628,6903,239,7142,6838,231,7069,제주특별자치도 제주시 봉개동 1883-1
591,원노형,33.48467,126.47993,13952,610,14562,13762,571,14333,제주특별자치도 제주시 노형동 3816
592,화북초등학교,33.5177,126.56241,3090,366,3456,3011,362,3373,제주특별자치도 제주시 화북일동 3806-3
593,매촌,33.517959999999995,126.58856000000002,2056,6,2062,2030,6,2036,제주특별자치도 제주시 도련이동 522-10
594,매촌,33.51788,126.58873,2471,51,2522,2444,50,2494,제주특별자치도 제주시 도련이동 522-3
595,연동입구,33.49625,126.49701,6373,839,7212,6317,820,7137,제주특별자치도 제주시 연동 115-4
596,원노형,33.48345,126.48076,26575,867,27442,26206,828,27034,제주특별자치도 제주시 노형동 948
597,금천마을,33.47864000000001,126.55343,6552,47,6599,6500,47,6547,제주특별자치도 제주시 아라이동 943-4
598,금천마을,33.47849,126.55348,3523,7,3530,3476,7,3483,제주특별자치도 제주시 아라이동 943-4
600,은혜마을종점,33.46522,126.615,214,10,224,213,10,223,제주특별자치도 제주시 봉개동 227-66
601,동회천,33.50413,126.61536,1355,16,1371,1345,16,1361,제주특별자치도 제주시 회천동 1284
602,삼양종점,33.52843,126.59147,346,29,375,342,28,370,제주특별자치도 제주시 삼양일동 1588-1
603,삼양종점,33.52852,126.59131,8204,186,8390,8117,182,8299,제주특별자치도 제주시 삼양일동 1583-13
604,삼양1동,33.52763,126.59,10067,155,10222,9983,151,10134,제주특별자치도 제주시 삼양일동 1581-29
605,삼양해수욕장입구,33.52618,126.58786,4871,300,5171,4743,282,5025,제주특별자치도 제주시 삼양일동 1669-1
606,해오름아파트,33.4818,126.48638,7383,82,7465,7323,78,7401,제주특별자치도 제주시 노형동 767
608,영평하동,33.486940000000004,126.57332,1964,6,1970,1960,6,1966,제주특별자치도 제주시 영평동 927-2
609,영평하동,33.48685,126.57315,273,1,274,268,1,269,제주특별자치도 제주시 영평동 2795
610,함덕5구,33.53426,126.67596,1823,33,1856,1796,32,1828,제주특별자치도 제주시 조천읍 함덕리 72-5
612,청화마을입구,33.456140000000005,126.43012,32,2,34,32,2,34,제주특별자치도 제주시 애월읍 광령리 3313-2
613,광령3리사무소,33.46387,126.42336,1485,11,1496,1478,10,1488,제주특별자치도 제주시 애월읍 광령리 3798-7
619,성지요양원,33.48342,126.43761,412,15,427,407,12,419,제주특별자치도 제주시 외도일동 127-6
620,다호마을,33.50458,126.49625,8902,823,9725,8694,784,9478,제주특별자치도 제주시 용담이동 1596-12
621,제주국제공항입구,33.50461,126.49647,724,221,945,688,216,904,제주특별자치도 제주시 용담이동 1588-5
622,백록초등학교,33.485409999999995,126.47151,6407,39,6446,6354,38,6392,제주특별자치도 제주시 노형동 2598-3
623,백록초등학교,33.48458,126.47065,16296,230,16526,16128,218,16346,제주특별자치도 제주시 노형동 2511-2
624,큰구릉내,33.48707,126.41543,4313,220,4533,4269,212,4481,제주특별자치도 제주시 애월읍 하귀1리 562
625,한국방송통신대학,33.48672,126.47341000000002,157,4,161,154,4,158,제주특별자치도 제주시 노형동 2615-4
626,정든마을,33.48745,126.47406,7729,44,7773,7658,43,7701,제주특별자치도 제주시 노형동 2598-2
627,몰래물,33.510490000000004,126.48218,233,32,265,230,32,262,제주특별자치도 제주시 도두이동 701
628,한라수목원,33.46991,126.48474,1654,250,1904,1627,246,1873,제주특별자치도 제주시 노형동 103-4
629,연동입구,33.496179999999995,126.49674,2912,596,3508,2845,576,3421,제주특별자치도 제주시 연동 115-4
631,공항초소,33.51362,126.48435,192,135,327,186,132,318,제주특별자치도 제주시 용담삼동 2580-55
632,성지요양원,33.48274,126.43866,338,2,340,332,2,334,제주특별자치도 제주시 외도일동 107-1
633,도평마을입구,33.47993,126.45088,1826,27,1853,1807,27,1834,제주특별자치도 제주시 도평동 814-3
634,도평동,33.48013,126.45126,1365,17,1382,1342,17,1359,제주특별자치도 제주시 도평동 779
635,공항초소,33.51358,126.48457,711,483,1194,687,466,1153,제주특별자치도 제주시 용담삼동 1286-5
637,월성마을,33.50419,126.50338,12809,2050,14859,12464,1976,14440,제주특별자치도 제주시 용담이동 750-12
638,제주국제공항(구제주방면),33.506609999999995,126.49345,91226,55164,146390,89598,52635,142233,제주특별자치도 제주시 용담이동 1462-1
639,대동마을,33.494609999999994,126.46379,1095,66,1161,1070,58,1128,제주특별자치도 제주시 이호이동 209-4
640,대동마을,33.49445,126.46379,5098,128,5226,5049,124,5173,제주특별자치도 제주시 이호이동 201-12
641,외도부영1차아파트,33.48675,126.43083,11453,19,11472,11309,19,11328,제주특별자치도 제주시 외도일동 646-1
643,거로복지회관,33.508340000000004,126.56113,671,1,672,655,1,656,제주특별자치도 제주시 화북이동 3378-4
644,거로입구,33.50496,126.56238,85,3,88,85,3,88,제주특별자치도 제주시 화북이동 3283-6
645,용강마을,33.4757,126.58553,684,1,685,682,1,683,제주특별자치도 제주시 용강동 1257-2
646,용강동,33.47567,126.58537,396,2,398,396,2,398,제주특별자치도 제주시 용강동 1316
647,용강동대합실,33.47842,126.58617,652,8,660,652,8,660,제주특별자치도 제주시 용강동 1777
649,봉개남문,33.49042,126.59063,396,5,401,395,5,400,제주특별자치도 제주시 봉개동 2482-4
651,봉개동,33.49151,126.59245,7594,233,7827,7534,221,7755,제주특별자치도 제주시 봉개동 1945-2
652,봉개동,33.49154,126.59275,21122,330,21452,20658,320,20978,제주특별자치도 제주시 봉개동 1812-9
659,우당도서관입구,33.51262,126.54517,379,11,390,373,11,384,제주특별자치도 제주시 건입동 607-3
662,월평마을,33.46968,126.57538999999998,3362,23,3385,3286,23,3309,제주특별자치도 제주시 월평동 1038-3
663,전원유치원,33.48724,126.53966,591,3,594,589,3,592,제주특별자치도 제주시 아라일동 2470-4
665,선덕어린이집,33.48101,126.51248,1417,9,1426,1410,9,1419,제주특별자치도 제주시 오라이동 1618-2
666,사평마을입구,33.48134,126.51127,1520,12,1532,1513,12,1525,제주특별자치도 제주시 오라이동 1770-3
667,민오름,33.48142,126.50168,4967,53,5020,4925,50,4975,제주특별자치도 제주시 오라이동 3161-2
668,민오름,33.481759999999994,126.50047,3927,65,3992,3816,61,3877,제주특별자치도 제주시 연동 440-2
670,이도2동행정복지센터,33.4965,126.5364,2337,19,2356,2309,19,2328,제주특별자치도 제주시 이도이동 1085-4
671,경제통상진흥원,33.498870000000004,126.54047,2250,13,2263,2220,11,2231,제주특별자치도 제주시 이도이동 444
672,한라일보,33.49857,126.51966000000002,1219,22,1241,1210,18,1228,제주특별자치도 제주시 삼도일동 568-1
673,게이트볼장,33.49475,126.51963,1182,11,1193,1180,11,1191,제주특별자치도 제주시 오라일동 1076-1
674,게이트볼장,33.49492,126.51987,1171,16,1187,1156,13,1169,제주특별자치도 제주시 오라일동 1076-1
675,한라일보,33.4986,126.51987,501,39,540,496,39,535,제주특별자치도 제주시 삼도일동 585-26
676,경제통상진흥원,33.49908,126.5403,4967,98,5065,4917,95,5012,제주특별자치도 제주시 이도이동 444
677,이도2동행정복지센터,33.496109999999994,126.53546,2001,89,2090,1988,84,2072,제주특별자치도 제주시 이도이동 1085-4
678,서부경찰서,33.47293,126.40667,164,3,167,163,3,166,제주특별자치도 제주시 애월읍 상귀리 419-6
679,서부경찰서,33.47278,126.40672,1216,12,1228,1213,11,1224,제주특별자치도 제주시 애월읍 상귀리 419-6
680,주르레마을,33.45039000000001,126.48651,1014,157,1171,965,155,1120,제주특별자치도 제주시 노형동 291-20
681,주르레마을,33.44968,126.48625,43,24,67,43,22,65,제주특별자치도 제주시 노형동 3762-4
682,하귀2리,33.47878,126.39974,1205,73,1278,1193,70,1263,제주특별자치도 제주시 애월읍 하귀2리 1931-3
683,하귀2리,33.47874,126.39952,138,6,144,134,6,140,제주특별자치도 제주시 애월읍 하귀2리 1956-6
684,귀일중학교,33.48121,126.40512,1835,138,1973,1784,137,1921,제주특별자치도 제주시 애월읍 하귀2리 1384-16
688,신제주초등학교,33.48505,126.49632,8265,187,8452,8169,186,8355,제주특별자치도 제주시 연동 304
690,광령2리입구,33.459509999999995,126.43123,10,4,14,10,4,14,제주특별자치도 제주시 애월읍 광령리 2287-2
691,원노형,33.48598,126.48355,5649,1414,7063,5475,1292,6767,제주특별자치도 제주시 노형동 949
692,메종글래드제주,33.485859999999995,126.48744,5797,1135,6932,5630,1049,6679,제주특별자치도 제주시 연동 253-1
693,봉개워터파크,33.4864,126.60147,327,96,423,321,96,417,제주특별자치도 제주시 봉개동 1336-4
694,6호광장,33.511070000000004,126.5486,1716,614,2330,1682,602,2284,제주특별자치도 제주시 건입동 602-22
695,6호광장,33.51099,126.54923,21,4,25,21,4,25,제주특별자치도 제주시 화북이동 4870-2
696,제주대학교입구,33.45673,126.55105,11866,1731,13597,11642,1640,13282,제주특별자치도 제주시 아라일동 426-10
698,당동,33.46856,126.3841,212,1,213,211,1,212,제주특별자치도 제주시 애월읍 수산리 1778-2
700,하귀하나로마트,33.4848,126.41106,12399,187,12586,12296,175,12471,제주특별자치도 제주시 애월읍 하귀1리 549-16
702,금악리,33.35743,126.29466,115,16,131,114,15,129,제주특별자치도 제주시 한림읍 금악리 1896-7
703,평대,33.528690000000005,126.83915,24,22,46,24,22,46,제주특별자치도 제주시 구좌읍 평대리 1716-6
707,만장굴입구,33.54918,126.77827,60,6,66,60,6,66,제주특별자치도 제주시 구좌읍 월정리 1841-3
708,선인동,33.48527,126.69963,130,15,145,130,15,145,제주특별자치도 제주시 조천읍 선흘리 3980-1
709,승준농원,33.44838,126.40645,18,6,24,18,6,24,제주특별자치도 제주시 애월읍 유수암리 502-5
710,승준농원,33.44845,126.40622,5,11,16,5,10,15,제주특별자치도 제주시 애월읍 유수암리 503-1
711,항몽유적지,33.45233,126.40825,86,39,125,82,39,121,제주특별자치도 제주시 애월읍 상귀리 1012
712,항몽유적지,33.45243,126.40859,56,68,124,56,67,123,제주특별자치도 제주시 애월읍 상귀리 1010-2
713,예원동민회관앞,33.45898,126.39941,126,1,127,126,1,127,제주특별자치도 제주시 애월읍 수산리 34-1
716,소길리사무소,33.43995,126.37975,347,31,378,344,27,371,제주특별자치도 제주시 애월읍 소길리 627-2
717,소길리,33.44121,126.37914,511,10,521,511,10,521,제주특별자치도 제주시 애월읍 장전리 1638-2
718,유수암상동경로당,33.422940000000004,126.40505,163,18,181,154,17,171,제주특별자치도 제주시 애월읍 유수암리 1060-10
719,유수암리사무소,33.44143,126.40328999999998,598,16,614,596,15,611,제주특별자치도 제주시 애월읍 유수암리 3234
721,유수암천,33.44313,126.40012,83,2,85,83,2,85,제주특별자치도 제주시 애월읍 유수암리 1978-1
723,용흥리상동,33.45592,126.37002,395,2,397,393,2,395,제주특별자치도 제주시 애월읍 신엄리 1873-14
728,명월하동,33.39607,126.26079,185,26,211,182,26,208,제주특별자치도 제주시 한림읍 명월리 2087-5
729,명월리,33.38705,126.26647,729,41,770,721,40,761,제주특별자치도 제주시 한림읍 명월리 1767-1
730,명월리,33.38942,126.26597,5,7,12,5,7,12,제주특별자치도 제주시 한림읍 명월리 2227
731,명월리,33.38989,126.26611,142,53,195,138,53,191,제주특별자치도 제주시 한림읍 명월리 2223
732,남문동,33.39655,126.26349,311,9,320,310,9,319,제주특별자치도 제주시 한림읍 동명리 2216-1
733,명월하동,33.39659,126.26337,18,9,27,17,9,26,제주특별자치도 제주시 한림읍 명월리 2237
736,명월하동,33.39726,126.25981000000002,25,4,29,25,4,29,제주특별자치도 제주시 한림읍 옹포리 983
737,한림고등학교,33.39918,126.25841,523,55,578,512,55,567,제주특별자치도 제주시 한림읍 옹포리 983
738,한림고등학교,33.39915,126.25857,3103,547,3650,2911,505,3416,제주특별자치도 제주시 한림읍 옹포리 819-3
745,알진오름입구,33.47691,126.78413,25,3,28,24,3,27,제주특별자치도 제주시 구좌읍 송당리 895-1
746,알진오름입구,33.47724,126.78417,50,16,66,49,16,65,제주특별자치도 제주시 구좌읍 송당리 895-2
747,비자림,33.493179999999995,126.81034,1265,1850,3115,1213,1778,2991,제주특별자치도 제주시 구좌읍 평대리 3344
748,비자림,33.49334,126.81043,1599,917,2516,1560,903,2463,제주특별자치도 제주시 구좌읍 평대리 3187
749,조수리,33.33576,126.22831,547,46,593,542,46,588,제주특별자치도 제주시 한경면 조수리 315
750,조수1리,33.33783,126.2279,14,4,18,14,4,18,제주특별자치도 제주시 한경면 조수리 437-10
751,제주서부신협,33.32703,126.25302,78,10,88,77,6,83,제주특별자치도 제주시 한경면 저지리 1521-21
752,조수1리중동,33.33415,126.22674,158,4,162,156,4,160,제주특별자치도 제주시 한경면 조수리 1455-2
753,한원리,33.334,126.20038,1,5,6,1,5,6,제주특별자치도 제주시 한경면 두모리 1360-4
754,한원리,33.3341,126.20042,105,3,108,105,3,108,제주특별자치도 제주시 한경면 두모리 731-1
755,한경면사무소,33.34993,126.18388,396,22,418,394,20,414,제주특별자치도 제주시 한경면 신창리 252-3
757,신창상동,33.3482,126.18753,19,2,21,19,2,21,제주특별자치도 제주시 한경면 신창리 1481
760,한원리,33.33553,126.19715,377,6,383,374,6,380,제주특별자치도 제주시 한경면 두모리 1453-4
761,낙천리,33.32597,126.22701,290,22,312,287,21,308,제주특별자치도 제주시 한경면 낙천리 1972
762,조수1리,33.33578,126.2288,206,40,246,204,37,241,제주특별자치도 제주시 한경면 조수리 317-7
764,조수1리,33.33628,126.23243,239,4,243,237,4,241,제주특별자치도 제주시 한경면 조수리 326-13
765,조수1리,33.33643,126.23277,182,2,184,182,2,184,제주특별자치도 제주시 한경면 조수리 4146
766,저지리수동,33.33682,126.23623,11,1,12,11,1,12,제주특별자치도 제주시 한경면 저지리 1215-2
767,저지리수동,33.3369,126.23625,33,4,37,32,4,36,제주특별자치도 제주시 한경면 저지리 1215-4
769,저지리수동,33.33745,126.23879,135,27,162,134,27,161,제주특별자치도 제주시 한경면 저지리 1313-1
770,평화동,33.30951,126.25943,121,14,135,121,14,135,제주특별자치도 제주시 한경면 청수리 3389
772,청수리,33.306909999999995,126.25842,34,10,44,33,10,43,제주특별자치도 제주시 한경면 청수리 188-2
773,청수리,33.30685,126.25832,65,3,68,65,3,68,제주특별자치도 제주시 한경면 청수리 154-2
775,산양곶자왈,33.2908,126.2508,46,10,56,46,10,56,제주특별자치도 제주시 한경면 청수리 955-2
777,산양리,33.29575,126.23398,303,7,310,303,6,309,제주특별자치도 제주시 한경면 낙천리 810-2
778,조수2리웃동네,33.29677,126.21997,86,4,90,86,4,90,제주특별자치도 제주시 한경면 조수리 3771-1
779,조수2리윗동네,33.296859999999995,126.21961,147,6,153,147,6,153,제주특별자치도 제주시 한경면 조수리 3739-12
780,조수2리,33.29585,126.21763,41,4,45,41,3,44,제주특별자치도 제주시 한경면 조수리 4007-6
782,조수2리,33.29397,126.2145,69,4,73,69,4,73,제주특별자치도 제주시 한경면 조수리 3959-2
785,칠전동,33.29773,126.19465,31,1,32,31,1,32,제주특별자치도 제주시 한경면 고산리 1717-4
786,고산환승정류장(고산1리),33.30073,126.18044,5297,302,5599,5217,292,5509,제주특별자치도 제주시 한경면 고산리 2919-8
787,한장동,33.2904,126.16763,78,5,83,78,5,83,제주특별자치도 제주시 한경면 고산리 3822-2
788,한장동,33.290420000000005,126.16752,31,19,50,30,18,48,제주특별자치도 제주시 한경면 고산리 3817-4
793,구시장터,33.435179999999995,126.32503,547,8,555,546,8,554,제주특별자치도 제주시 애월읍 납읍리 2384-12
794,구몰리동,33.42473,126.31562,786,12,798,782,11,793,제주특별자치도 제주시 애월읍 봉성리 3408-4
795,금능석물원,33.38591,126.22633,2860,586,3446,2780,563,3343,제주특별자치도 제주시 한림읍 금능리 1282-4
796,조수1리,33.3378,126.228,345,62,407,340,61,401,제주특별자치도 제주시 한경면 조수리 437-13
797,조수1리중동,33.3342,126.227,40,13,53,40,13,53,제주특별자치도 제주시 한경면 조수리 1477-5
798,낙천리,33.32606,126.22716,224,11,235,222,11,233,제주특별자치도 제주시 한경면 낙천리 1973-3
800,복호동입구,33.3365,126.19668,622,9,631,581,9,590,제주특별자치도 제주시 한경면 두모리 3023
801,신창리농산물종합유통센터,33.34664,126.19092,213,18,231,211,18,229,제주특별자치도 제주시 한경면 신창리 1481
802,한경면사무소,33.34985,126.18373,966,33,999,952,31,983,제주특별자치도 제주시 한경면 신창리 256
803,목선동,33.48999,126.71828,251,26,277,249,25,274,제주특별자치도 제주시 조천읍 선흘리 337-49
804,산남내,33.471059999999994,126.77588,167,23,190,166,22,188,제주특별자치도 제주시 구좌읍 송당리 1572-11
805,송당초등학교,33.471779999999995,126.77987,673,181,854,650,177,827,제주특별자치도 제주시 구좌읍 송당리 1271-1
806,신선동,33.51222,126.69925,302,13,315,301,13,314,제주특별자치도 제주시 조천읍 선흘리 2503-1
809,어음2리사무소,33.40122,126.33663,756,14,770,747,14,761,제주특별자치도 제주시 애월읍 어음리 3010-1
815,부면동,33.41603,126.33267,437,13,450,435,12,447,제주특별자치도 제주시 애월읍 어음리 3627-2
822,동명리,33.4098,126.26569,2454,187,2641,2415,182,2597,제주특별자치도 제주시 한림읍 동명리 1591-16
823,한림2리,33.409240000000004,126.26605,5227,257,5484,5152,250,5402,제주특별자치도 제주시 한림읍 동명리 2251
824,한림발전소,33.4017,126.27084,15,2,17,15,2,17,제주특별자치도 제주시 한림읍 동명리 666-2
825,한림발전소,33.40161,126.27132,23,1,24,23,1,24,제주특별자치도 제주시 한림읍 동명리 656-1
827,한천동,33.39465,126.2746,88,2,90,88,2,90,제주특별자치도 제주시 한림읍 동명리 820-1
830,송당상동,33.467209999999994,126.77312,135,10,145,135,9,144,제주특별자치도 제주시 구좌읍 송당리 1579-5
831,송당상동,33.46638,126.77277,171,28,199,170,27,197,제주특별자치도 제주시 구좌읍 송당리 1882-2
832,만장굴,33.53098,126.77188,10,13,23,9,12,21,제주특별자치도 제주시 구좌읍 월정리 산 37
835,혜정원아가의집,33.51625,126.67784,397,14,411,397,11,408,제주특별자치도 제주시 조천읍 함덕리 52-5
839,선인동,33.48583,126.69973,248,40,288,243,37,280,제주특별자치도 제주시 조천읍 선흘리 2092-1
840,선인동,33.4859,126.69963,379,58,437,371,53,424,제주특별자치도 제주시 조천읍 선흘리 2092-1
841,양잠단지,33.4588,126.70292,99,14,113,99,14,113,제주특별자치도 제주시 조천읍 선흘리 1944-21
842,선흘2리,33.45835,126.71153,70,17,87,70,17,87,제주특별자치도 제주시 조천읍 선흘리 469-6
843,선흘2리,33.45851,126.7117,369,70,439,367,68,435,제주특별자치도 제주시 조천읍 선흘리 470-2
845,대흘2리,33.51155,126.673,242,10,252,242,10,252,제주특별자치도 제주시 조천읍 대흘리 2787
846,대흘2리,33.5117,126.67318,1,2,3,1,2,3,제주특별자치도 제주시 조천읍 대흘리 120-3
847,대흘2리,33.51267,126.67643,382,71,453,380,71,451,제주특별자치도 제주시 조천읍 대흘리 산 6-5
848,대흘2리새동네,33.51288,126.67645,228,11,239,228,11,239,제주특별자치도 제주시 조천읍 대흘리 산 6-5
857,금붕사,33.50075,126.8908,18,1,19,17,1,18,제주특별자치도 제주시 구좌읍 종달리 1659-44
858,동복리휴게소,33.5535,126.70765,906,248,1154,877,232,1109,제주특별자치도 제주시 구좌읍 동복리 1759
859,동성동,33.55577,126.75453,2325,554,2879,2265,529,2794,제주특별자치도 제주시 구좌읍 김녕리 1206-4
860,구좌보건소,33.51992,126.85982,171,22,193,166,21,187,제주특별자치도 제주시 구좌읍 세화리 1361
861,종달리,33.49495,126.89617,592,232,824,573,227,800,제주특별자치도 제주시 구좌읍 종달리 4982
862,하도리서문동,33.51983,126.87131,293,36,329,291,36,327,제주특별자치도 제주시 구좌읍 하도리 3281-4
863,세화환승정류장(세화리),33.52338,126.85556,9802,1714,11516,9608,1649,11257,제주특별자치도 제주시 구좌읍 세화리 1421-15
865,용당리,33.3346,126.182,1170,21,1191,1156,21,1177,제주특별자치도 제주시 한경면 용수리 1025
866,용수리충혼묘지,33.32086,126.17812,266,85,351,264,75,339,제주특별자치도 제주시 한경면 용수리 4719-1
867,신흥동,33.34061,126.18206,267,16,283,267,15,282,제주특별자치도 제주시 한경면 용수리 1242-6
868,구한경의원앞,33.34385,126.18241,337,58,395,324,58,382,제주특별자치도 제주시 한경면 신창리 660-4
869,신창중학교,33.34737,126.18271,427,32,459,417,31,448,제주특별자치도 제주시 한경면 신창리 492-1
870,판포리상동,33.36768,126.20419,129,73,202,123,72,195,제주특별자치도 제주시 한경면 판포리 3182
871,곽지모물,33.45319,126.30875,34,22,56,32,22,54,제주특별자치도 제주시 애월읍 곽지리 1549-4
872,자운당,33.4676,126.3568,575,167,742,558,156,714,제주특별자치도 제주시 애월읍 신엄리 3064-4
873,금붕사,33.50066,126.89051,64,21,85,59,20,79,제주특별자치도 제주시 구좌읍 종달리 1659-45
874,제일교동문시장입구,33.51235,126.53175,4394,228,4622,4370,225,4595,제주특별자치도 제주시 일도이동 1050-1
875,신산로,33.507909999999995,126.53375,2300,333,2633,2265,324,2589,제주특별자치도 제주시 일도이동 823-3
876,문예회관,33.50495,126.53569,903,54,957,891,54,945,제주특별자치도 제주시 일도이동 852
877,용당리,33.333290000000005,126.18177,396,18,414,386,18,404,제주특별자치도 제주시 한경면 용수리 4719-1
878,신창환승정류장(한경면사무소),33.35053,126.18334,2329,154,2483,2271,149,2420,제주특별자치도 제주시 한경면 두모리 3023-8
879,남조로검문소,33.46887,126.65976,109,92,201,103,86,189,제주특별자치도 제주시 조천읍 와흘리 산 12-9
881,대흘초등학교,33.49902,126.65745,150,1,151,145,1,146,제주특별자치도 제주시 조천읍 대흘리 1655-4
882,대흘리,33.49822,126.65906,70,11,81,66,11,77,제주특별자치도 제주시 조천읍 대흘리 1602-3
883,대흘리,33.49827,126.65895,177,7,184,158,6,164,제주특별자치도 제주시 조천읍 대흘리 1649-1
884,제일농장앞,33.49438,126.6638,22,3,25,20,3,23,제주특별자치도 제주시 조천읍 대흘리 1047-3
885,제일농장앞,33.49431,126.66426,232,8,240,224,8,232,제주특별자치도 제주시 조천읍 대흘리 1029-2
886,제일농장,33.49305,126.66832,140,12,152,137,12,149,제주특별자치도 제주시 조천읍 대흘리 1075-12
888,와산리,33.49192,126.6801,80,10,90,79,8,87,제주특별자치도 제주시 조천읍 와산리 1077-3
889,와산리,33.49152,126.6822,965,35,1000,960,32,992,제주특별자치도 제주시 조천읍 와산리 966-4
890,목선동,33.4897,126.71815,58,7,65,58,7,65,제주특별자치도 제주시 조천읍 선흘리 338-3
891,선흘목선동,33.48944,126.71839,69,36,105,65,35,100,제주특별자치도 제주시 조천읍 선흘리 338-2
892,상덕천,33.4837,126.74663,145,8,153,143,8,151,제주특별자치도 제주시 구좌읍 덕천리 1188
893,상덕천마을입구,33.48366,126.74692,109,13,122,108,11,119,제주특별자치도 제주시 구좌읍 덕천리 1230-2
894,상덕천리,33.48108,126.75144,55,7,62,55,6,61,제주특별자치도 제주시 구좌읍 덕천리 1316-10
895,상덕천리,33.481190000000005,126.75154,65,6,71,65,5,70,제주특별자치도 제주시 구좌읍 덕천리 1289-2
896,웃송당,33.47129,126.77146,205,7,212,205,7,212,제주특별자치도 제주시 구좌읍 송당리 2791
897,웃송당,33.47102,126.7717,192,6,198,188,6,194,제주특별자치도 제주시 구좌읍 송당리 1655-1
898,산남내,33.47094,126.77589,445,17,462,442,17,459,제주특별자치도 제주시 구좌읍 송당리 1572-13
899,송당초등학교,33.47184,126.77923,678,73,751,670,73,743,제주특별자치도 제주시 구좌읍 송당리 1272-1
900,송당로타리,33.47157,126.78397,2430,794,3224,2382,783,3165,제주특별자치도 제주시 구좌읍 송당리 1375-2
901,송당로타리,33.4716,126.78418,2386,931,3317,2311,876,3187,제주특별자치도 제주시 구좌읍 송당리 1379-12
902,산양리,33.29368,126.23326000000002,132,18,150,131,18,149,제주특별자치도 제주시 한경면 청수리 3259-8
903,산양리,33.293820000000004,126.23347,24,1,25,24,1,25,제주특별자치도 제주시 한경면 청수리 3331-5
904,수룡동,33.30833,126.23871,275,2,277,273,2,275,제주특별자치도 제주시 한경면 낙천리 462-6
905,수룡동,33.30823,126.23853,283,2,285,283,2,285,제주특별자치도 제주시 한경면 낙천리 452-10
906,청수리,33.32114,126.24456,593,25,618,588,17,605,제주특별자치도 제주시 한경면 청수리 1638-2
907,청수리,33.32121,126.24446,132,11,143,131,8,139,제주특별자치도 제주시 한경면 청수리 1639-2
909,저청중학교,33.32582,126.2521,38,1,39,38,1,39,제주특별자치도 제주시 한경면 청수리 416-2
910,상명,33.36007,126.26975,377,2,379,376,2,378,제주특별자치도 제주시 한림읍 상명리 1599-3
911,상명리,33.36023,126.27005,55,4,59,55,3,58,제주특별자치도 제주시 한림읍 상명리 2361
914,조성동입구,33.35773,126.2737,12,2,14,11,2,13,제주특별자치도 제주시 한림읍 상명리 1026-2
915,상명리,33.357409999999994,126.27443,499,7,506,494,7,501,제주특별자치도 제주시 한림읍 상명리 1025-1
916,월림리,33.35492,126.26172,3,3,6,3,3,6,제주특별자치도 제주시 한림읍 상명리 2138-2
919,예향원,33.35304,126.25927,163,1,164,162,1,163,제주특별자치도 제주시 한림읍 월림리 2361
920,월림삼거리,33.349909999999994,126.25606,70,3,73,69,3,72,제주특별자치도 제주시 한림읍 월림리 285-4
921,월림삼거리,33.35002,126.2562,950,24,974,941,23,964,제주특별자치도 제주시 한림읍 월림리 2350-3
923,월림리,33.34618,126.25583,28,1,29,28,1,29,제주특별자치도 제주시 한림읍 월림리 464-4
924,저지리성전동,33.3413,126.25698,219,2,221,218,2,220,제주특별자치도 제주시 한경면 저지리 산 13-7
926,저지리,33.33497,126.25655,70,12,82,70,10,80,제주특별자치도 제주시 한경면 저지리 1798-2
927,저지오름,33.3335,126.25638,269,47,316,264,41,305,제주특별자치도 제주시 한경면 저지리 1844-4
928,저지오름,33.33341,126.25648,411,80,491,402,80,482,제주특별자치도 제주시 한경면 저지리 1790-2
929,저지남동,33.3301,126.25515,95,19,114,93,19,112,제주특별자치도 제주시 한경면 저지리 1711-8
930,저지리,33.330009999999994,126.25523,207,16,223,205,16,221,제주특별자치도 제주시 한경면 저지리 1711-7
931,제주서부신협,33.327420000000004,126.25352,398,17,415,391,17,408,제주특별자치도 제주시 한경면 저지리 1505-1
932,명리동,33.31926,126.26784,41,12,53,40,12,52,제주특별자치도 제주시 한경면 저지리 3022-7
933,명리동,33.31933,126.26803,270,7,277,270,6,276,제주특별자치도 제주시 한경면 저지리 3258
934,명리동,33.31773,126.26978,270,24,294,270,23,293,제주특별자치도 제주시 한경면 저지리 3007-2
935,명리동,33.31758,126.26977,40,23,63,40,23,63,제주특별자치도 제주시 한경면 저지리 3258
936,이시돌삼거리,33.34467,126.31671,133,36,169,128,34,162,제주특별자치도 제주시 한림읍 금악리 411-1
937,금악리,33.35763,126.29492,1343,52,1395,1338,51,1389,제주특별자치도 제주시 한림읍 금악리 2117
938,금악초등학교,33.35719,126.29571,524,19,543,522,19,541,제주특별자치도 제주시 한림읍 금악리 1898-2
941,금악,33.361999999999995,126.2928,182,2,184,182,2,184,제주특별자치도 제주시 한림읍 금악리 2204-10
943,금악리,33.36658,126.28713,25,2,27,25,1,26,제주특별자치도 제주시 한림읍 금악리 2850-8
946,고림동,33.37415,126.28476,42,2,44,41,2,43,제주특별자치도 제주시 한림읍 명월리 417-12
948,문수동,33.38559,126.28357,345,3,348,345,3,348,제주특별자치도 제주시 한림읍 동명리 175-1
964,미듬아파트,33.41875,126.26873,363,16,379,362,15,377,제주특별자치도 제주시 한림읍 대림리 1853-4
965,미듬아파트,33.4187,126.26883,2734,24,2758,2703,23,2726,제주특별자치도 제주시 한림읍 대림리 1771-5
966,한림오일시장,33.42051,126.27277,1086,21,1107,1072,20,1092,제주특별자치도 제주시 한림읍 대림리 1718-3
967,한림오일시장,33.4208,126.27358999999998,1647,12,1659,1635,11,1646,제주특별자치도 제주시 한림읍 대림리 1714
968,대림사거리,33.42216,126.27776,597,29,626,595,29,624,제주특별자치도 제주시 한림읍 대림리 444-2
969,대림사거리,33.42218,126.27881,222,16,238,221,16,237,제주특별자치도 제주시 한림읍 대림리 1413-4
970,대림리사무소,33.42252,126.28062,333,12,345,330,12,342,제주특별자치도 제주시 한림읍 대림리 766-6
971,대림리사무소,33.42263,126.28147,234,3,237,233,2,235,제주특별자치도 제주시 한림읍 대림리 763-7
972,대림입전동,33.42218,126.28336000000002,173,2,175,170,1,171,제주특별자치도 제주시 한림읍 대림리 752-2
973,대림입전동,33.422,126.28352,337,9,346,336,8,344,제주특별자치도 제주시 한림읍 대림리 752-9
974,귀덕3리,33.4182,126.29202,365,2,367,363,2,365,제주특별자치도 제주시 한림읍 귀덕리 2147-4
975,귀덕3리,33.418,126.2923,248,3,251,240,3,243,제주특별자치도 제주시 한림읍 귀덕리 2217-3
976,귀덕3리,33.41893,126.29618,665,19,684,659,19,678,제주특별자치도 제주시 한림읍 귀덕리 2074-9
977,귀덕3리,33.41901,126.2962,638,23,661,636,23,659,제주특별자치도 제주시 한림읍 귀덕리 2074-1
979,도림사,33.41823,126.30245,127,3,130,126,3,129,제주특별자치도 제주시 애월읍 봉성리 3946-8
980,봉성리서성동,33.41721,126.31072,466,15,481,465,15,480,제주특별자치도 제주시 애월읍 봉성리 4097-5
981,봉성리서성동,33.41738,126.31072,538,11,549,537,11,548,제주특별자치도 제주시 애월읍 봉성리 4106-2
982,봉성하나로마트,33.4189,126.31245,2188,26,2214,2154,21,2175,제주특별자치도 제주시 애월읍 봉성리 4123-3
983,봉성하나로마트,33.41922,126.31257,3639,63,3702,3600,62,3662,제주특별자치도 제주시 애월읍 봉성리 3820-2
984,구몰리동,33.42479,126.31553999999998,292,4,296,290,2,292,제주특별자치도 제주시 애월읍 봉성리 3408-8
986,납읍리섯잣길,33.43705,126.32758,604,6,610,604,5,609,제주특별자치도 제주시 애월읍 납읍리 2188-3
987,납읍리,33.43891,126.32895,1023,14,1037,1022,12,1034,제주특별자치도 제주시 애월읍 납읍리 1569-14
988,납읍리사무소,33.439440000000005,126.32944,3192,42,3234,3168,41,3209,제주특별자치도 제주시 애월읍 납읍리 1754-3
989,원동입구,33.44501,126.33591,45,5,50,44,5,49,제주특별자치도 제주시 애월읍 납읍리 1891-7
990,상가리서동,33.45013,126.34097,383,22,405,378,22,400,제주특별자치도 제주시 애월읍 상가리 1749-5
991,상가리서동,33.45047,126.34074,225,2,227,223,2,225,제주특별자치도 제주시 애월읍 상가리 1765-5
992,상가리,33.45174,126.34189,626,20,646,620,19,639,제주특별자치도 제주시 애월읍 상가리 1794-9
993,하가입구,33.4523,126.3442,309,43,352,309,41,350,제주특별자치도 제주시 애월읍 하가리 1591-5
994,상가리보건진료소,33.452009999999994,126.34428,1246,77,1323,1241,75,1316,제주특별자치도 제주시 애월읍 상가리 1805-4
995,상가리동동,33.45208,126.34728,840,55,895,836,53,889,제주특별자치도 제주시 애월읍 상가리 1156-4
996,하가리오당빌레,33.45318,126.35085,517,57,574,514,56,570,제주특별자치도 제주시 애월읍 하가리 792-1
997,하가리오당빌레,33.45333,126.35082,199,13,212,197,13,210,제주특별자치도 제주시 애월읍 하가리 848-4
998,존손이굴,33.45217,126.36229,18,3,21,18,3,21,제주특별자치도 제주시 애월읍 하가리 190-4
999,용흥리,33.45206,126.36886,131,5,136,130,5,135,제주특별자치도 제주시 애월읍 신엄리 1951-6
1000,용흥리,33.45172,126.36958,1164,65,1229,1154,63,1217,제주특별자치도 제주시 애월읍 신엄리 3208
1001,흥국사,33.45244,126.3781,56,2,58,55,2,57,제주특별자치도 제주시 애월읍 신엄리 118-1
1002,흥국사,33.45263,126.37842,16,2,18,16,2,18,제주특별자치도 제주시 애월읍 장전리 1382-1
1003,장전알동네,33.4523,126.38545,326,9,335,325,9,334,제주특별자치도 제주시 애월읍 장전리 1174-5
1004,장전알동네,33.45175,126.38562,450,11,461,449,11,460,제주특별자치도 제주시 애월읍 장전리 1123-3
1005,장전리사무소,33.45088,126.38845,3263,53,3316,3222,52,3274,제주특별자치도 제주시 애월읍 장전리 1797
1006,알뱅듸왓,33.450540000000004,126.39052,195,8,203,194,8,202,제주특별자치도 제주시 애월읍 장전리 381-5
1007,알뱅듸왓,33.45035,126.39065,1225,31,1256,1206,31,1237,제주특별자치도 제주시 애월읍 장전리 1797
1008,장전리동가름,33.45264,126.39523,152,6,158,149,6,155,제주특별자치도 제주시 애월읍 장전리 240-4
1009,장전리동가름,33.45254,126.39532,935,23,958,923,23,946,제주특별자치도 제주시 애월읍 장전리 190-11
1010,예원동,33.4561,126.40335,320,9,329,319,9,328,제주특별자치도 제주시 애월읍 상귀리 1100-1
1011,극락사,33.45653,126.40695,106,7,113,106,7,113,제주특별자치도 제주시 애월읍 상귀리 789-8
1012,극락사,33.456340000000004,126.40677,374,23,397,365,20,385,제주특별자치도 제주시 애월읍 상귀리 789-5
1013,세화환승정류장(세화리),33.52325,126.8566,20085,4651,24736,19598,4403,24001,제주특별자치도 제주시 구좌읍 세화리 1465-6
1014,세화리시장2동,33.5236,126.85361,6272,659,6931,6195,628,6823,제주특별자치도 제주시 구좌읍 세화리 1524-5
1015,세화리시장2동,33.5235,126.85325,1969,376,2345,1936,364,2300,제주특별자치도 제주시 구좌읍 세화리 1531-3
1016,하덕천,33.50263,126.77111,101,43,144,101,41,142,제주특별자치도 제주시 구좌읍 덕천리 283-1
1017,덕천리,33.50244,126.77078,551,78,629,546,70,616,제주특별자치도 제주시 구좌읍 덕천리 233
1018,선흘,33.51156,126.70523,169,26,195,167,26,193,제주특별자치도 제주시 조천읍 선흘리 1207-2
1019,선흘1리,33.51168,126.70512,1493,89,1582,1488,85,1573,제주특별자치도 제주시 조천읍 선흘리 4199
1020,신선동,33.51228,126.6987,27,6,33,27,6,33,제주특별자치도 제주시 조천읍 선흘리 2836-2
1021,낙선동,33.51455,126.69342,17,3,20,17,3,20,제주특별자치도 제주시 조천읍 선흘리 3383-2
1022,낙선동,33.51467,126.69353,540,23,563,534,23,557,제주특별자치도 제주시 조천읍 선흘리 3386-1
1025,유수암리,33.42781,126.41093,12,4,16,11,4,15,제주특별자치도 제주시 애월읍 유수암리 3234
1026,교래사거리,33.43335,126.67172,834,253,1087,817,237,1054,제주특별자치도 제주시 조천읍 교래리 산 60-13
1027,교래사거리,33.43325,126.67178,614,399,1013,582,377,959,제주특별자치도 제주시 조천읍 교래리 산 60-13
1029,고평동,33.4749,126.65627,81,8,89,81,8,89,제주특별자치도 제주시 조천읍 와흘리 67-1
1030,먼나먼루,33.487759999999994,126.65023,12,3,15,12,3,15,제주특별자치도 제주시 조천읍 와흘리 385-2
1033,대흘1리,33.498459999999994,126.6541,61,20,81,59,20,79,제주특별자치도 제주시 조천읍 대흘리 2296-8
1034,대흘1리,33.49855,126.65392,557,19,576,551,19,570,제주특별자치도 제주시 조천읍 대흘리 2297-3
1035,탐라도뚜리농장,33.50236,126.64238,238,6,244,237,6,243,제주특별자치도 제주시 조천읍 와흘리 2814
1036,탐라도뚜리농장,33.50213,126.64192,19,6,25,19,5,24,제주특별자치도 제주시 조천읍 와흘리 1336-3
1037,와흘리,33.503029999999995,126.63628,1101,13,1114,1095,13,1108,제주특별자치도 제주시 조천읍 와흘리 1260-5
1038,와흘,33.50308,126.63506,111,13,124,109,13,122,제주특별자치도 제주시 조천읍 와흘리 1456-2
1039,새가름마을,33.50482,126.62882,628,4,632,622,4,626,제주특별자치도 제주시 조천읍 와흘리 2601-9
1041,동회천,33.50465,126.61338,993,66,1059,982,64,1046,제주특별자치도 제주시 회천동 2326-1
1042,남조로검문소,33.46968,126.66118,226,97,323,219,95,314,제주특별자치도 제주시 조천읍 대흘리 1235-11
1043,세미마을,33.470009999999995,126.66362,263,19,282,258,19,277,제주특별자치도 제주시 조천읍 대흘리 1197-33
1044,세미마을,33.46985,126.66462,48,14,62,47,13,60,제주특별자치도 제주시 조천읍 대흘리 1197-35
1045,대흘교차로,33.46898,126.6764,169,11,180,166,9,175,제주특별자치도 제주시 조천읍 대흘리 1209-2
1046,대흘교차로,33.46842,126.67972,35,10,45,34,10,44,제주특별자치도 제주시 조천읍 와산리 산 27-1
1047,선흘2리입구,33.458859999999994,126.70153,638,31,669,629,31,660,제주특별자치도 제주시 조천읍 선흘리 1942-8
1048,선흘2리입구,33.45841,126.70143,71,31,102,70,29,99,제주특별자치도 제주시 조천읍 선흘리 1941-6
1049,거문오름입구,33.45304,126.709,21,5,26,19,5,24,제주특별자치도 제주시 조천읍 선흘리 1848-3
1050,거문오름입구,33.452220000000004,126.70935,3,2,5,3,2,5,제주특별자치도 제주시 조천읍 선흘리 1869-4
1051,대천환승정류장(제주방향),33.43642,126.73489,1612,670,2282,1565,633,2198,제주특별자치도 제주시 구좌읍 송당리 2601-4
1052,성연목장,33.422340000000005,126.7568,102,21,123,99,21,120,제주특별자치도 제주시 구좌읍 송당리 산 262-1
1053,성연목장,33.42255,126.75697,82,10,92,80,10,90,제주특별자치도 제주시 구좌읍 송당리 산 262-1
1056,대성목장,33.43071,126.74753,23,6,29,23,4,27,제주특별자치도 제주시 구좌읍 송당리 산 286-3
1057,대성목장,33.43088,126.74768,73,31,104,69,31,100,제주특별자치도 제주시 구좌읍 송당리 산 286-3
1058,대천환승정류장(표선방향),33.43537,126.73714,847,350,1197,821,339,1160,제주특별자치도 제주시 구좌읍 송당리 2635-6
1059,대천환승정류장(교래방향),33.435179999999995,126.73451,622,359,981,603,348,951,제주특별자치도 제주시 구좌읍 송당리 2614-2
1060,대천환승정류장(세화방향),33.43615,126.73704,1157,799,1956,1121,771,1892,제주특별자치도 제주시 구좌읍 송당리 산 126-7
1061,탐라승마장,33.43405,126.7178,80,16,96,50,15,65,제주특별자치도 제주시 조천읍 교래리 산 10-4
1062,탐라승마장,33.43362,126.71682,15,6,21,14,6,20,제주특별자치도 제주시 조천읍 교래리 42-2
1063,산굼부리,33.435320000000004,126.68933,463,447,910,391,419,810,제주특별자치도 제주시 조천읍 교래리 165-2
1064,산굼부리,33.43537,126.68883999999998,1386,1210,2596,1111,1078,2189,제주특별자치도 제주시 조천읍 교래리 165-2
1065,교래리,33.43686,126.67786,69,34,103,66,34,100,제주특별자치도 제주시 조천읍 교래리 827
1066,교래리보건소,33.43626,126.6762,850,99,949,825,93,918,제주특별자치도 제주시 조천읍 교래리 481-2
1069,구엄리,33.474540000000005,126.37619,1463,221,1684,1419,212,1631,제주특별자치도 제주시 애월읍 구엄리 1080-7
1070,구엄리,33.47432,126.37625,3917,341,4258,3858,324,4182,제주특별자치도 제주시 애월읍 구엄리 1078-12
1071,중엄리,33.47355,126.37339,2590,359,2949,2557,346,2903,제주특별자치도 제주시 애월읍 신엄리 757-6
1072,중엄리,33.47346,126.37367,6765,435,7200,6673,426,7099,제주특별자치도 제주시 애월읍 신엄리 756-8
1073,신엄리,33.47177,126.36807,2721,336,3057,2666,324,2990,제주특별자치도 제주시 애월읍 신엄리 3208
1074,신엄리,33.4716,126.36813,8249,337,8586,8130,325,8455,제주특별자치도 제주시 애월읍 신엄리 1305-9
1075,자운당,33.467420000000004,126.35694,1625,231,1856,1576,215,1791,제주특별자치도 제주시 애월읍 하가리 1633
1076,고내리애월119센터,33.46629,126.34943,2129,162,2291,2097,156,2253,제주특별자치도 제주시 애월읍 고내리 1365
1077,애월119센터,33.46623,126.34871,1062,111,1173,1040,109,1149,제주특별자치도 제주시 애월읍 고내리 207-4
1078,고내리,33.46246,126.33805,2368,597,2965,2309,581,2890,제주특별자치도 제주시 애월읍 고내리 663-3
1079,고내리,33.46315,126.3389,1553,850,2403,1475,838,2313,제주특별자치도 제주시 애월읍 고내리 1038-1
1080,애월고등학교,33.46262,126.33447,3026,386,3412,2950,369,3319,제주특별자치도 제주시 애월읍 고내리 1370
1081,애월고등학교,33.46243,126.33455,10693,721,11414,10396,691,11087,제주특별자치도 제주시 애월읍 애월리 4-3
1082,애월읍사무소,33.46258,126.33034,2306,88,2394,2245,86,2331,제주특별자치도 제주시 애월읍 애월리 343-5
1083,애월읍사무소,33.46308,126.32902,638,172,810,614,163,777,제주특별자치도 제주시 애월읍 애월리 353-2
1084,애월중학교,33.46358,126.32522,14,1,15,13,1,14,제주특별자치도 제주시 애월읍 애월리 458-1
1085,애월중학교,33.46353,126.32416,5424,212,5636,5281,208,5489,제주특별자치도 제주시 애월읍 애월리 548
1086,애월리,33.46439,126.32068999999998,5341,602,5943,5214,573,5787,제주특별자치도 제주시 애월읍 애월리 1715-19
1087,애월환승정류장(애월리),33.46444,126.31983,7746,1335,9081,7612,1276,8888,제주특별자치도 제주시 애월읍 애월리 1584-1
1088,신설동,33.46431,126.31637,879,180,1059,850,176,1026,제주특별자치도 제주시 애월읍 애월리 2115-5
1089,신설동,33.46433,126.3157,13,2,15,13,2,15,제주특별자치도 제주시 애월읍 애월리 2020-1
1090,한담동,33.46264,126.31269,3164,2591,5755,2984,2482,5466,제주특별자치도 제주시 애월읍 애월리 2628
1091,한담동,33.46243,126.31278,10492,6766,17258,9697,6405,16102,제주특별자치도 제주시 애월읍 애월리 2154-2
1092,곽지모물,33.45169,126.30892,2254,1096,3350,2148,1049,3197,제주특별자치도 제주시 애월읍 곽지리 1538-1
1093,곽지해수욕장,33.44843,126.30746,2482,1156,3638,2352,1126,3478,제주특별자치도 제주시 애월읍 곽지리 1668-3
1094,곽지해수욕장,33.4482,126.30757,5628,1453,7081,5440,1401,6841,제주특별자치도 제주시 애월읍 곽지리 2495
1095,금빛신협,33.44655,126.3058,3172,528,3700,3105,512,3617,제주특별자치도 제주시 애월읍 곽지리 2046-2
1096,금빛신협,33.44578,126.30467,1370,337,1707,1330,327,1657,제주특별자치도 제주시 애월읍 곽지리 2060-3
1097,금성리,33.444959999999995,126.30239,693,65,758,685,61,746,제주특별자치도 제주시 애월읍 금성리 444-3
1098,금성리,33.4445,126.30143,1803,142,1945,1787,136,1923,제주특별자치도 제주시 애월읍 금성리 601-3
1099,하동복지회관,33.44421,126.29679,518,137,655,503,134,637,제주특별자치도 제주시 한림읍 귀덕리 4174
1100,하동복지회관,33.44437,126.29677,558,109,667,551,106,657,제주특별자치도 제주시 한림읍 귀덕리 903-4
1101,귀덕초등학교,33.44372,126.29413999999998,2445,486,2931,2347,440,2787,제주특별자치도 제주시 한림읍 귀덕리 1179-6
1102,귀덕1리,33.44351,126.29275,1334,226,1560,1298,219,1517,제주특별자치도 제주시 한림읍 귀덕리 1026-4
1103,사동복지회관,33.44221,126.29005,1026,155,1181,1004,148,1152,제주특별자치도 제주시 한림읍 귀덕리 4174
1104,사동복지회관,33.44187,126.28872,401,62,463,391,62,453,제주특별자치도 제주시 한림읍 귀덕리 3028-3
1105,초록마을,33.44118,126.28666,453,89,542,430,86,516,제주특별자치도 제주시 한림읍 귀덕리 2962-8
1106,초록마을,33.44098,126.2856,349,32,381,341,29,370,제주특별자치도 제주시 한림읍 귀덕리 4174
1107,귀덕새마을금고,33.43994,126.28327,842,111,953,831,107,938,제주특별자치도 제주시 한림읍 귀덕리 3253-7
1108,귀덕새마을금고,33.43974,126.28236,813,83,896,804,79,883,제주특별자치도 제주시 한림읍 귀덕리 3329-5
1109,귀덕2리,33.43813,126.28041,950,102,1052,937,101,1038,제주특별자치도 제주시 한림읍 귀덕리 3347-3
1110,귀덕2리,33.43732,126.27913999999998,816,78,894,810,77,887,제주특별자치도 제주시 한림읍 귀덕리 3992-1
1111,라신동,33.43527,126.27783,215,19,234,210,19,229,제주특별자치도 제주시 한림읍 귀덕리 4174
1112,라신동,33.434059999999995,126.27738,370,61,431,358,58,416,제주특별자치도 제주시 한림읍 귀덕리 3651-3
1113,용운동,33.43227,126.27596,384,150,534,373,138,511,제주특별자치도 제주시 한림읍 수원리 262-5
1114,용운동,33.43195,126.27592,546,132,678,533,126,659,제주특별자치도 제주시 한림읍 대림리 1035-2
1115,대림입구,33.4286,126.27239,271,49,320,266,46,312,제주특별자치도 제주시 한림읍 대림리 1095-23
1116,대림입구,33.42846,126.27198,86,39,125,84,38,122,제주특별자치도 제주시 한림읍 수원리 289
1117,수원리,33.426140000000004,126.26994,1474,98,1572,1456,98,1554,제주특별자치도 제주시 한림읍 대림리 1591
1118,수원리,33.42566,126.26913,928,55,983,913,55,968,제주특별자치도 제주시 한림읍 대림리 2021-8
1119,한림2리,33.41402,126.26915,4,4,8,4,3,7,제주특별자치도 제주시 한림읍 한림리 1009-3
1120,한림고등학교,33.40488,126.25427,861,300,1161,797,296,1093,제주특별자치도 제주시 한림읍 옹포리 983
1121,옹포리,33.40332,126.2522,4340,523,4863,4199,511,4710,제주특별자치도 제주시 한림읍 옹포리 560-3
1122,옹포리,33.40303,126.25168,1222,394,1616,1152,385,1537,제주특별자치도 제주시 한림읍 옹포리 575
1123,옹포사거리,33.40558,126.25598,4290,1002,5292,4213,975,5188,제주특별자치도 제주시 한림읍 옹포리 983
1124,옹포사거리,33.40585,126.25612,1662,1153,2815,1568,1130,2698,제주특별자치도 제주시 한림읍 옹포리 983
1125,한림여자중학교,33.41033,126.25965,3956,650,4606,3870,639,4509,제주특별자치도 제주시 한림읍 한림리 1490-4
1126,한림여자중학교,33.4109,126.25977,2673,276,2949,2617,265,2882,제주특별자치도 제주시 한림읍 한림리 1473-6
1127,한국통신,33.41275,126.26118,4103,307,4410,4044,302,4346,제주특별자치도 제주시 한림읍 한림리 1386-13
1128,한국통신,33.41302,126.26138,1693,335,2028,1653,318,1971,제주특별자치도 제주시 한림읍 한림리 1582
1129,한림환승정류장(한림리),33.41437,126.26336,29341,2169,31510,28938,2094,31032,제주특별자치도 제주시 한림읍 한림리 1360-2
1130,한림환승정류장(한림리),33.41453,126.26427,36280,2541,38821,35631,2429,38060,제주특별자치도 제주시 한림읍 한림리 1582
1131,한수리,33.42224,126.2646,1351,59,1410,1328,56,1384,제주특별자치도 제주시 한림읍 한수리 839
1132,한수리,33.42187,126.26409,388,31,419,380,31,411,제주특별자치도 제주시 한림읍 한수리 887-9
1133,한림천주교회,33.41711,126.26491,7568,342,7910,7423,334,7757,제주특별자치도 제주시 한림읍 한림리 1584
1134,한림주유소,33.416709999999995,126.26483,5738,666,6404,5609,638,6247,제주특별자치도 제주시 한림읍 한림리 1584
1135,협재리,33.39788,126.24528,5067,1954,7021,4934,1904,6838,제주특별자치도 제주시 한림읍 협재리 1590-1
1136,협재리,33.39753,126.24465,989,647,1636,964,625,1589,제주특별자치도 제주시 한림읍 협재리 2872
1137,협재해수욕장,33.39421,126.24098,8603,4951,13554,8058,4769,12827,제주특별자치도 제주시 한림읍 협재리 1750-9
1138,협재해수욕장,33.39423,126.24082,2587,2182,4769,2434,2079,4513,제주특별자치도 제주시 한림읍 협재리 2447-4
1139,한림공원,33.39182,126.23908,3194,1401,4595,2919,1324,4243,제주특별자치도 제주시 한림읍 협재리 2514-15
1140,한림공원,33.39178,126.23886,1047,849,1896,958,804,1762,제주특별자치도 제주시 한림읍 협재리 2497-3
1141,금능리,33.3874,126.23226,699,376,1075,678,365,1043,제주특별자치도 제주시 한림읍 금능리 2072-2
1142,금능리,33.38722,126.23234,3616,655,4271,3537,626,4163,제주특별자치도 제주시 한림읍 금능리 2072-6
1143,금능석물원,33.38603,126.22628,355,125,480,330,124,454,제주특별자치도 제주시 한림읍 금능리 1282-3
1144,월령리,33.37615,126.21782,3115,679,3794,3065,663,3728,제주특별자치도 제주시 한림읍 월령리 219-3
1145,월령리,33.37595,126.2174,461,164,625,438,162,600,제주특별자치도 제주시 한림읍 월령리 1220
1146,판포리상동,33.36765,126.20451,647,207,854,628,200,828,제주특별자치도 제주시 한경면 판포리 1634-6
1147,판포리,33.3648,126.20025,2952,629,3581,2752,602,3354,제주특별자치도 제주시 한경면 판포리 2864-2
1148,판포리,33.36457,126.19927,847,245,1092,802,233,1035,제주특별자치도 제주시 한경면 판포리 2869-4
1149,금등리마을,33.36175,126.19296,738,36,774,713,36,749,제주특별자치도 제주시 한경면 금등리 658-7
1150,금등리마을,33.36178,126.1924,209,28,237,202,25,227,제주특별자치도 제주시 한경면 금등리 729-5
1151,구한경의원앞,33.34407,126.18268,344,120,464,326,118,444,제주특별자치도 제주시 한경면 신창리 680-2
1152,신창리한경수협,33.34761,126.18279,581,74,655,567,71,638,제주특별자치도 제주시 한경면 신창리 1481
1153,신창환승정류장(한경면사무소),33.34993,126.18308,8946,1118,10064,8759,1032,9791,제주특별자치도 제주시 한경면 신창리 261-8
1154,두모리사무소,33.35351,126.18528,1305,69,1374,1291,69,1360,제주특별자치도 제주시 한경면 두모리 3023-8
1155,두모리사무소,33.353970000000004,126.18533,279,17,296,277,17,294,제주특별자치도 제주시 한경면 두모리 2382-1
1156,신흥동,33.34063,126.18238,706,13,719,697,13,710,제주특별자치도 제주시 한경면 용수리 4719-1
1157,용수리,33.32101,126.17853999999998,556,92,648,543,89,632,제주특별자치도 제주시 한경면 용수리 3048-4
1158,고산1리(구출장소),33.30657,126.17855,493,73,566,488,71,559,제주특별자치도 제주시 한경면 고산리 2629-2
1159,고산1리(구출장소),33.306059999999995,126.17898,1442,140,1582,1426,130,1556,제주특별자치도 제주시 한경면 고산리 3993
1160,고산우체국앞,33.3038,126.1796,2973,139,3112,2929,137,3066,제주특별자치도 제주시 한경면 고산리 2208-5
1161,고산,33.30307,126.17942,638,59,697,632,57,689,제주특별자치도 제주시 한경면 고산리 2203-2
1162,고산환승정류장(고산1리고산성당앞),33.3009,126.18043,7713,801,8514,7539,749,8288,제주특별자치도 제주시 한경면 고산리 2865-5
1163,고산1리육거리,33.30087,126.17972,145,25,170,143,24,167,제주특별자치도 제주시 한경면 고산리 3993
1164,화전마을,33.35201,126.36003,1728,261,1989,1696,250,1946,제주특별자치도 제주시 애월읍 봉성리 산 35-9
1165,화전마을,33.35143,126.35902,385,164,549,371,163,534,제주특별자치도 제주시 한림읍 금악리 산 31-15
1166,엘리시안CC,33.38017,126.37142,200,1,201,198,1,199,제주특별자치도 제주시 애월읍 어음리 산 187
1167,국학원,33.3889,126.37368,322,128,450,304,123,427,제주특별자치도 제주시 애월읍 어음리 산 3
1168,렛츠런파크,33.40997,126.39263,1869,41,1910,1846,37,1883,제주특별자치도 제주시 애월읍 소길리 산 186-1
1169,렛츠런파크,33.41042,126.39343,8497,92,8589,8406,90,8496,제주특별자치도 제주시 애월읍 소길리 산 186-1
1170,고성2리,33.43616,126.42416,3157,78,3235,3105,75,3180,제주특별자치도 제주시 애월읍 고성리 920-3
1171,제주공룡원,33.443290000000005,126.43186,757,165,922,734,156,890,제주특별자치도 제주시 애월읍 광령리 2675-2
1172,산이굴,33.44396,126.43163,196,82,278,192,77,269,제주특별자치도 제주시 애월읍 광령리 2663-1
1173,고성2리,33.43694,126.42403,496,24,520,485,24,509,제주특별자치도 제주시 애월읍 고성리 914-6
1174,국학원,33.38753,126.37263,176,100,276,170,93,263,제주특별자치도 제주시 애월읍 어음리 산 72-4
1175,어음2리입구,33.38025,126.37048,112,11,123,112,11,123,제주특별자치도 제주시 애월읍 어음리 산 68-3
1176,하도리창흥동,33.50877,126.88738,740,214,954,718,209,927,제주특별자치도 제주시 구좌읍 하도리 산 10-1
1177,하도리창흥동,33.50856,126.88703,176,118,294,166,111,277,제주특별자치도 제주시 구좌읍 하도리 산 10-5
1178,하도리동동,33.51605,126.88448,1006,102,1108,1001,82,1083,제주특별자치도 제주시 구좌읍 하도리 1299-5
1179,하도리동동,33.51593,126.88421,261,53,314,257,53,310,제주특별자치도 제주시 구좌읍 하도리 1209-2
1180,하도리,33.51793,126.88272,2689,411,3100,2664,393,3057,제주특별자치도 제주시 구좌읍 하도리 1314-2
1181,하도리,33.51777,126.88259,674,193,867,665,186,851,제주특별자치도 제주시 구좌읍 하도리 1313-3
1182,하도초등학교,33.51812,126.87902,709,31,740,692,31,723,제주특별자치도 제주시 구좌읍 하도리 2251-6
1183,하도초등학교,33.5179,126.87904,219,24,243,217,24,241,제주특별자치도 제주시 구좌읍 하도리 2251-5
1184,하도리면수동,33.52065,126.86867,253,105,358,251,103,354,제주특별자치도 제주시 구좌읍 하도리 3309-5
1185,하도리면수동,33.52102,126.8681,974,91,1065,967,90,1057,제주특별자치도 제주시 구좌읍 하도리 3309-6
1186,해녀박물관입구,33.52114,126.86385,2180,756,2936,2109,729,2838,제주특별자치도 제주시 구좌읍 상도리 471-33
1187,해녀박물관입구,33.52103,126.86376,1191,679,1870,1143,665,1808,제주특별자치도 제주시 구좌읍 상도리 471-33
1188,세화리구좌농협,33.52095,126.85986,3057,278,3335,2990,262,3252,제주특별자치도 제주시 구좌읍 세화리 1366-2
1189,세화리구좌농협,33.52107,126.85958,3410,520,3930,3337,506,3843,제주특별자치도 제주시 구좌읍 세화리 1366-4
1190,구좌보건소,33.519859999999994,126.85969,274,51,325,270,48,318,제주특별자치도 제주시 구좌읍 세화리 1332
1191,세화고등학교,33.5168,126.863,583,7,590,558,7,565,제주특별자치도 제주시 구좌읍 세화리 3637
1192,상도리세화고등학교,33.51653,126.86353,581,10,591,567,9,576,제주특별자치도 제주시 구좌읍 상도리 524-1
1193,상도마을회관,33.51487,126.86532,29,15,44,25,12,37,제주특별자치도 제주시 구좌읍 상도리 589
1194,상도마을회관,33.51445,126.86613,299,16,315,285,15,300,제주특별자치도 제주시 구좌읍 상도리 1401
1195,종달리,33.49512,126.89621,1980,345,2325,1941,338,2279,제주특별자치도 제주시 구좌읍 종달리 1714-4
1196,종달초등학교,33.4929,126.89648,4105,1078,5183,4027,1063,5090,제주특별자치도 제주시 구좌읍 종달리 1782-3
1197,종달초등학교,33.49238,126.89627,1560,533,2093,1517,519,2036,제주특별자치도 제주시 구좌읍 종달리 1903-1
1198,평대리동동,33.524390000000004,126.84971000000002,1422,135,1557,1402,130,1532,제주특별자치도 제주시 구좌읍 평대리 419-2
1199,평대리동동,33.52432,126.8495,421,122,543,417,120,537,제주특별자치도 제주시 구좌읍 평대리 355-10
1200,평대리사무소,33.52787,126.84331,1199,409,1608,1186,397,1583,제주특별자치도 제주시 구좌읍 평대리 749-1
1201,평대리사무소,33.52834,126.84228,931,389,1320,912,376,1288,제주특별자치도 제주시 구좌읍 평대리 3344
1202,평대초등학교,33.52884,126.83879,505,365,870,492,356,848,제주특별자치도 제주시 구좌읍 평대리 1727-1
1203,평대초등학교,33.52957,126.83922,1682,712,2394,1652,691,2343,제주특별자치도 제주시 구좌읍 평대리 647-3
1204,평대초등학교,33.52976,126.83878,72,5,77,71,5,76,제주특별자치도 제주시 구좌읍 평대리 1720-6
1205,평대리서동,33.530770000000004,126.83778,718,262,980,700,260,960,제주특별자치도 제주시 구좌읍 평대리 1841-1
1206,평대리서동,33.53078,126.83758,685,182,867,663,178,841,제주특별자치도 제주시 구좌읍 평대리 3344
1207,계룡동,33.53362,126.83389,558,197,755,551,192,743,제주특별자치도 제주시 구좌읍 평대리 2033-16
1208,계룡동,33.5344,126.83345,863,354,1217,833,347,1180,제주특별자치도 제주시 구좌읍 한동리 37-2
1209,한동리,33.53717,126.82958,1513,216,1729,1490,213,1703,제주특별자치도 제주시 구좌읍 한동리 1195-3
1210,한동리,33.5371,126.82945,1803,155,1958,1791,146,1937,제주특별자치도 제주시 구좌읍 한동리 1186-2
1211,한동리서동,33.53873,126.82722,1939,321,2260,1883,315,2198,제주특별자치도 제주시 구좌읍 한동리 1161-3
1212,한동리서동,33.53877,126.82693,1493,231,1724,1460,223,1683,제주특별자치도 제주시 구좌읍 한동리 4848
1213,구좌중앙초등학교,33.55117,126.79858,2421,1208,3629,2306,1156,3462,제주특별자치도 제주시 구좌읍 월정리 1894
1214,구좌중앙초등학교,33.55118,126.79898,2568,2081,4649,2417,1999,4416,제주특별자치도 제주시 구좌읍 월정리 130-11
1215,행원리,33.55337,126.80771,2653,377,3030,2612,363,2975,제주특별자치도 제주시 구좌읍 행원리 727-1
1216,행원리,33.55293,126.80828,2077,289,2366,2034,275,2309,제주특별자치도 제주시 구좌읍 행원리 811-7
1217,행원농공단지,33.54936,126.8141,249,28,277,242,28,270,제주특별자치도 제주시 구좌읍 행원리 438-3
1218,행원농공단지,33.5493,126.81438,896,53,949,888,51,939,제주특별자치도 제주시 구좌읍 행원리 3554
1219,월정리,33.5519,126.79105,3143,1912,5055,2951,1820,4771,제주특별자치도 제주시 구좌읍 월정리 306-3
1220,월정리,33.55175,126.79115,1572,1381,2953,1494,1320,2814,제주특별자치도 제주시 구좌읍 월정리 214-5
1221,만장굴입구,33.54965,126.7789,526,602,1128,496,573,1069,제주특별자치도 제주시 구좌읍 월정리 1821-4
1222,만장굴입구,33.54925,126.7773,691,1017,1708,661,994,1655,제주특별자치도 제주시 구좌읍 월정리 1840-3
1223,지경곰,33.55198,126.76855,226,146,372,217,144,361,제주특별자치도 제주시 구좌읍 김녕리 2117
1224,지경곰,33.55229,126.76818,265,165,430,258,156,414,제주특별자치도 제주시 구좌읍 김녕리 2117
1225,김녕해수욕장,33.555820000000004,126.76029,1372,835,2207,1303,804,2107,제주특별자치도 제주시 구좌읍 김녕리 497-2
1226,김녕해수욕장,33.55617,126.75931,636,672,1308,606,646,1252,제주특별자치도 제주시 구좌읍 김녕리 501-2
1227,동성동,33.55563,126.75453,1251,363,1614,1217,347,1564,제주특별자치도 제주시 구좌읍 김녕리 2121
1228,김녕환승정류장(김녕초등학교),33.55503,126.75125,11553,3802,15355,11188,3596,14784,제주특별자치도 제주시 구좌읍 김녕리 2121
1229,김녕환승정류장(김녕초등학교),33.5549,126.75127,5075,1216,6291,4973,1157,6130,제주특별자치도 제주시 구좌읍 김녕리 1691-2
1230,김녕리,33.55422,126.74795,1527,522,2049,1503,502,2005,제주특별자치도 제주시 구좌읍 김녕리 6194
1231,김녕리,33.55438,126.74711,4788,273,5061,4736,249,4985,제주특별자치도 제주시 구좌읍 김녕리 3607
1232,남흘동,33.55535,126.74328,548,91,639,548,91,639,제주특별자치도 제주시 구좌읍 김녕리 6194
1233,남흘동,33.55543,126.74293,1685,178,1863,1649,170,1819,제주특별자치도 제주시 구좌읍 김녕리 6194
1234,동복리,33.553020000000004,126.71265,4471,346,4817,4401,335,4736,제주특별자치도 제주시 구좌읍 동복리 1759
1235,동복리,33.55292,126.71257,1230,316,1546,1192,309,1501,제주특별자치도 제주시 구좌읍 동복리 1484-3
1236,동복리휴게소,33.553329999999995,126.70765,134,114,248,128,106,234,제주특별자치도 제주시 구좌읍 동복리 1685-4
1237,북촌다려마을,33.55145,126.70148,255,149,404,247,147,394,제주특별자치도 제주시 조천읍 북촌리 361-2
1238,북촌다려마을,33.55107,126.70022,728,190,918,702,183,885,제주특별자치도 제주시 조천읍 북촌리 388-5
1239,북촌리,33.548120000000004,126.69503,7290,490,7780,7129,480,7609,제주특별자치도 제주시 조천읍 북촌리 632-1
1240,북촌리,33.54797,126.69523,707,216,923,657,205,862,제주특별자치도 제주시 조천읍 북촌리 634-3
1241,북촌리해동,33.54475,126.68695,191,99,290,186,91,277,제주특별자치도 제주시 조천읍 북촌리 1636-5
1242,북촌리해동,33.54418,126.68547,1232,264,1496,1198,239,1437,제주특별자치도 제주시 조천읍 북촌리 2688
1243,911의원,33.540620000000004,126.6784,222,43,265,206,42,248,제주특별자치도 제주시 조천읍 함덕리 261-24
1244,911의원,33.540690000000005,126.67808,455,37,492,445,37,482,제주특별자치도 제주시 조천읍 함덕리 261-10
1245,1100고지휴게소,33.357820000000004,126.46294,155,51,206,150,49,199,제주특별자치도 서귀포시 색달동 산 1-2
1246,한라산둘레길(천아숲길입구),33.4095,126.47705,86,4,90,79,4,83,제주특별자치도 제주시 해안동 산 219-10
1247,충혼묘지,33.4182,126.48995,188,27,215,182,19,201,제주특별자치도 제주시 노형동 산 17-3
1248,한라산둘레길(천아숲길입구),33.40935,126.47718,112,15,127,110,15,125,제주특별자치도 제주시 해안동 산 219-3
1249,어리목,33.39035,126.48531,1512,738,2250,1367,693,2060,제주특별자치도 제주시 해안동 산 220-1
1250,어리목입구,33.39022,126.48533,419,226,645,360,210,570,제주특별자치도 제주시 해안동 산 220-3
1251,충혼묘지,33.41827,126.48982,16,7,23,16,6,22,제주특별자치도 제주시 노형동 산 17-2
1252,봉개체육공원,33.48428,126.61158,465,200,665,452,195,647,제주특별자치도 제주시 회천동 1783-4
1253,성판악,33.38512,126.62049,5332,2219,7551,4996,2092,7088,제주특별자치도 제주시 조천읍 교래리 산 137-23
1254,봉개교,33.496759999999995,126.58166,100,3,103,100,3,103,제주특별자치도 제주시 봉개동 2735
1255,전원마을,33.47485,126.63871,770,130,900,765,122,887,제주특별자치도 제주시 조천읍 와흘리 2836
1256,초록마을,33.4712,126.64496,434,55,489,430,53,483,제주특별자치도 제주시 조천읍 와흘리 2871-1
1257,남조로검문소,33.46986,126.65782,678,109,787,665,103,768,제주특별자치도 제주시 조천읍 와흘리 125-3
1258,이기풍선교기념관,33.45656,126.6627,394,50,444,389,46,435,제주특별자치도 제주시 조천읍 대흘리 산 46-2
1259,제주돌문화공원,33.44747,126.66402,2113,1096,3209,1830,956,2786,제주특별자치도 제주시 조천읍 교래리 산 99-1
1260,교래사거리,33.43408,126.67206000000002,957,355,1312,896,334,1230,제주특별자치도 제주시 조천읍 교래리 산 60-19
1261,교래리,33.42463,126.67568,671,66,737,649,64,713,제주특별자치도 제주시 조천읍 교래리 산 36-2
1262,제주목장,33.41741,126.67799,660,96,756,642,93,735,제주특별자치도 제주시 조천읍 교래리 산 25-3
1263,제주목장,33.41726,126.67794,141,34,175,138,32,170,제주특별자치도 제주시 조천읍 교래리 산 25-3
1264,교래리,33.42588,126.67442,199,27,226,189,25,214,제주특별자치도 제주시 조천읍 교래리 837
1265,교래사거리,33.4344,126.67161000000002,465,193,658,436,180,616,제주특별자치도 제주시 조천읍 교래리 산 60-65
1266,제주돌문화공원,33.44615,126.66429,552,486,1038,495,445,940,제주특별자치도 제주시 조천읍 교래리 산 99-10
1267,이기풍선교기념관,33.45588,126.66228,82,21,103,80,20,100,제주특별자치도 제주시 조천읍 대흘리 산 46-2
1268,초록마을,33.47074,126.64615,60,43,103,56,43,99,제주특별자치도 제주시 조천읍 와흘리 2948-2
1269,전원마을,33.47456,126.63868,360,189,549,355,186,541,제주특별자치도 제주시 조천읍 와흘리 2819-1
1271,봉개교,33.49654,126.58155,188,12,200,187,12,199,제주특별자치도 제주시 봉개동 2698
1272,제주컨트리클럽,33.4327,126.58545,213,9,222,209,9,218,제주특별자치도 제주시 영평동 2263-1
1273,견월교,33.42401,126.60814,106,13,119,106,13,119,제주특별자치도 제주시 봉개동-457
1274,교래입구,33.41938,126.61678,614,141,755,588,138,726,제주특별자치도 제주시 봉개동 산 78-19
1275,교래입구,33.41923,126.61662,823,523,1346,786,496,1282,제주특별자치도 제주시 봉개동-457
1276,견월교,33.42378,126.60822,104,63,167,90,58,148,제주특별자치도 제주시 봉개동 산 78-6
1277,제주컨트리클럽,33.432959999999994,126.58505,42,11,53,42,10,52,제주특별자치도 제주시 영평동 2263-2
1281,와흘상동,33.49276,126.63477,22,2,24,22,1,23,제주특별자치도 제주시 조천읍 와흘리 2814
1282,장전리사무소,33.450990000000004,126.38821000000002,407,7,414,403,7,410,제주특별자치도 제주시 애월읍 장전리 362-5
1283,납읍리섯잣길,33.43673,126.32738,2100,21,2121,2069,21,2090,제주특별자치도 제주시 애월읍 납읍리 2422-3
1284,더럭초등학교,33.45415,126.34616,252,105,357,245,100,345,제주특별자치도 제주시 애월읍 하가리 1552-2
1286,하가리연못,33.4558,126.34839,576,84,660,567,65,632,제주특별자치도 제주시 애월읍 하가리 1369-4
1288,대흘초등학교,33.49897,126.6585,603,10,613,599,5,604,제주특별자치도 제주시 조천읍 대흘리 2787
1289,와산삼거리,33.49129,126.68226,579,22,601,571,22,593,제주특별자치도 제주시 조천읍 와산리 980-3
1290,제일농장,33.49282,126.66837,126,12,138,123,12,135,제주특별자치도 제주시 조천읍 대흘리 2787
1293,봉성하나로마트,33.41888,126.31265,490,2,492,489,2,491,제주특별자치도 제주시 애월읍 봉성리 4124-5
1294,하가리주승골,33.45774,126.35077,834,29,863,827,28,855,제주특별자치도 제주시 애월읍 하가리 941-2
1295,하가리노인회관,33.45782,126.35072,57,1,58,57,1,58,제주특별자치도 제주시 애월읍 하가리 947-7
1296,더럭초등학교,33.45424000000001,126.34607,20,17,37,20,17,37,제주특별자치도 제주시 애월읍 하가리 1575-1
1298,존손이굴,33.45243,126.36197,48,6,54,48,6,54,제주특별자치도 제주시 애월읍 하가리 168-3
1301,이시돌하단지,33.34496,126.32243,71,20,91,65,20,85,제주특별자치도 제주시 한림읍 금악리 111-1
1302,이시돌삼거리,33.3447,126.31695,37,2,39,37,2,39,제주특별자치도 제주시 한림읍 금악리 411
1304,동수동,33.51762,126.6225,603,4,607,598,4,602,제주특별자치도 제주시 조천읍 신촌리 1402-6
1311,이시돌하단지,33.34499,126.32256,142,30,172,138,29,167,제주특별자치도 제주시 한림읍 금악리 119-2
1313,상가리동동,33.45211,126.3466,370,17,387,368,15,383,제주특별자치도 제주시 애월읍 하가리 1585-1
1316,동회천,33.50455,126.61345,33,17,50,33,17,50,제주특별자치도 제주시 회천동 2326-4
1317,고산1리육거리,33.30096,126.17948,171,27,198,168,26,194,제주특별자치도 제주시 한경면 고산리 2822-13
1318,산양리,33.29351,126.23348,300,11,311,300,11,311,제주특별자치도 제주시 한경면 청수리 3329-1
1325,선린지,33.49305,126.71565,5,5,10,5,5,10,제주특별자치도 제주시 조천읍 선흘리 산 59-5
1326,알밤오름,33.49695,126.71281,117,38,155,116,38,154,제주특별자치도 제주시 조천읍 선흘리 334-14
1327,알밤오름,33.49678,126.7127,20,17,37,18,17,35,제주특별자치도 제주시 조천읍 선흘리 668
1328,웃가름,33.50927,126.70701,247,20,267,247,18,265,제주특별자치도 제주시 조천읍 선흘리 1277-2
1329,웃가름,33.508990000000004,126.70706,35,9,44,34,9,43,제주특별자치도 제주시 조천읍 선흘리 1275-3
1330,유수암(거문덕이),33.43105,126.4002,388,1,389,380,1,381,제주특별자치도 제주시 애월읍 유수암리 1603
1331,유수암(거문덕이),33.43095,126.40006,678,5,683,667,3,670,제주특별자치도 제주시 애월읍 유수암리 3236
1341,조천도서관,33.53719,126.6667,24,6,30,23,3,26,제주특별자치도 제주시 조천읍 함덕리 917-1
1343,하가삼거리,33.4561,126.3484,101,11,112,98,11,109,제주특별자치도 제주시 애월읍 하가리 1376-2
1348,광령2리사무소,33.44932,126.42912,729,15,744,723,15,738,제주특별자치도 제주시 애월읍 광령리 3068-4
1349,애월신협,33.46416,126.321,6258,400,6658,6173,387,6560,제주특별자치도 제주시 애월읍 애월리 1639-2
1353,한라도서관,33.47615,126.51472,2651,31,2682,2613,31,2644,제주특별자치도 제주시 오라이동 899-3
1355,제주국제공항(신제주방면),33.5061,126.49275,93750,35048,128798,91973,33263,125236,제주특별자치도 제주시 용담이동 1984-5
1356,제주절물자연휴양림,33.440259999999995,126.63018999999998,3825,338,4163,3749,322,4071,제주특별자치도 제주시 봉개동 산 78-1
1357,한라생태숲,33.429559999999995,126.59716,438,124,562,417,116,533,제주특별자치도 제주시 용강동 산 14-2
1358,한라생태숲,33.42981,126.59649,3477,201,3678,3393,198,3591,제주특별자치도 제주시 용강동 산 14-3
1359,제주도립미술관입구,33.45454,126.4871,113,77,190,112,72,184,제주특별자치도 제주시 노형동 286-3
1360,제주도립미술관입구,33.45465,126.48722,2440,1394,3834,2303,1325,3628,제주특별자치도 제주시 연동 2477
1363,도깨비공원,33.46553,126.69268999999998,280,6,286,275,6,281,제주특별자치도 제주시 조천읍 선흘리 4052-3
1364,제주삼다수,33.4214,126.67664,49,13,62,47,13,60,제주특별자치도 제주시 조천읍 교래리 산 34-13
1365,제주삼다수,33.42161,126.67673,371,17,388,365,16,381,제주특별자치도 제주시 조천읍 교래리 산 34-3
1366,사려니숲길,33.42304,126.62644,1064,306,1370,872,296,1168,제주특별자치도 제주시 봉개동 산 78-1
1367,사려니숲길,33.42308,126.6258,1595,565,2160,1529,545,2074,제주특별자치도 제주시 봉개동 산 78-1
1369,저지리알못,33.33589,126.26369,1,1,2,1,1,2,제주특별자치도 제주시 한경면 저지리 3258
1370,방림원,33.336890000000004,126.26734,122,66,188,119,65,184,제주특별자치도 제주시 한경면 저지리 2120-200
1371,방림원,33.33703,126.26732,142,101,243,133,100,233,제주특별자치도 제주시 한경면 저지리 2120-33
1372,저지리신흥동,33.33855,126.26396,68,12,80,68,12,80,제주특별자치도 제주시 한경면 저지리 2114-23
1373,신흥동,33.33863,126.26416,169,30,199,167,29,196,제주특별자치도 제주시 한경면 저지리 2114-23
1374,용수리마을회관,33.32529,126.16884,181,21,202,181,20,201,제주특별자치도 제주시 한경면 용수리 3445-7
1375,주구동산,33.32282,126.17026,65,13,78,64,8,72,제주특별자치도 제주시 한경면 용수리 4719-1
1377,별빛누리공원/난타공연장,33.44531,126.54847,1561,281,1842,1490,265,1755,제주특별자치도 제주시 오등동 10-34
1378,탐라교육원,33.42587,126.53277,469,7,476,466,7,473,제주특별자치도 제주시 오라이동 산 100
1379,관음사등산로입구,33.42245,126.54977,86,53,139,81,52,133,제주특별자치도 제주시 오등동 산 180-2
1380,관음사등산로입구,33.422340000000005,126.54963,79,17,96,77,16,93,제주특별자치도 제주시 오등동 산 180-2
1381,삼담우체국,33.50196,126.51279,94,2,96,94,2,96,제주특별자치도 제주시 용담일동 2830
1382,미래컨벤션센터,33.506640000000004,126.51475,1436,6,1442,1433,5,1438,제주특별자치도 제주시 용담일동 2583
1383,삼도119센터,33.51449,126.51778,608,132,740,601,127,728,제주특별자치도 제주시 용담일동 2578
1384,이화아파트,33.51814,126.53991,1895,99,1994,1881,91,1972,제주특별자치도 제주시 건입동 711
1385,사라봉경로당입구,33.51615,126.53853,845,51,896,842,51,893,제주특별자치도 제주시 건입동 711
1386,제주해변공연장,33.51746,126.52252,9230,673,9903,9105,650,9755,제주특별자치도 제주시 삼도이동 1192-1
1387,사라봉경로당입구,33.51559,126.53831,3658,40,3698,3633,39,3672,제주특별자치도 제주시 건입동 1047-1
1388,이화아파트,33.51828,126.53985,3109,93,3202,3055,88,3143,제주특별자치도 제주시 건입동 711
1389,제주해변공연장,33.5173,126.52247,3047,295,3342,2997,281,3278,제주특별자치도 제주시 삼도이동 1192-2
1390,삼도119센터,33.51457,126.51789,402,145,547,396,140,536,제주특별자치도 제주시 삼도이동 1227-1
1391,미래컨벤션센터,33.506609999999995,126.51482,1233,15,1248,1223,15,1238,제주특별자치도 제주시 용담일동 2583
1392,화북휴먼시아,33.51717,126.57382,4825,33,4858,4795,32,4827,제주특별자치도 제주시 화북일동 1027
1393,화북휴먼시아,33.51737,126.57468,38139,194,38333,37845,193,38038,제주특별자치도 제주시 화북일동 29-9
1394,축산진흥원입구,33.446909999999995,126.48755,1134,75,1209,1080,68,1148,제주특별자치도 제주시 노형동 293-17
1395,축산진흥원입구,33.44686,126.48744,84,18,102,83,18,101,제주특별자치도 제주시 노형동 293-17
1396,화북공업지역입구,33.51173,126.56453,800,1,801,797,1,798,제주특별자치도 제주시 화북이동 3713-7
1397,구산마을,33.483290000000004,126.53801,6841,91,6932,6750,84,6834,제주특별자치도 제주시 아라일동 2612-11
1398,구산마을,33.48314,126.53809,1331,2,1333,1312,2,1314,제주특별자치도 제주시 아라일동 2408-9
1400,황세왓동산,33.49313,126.56713,36,1,37,36,1,37,제주특별자치도 제주시 영평동 1288-3
1407,웃드르빛센터,33.302440000000004,126.25875,13,12,25,12,12,24,제주특별자치도 제주시 한경면 청수리 147-6
1409,산양리감귤선과장,33.30303,126.23761,5,2,7,5,2,7,제주특별자치도 제주시 한경면 낙천리 532
1410,산양리감귤선과장,33.30301,126.23776,82,2,84,82,2,84,제주특별자치도 제주시 한경면 낙천리 531-2
1413,일성콘도미니엄,33.3851,126.2215,117,70,187,111,67,178,제주특별자치도 제주시 한림읍 금능리 2316
1414,일성콘도미니엄,33.38499,126.22169,478,117,595,454,104,558,제주특별자치도 제주시 한림읍 금능리 1869-1
1415,수원주유소,33.42371,126.26651,714,45,759,698,44,742,제주특별자치도 제주시 한림읍 수원리 1027-7
1416,수원주유소,33.42373,126.26675,1411,66,1477,1380,63,1443,제주특별자치도 제주시 한림읍 수원리 826-20
1417,봉성리사무소,33.42219,126.31295,142,4,146,140,4,144,제주특별자치도 제주시 애월읍 봉성리 3808-14
1418,봉성리사무소,33.42219,126.3127,95,3,98,95,3,98,제주특별자치도 제주시 애월읍 봉성리 3808-6
1419,어음1리입구,33.41838,126.32665,7,1,8,7,1,8,제주특별자치도 제주시 애월읍 봉성리 1747-2
1420,어음1리입구,33.418420000000005,126.32662,146,4,150,145,4,149,제주특별자치도 제주시 애월읍 봉성리 1747-1
1421,삼남내,33.47071,126.77633,70,9,79,70,9,79,제주특별자치도 제주시 구좌읍 송당리 1571-21
1422,삼남내,33.470620000000004,126.77611,295,46,341,293,44,337,제주특별자치도 제주시 구좌읍 송당리 2791
1423,송당물혹,33.47088,126.78652,156,53,209,154,52,206,제주특별자치도 제주시 구좌읍 송당리 1389-27
1424,송당물혹,33.47098,126.78593,146,59,205,144,57,201,제주특별자치도 제주시 구좌읍 송당리 1467-5
1425,알송당,33.48378,126.78735,20,6,26,20,6,26,제주특별자치도 제주시 구좌읍 송당리 2774
1426,알송당,33.48375,126.78724,38,3,41,37,2,39,제주특별자치도 제주시 구좌읍 송당리 521-6
1427,대림동,33.4992,126.75525,2,2,4,2,2,4,제주특별자치도 제주시 구좌읍 덕천리 776
1428,대림동,33.499,126.75497,1,1,2,1,1,2,제주특별자치도 제주시 구좌읍 덕천리 1796
1429,멍중내,33.5007,126.6886,1,2,3,1,2,3,제주특별자치도 제주시 조천읍 선흘리 3138-2
1432,제주국제자유도시개발센터,33.45283,126.57125,379,6,385,356,6,362,제주특별자치도 제주시 영평동 2184
1433,제주국제자유도시개발센터,33.452729999999995,126.57146000000002,3963,137,4100,3934,135,4069,제주특별자치도 제주시 영평동 2273
1434,제주국제대학교,33.44141,126.57216,239,5,244,236,5,241,제주특별자치도 제주시 영평동 2235
1437,가물개공원,33.52455,126.58482,449,7,456,447,7,454,제주특별자치도 제주시 삼양이동 2182-1
1439,삼양3동,33.524680000000004,126.5797,153,5,158,153,5,158,제주특별자치도 제주시 삼양삼동 2582-1
1440,하귀휴먼시아입구,33.48572,126.41545,5943,52,5995,5888,50,5938,제주특별자치도 제주시 애월읍 하귀1리 562
1441,하귀휴먼시아1단지,33.48368,126.41618,6723,53,6776,6647,51,6698,제주특별자치도 제주시 애월읍 하귀1리 562
1442,하귀휴먼시아2단지앞,33.4813,126.41485,2836,28,2864,2807,26,2833,제주특별자치도 제주시 애월읍 하귀1리 562
1443,하귀휴먼시아입구,33.48573,126.41515,511,10,521,502,10,512,제주특별자치도 제주시 애월읍 하귀1리 137-3
1444,하귀휴먼시아1단지,33.48338,126.41587,1440,9,1449,1418,9,1427,제주특별자치도 제주시 애월읍 하귀1리 562
1446,서문사거리,33.51079,126.5198,19,4,23,19,4,23,제주특별자치도 제주시 용담일동 2578
1447,라마다프라자제주호텔,33.51823,126.51848,579,271,850,570,253,823,제주특별자치도 제주시 삼도이동 1222-45
1448,라마다프라자제주호텔,33.51838,126.51856,2362,801,3163,2349,752,3101,제주특별자치도 제주시 삼도이동 1264
1449,카카오,33.45126,126.57122,222,87,309,219,84,303,제주특별자치도 제주시 영평동 2180
1450,디지털융합센터,33.4513,126.57146000000002,2722,500,3222,2699,494,3193,제주특별자치도 제주시 영평동 2273
1451,도평입구,33.4795,126.46504,499,77,576,486,75,561,제주특별자치도 제주시 노형동 3766
1452,도평입구,33.47946,126.46528,367,72,439,364,66,430,제주특별자치도 제주시 노형동 3129-6
1453,부민장례식장,33.48076,126.52241,2088,19,2107,2062,19,2081,제주특별자치도 제주시 도남동 1237-1
1454,부민장례식장,33.480920000000005,126.52234,1912,23,1935,1875,23,1898,제주특별자치도 제주시 도남동 1237-1
1455,한일베라체,33.4948,126.54836,4068,47,4115,4024,45,4069,제주특별자치도 제주시 이도이동 150-1
1456,한일베라체,33.494170000000004,126.54855,5614,96,5710,5593,96,5689,제주특별자치도 제주시 이도이동 1956
1457,거로사거리,33.50765,126.55701,211,7,218,210,6,216,제주특별자치도 제주시 화북이동 5128-2
1458,거로사거리,33.507,126.55526,816,34,850,812,33,845,제주특별자치도 제주시 건입동 9-1
1459,거로사거리,33.50778,126.5555,393,22,415,390,22,412,제주특별자치도 제주시 화북이동 5758
1460,거로사거리,33.50689000000001,126.557,1448,78,1526,1433,75,1508,제주특별자치도 제주시 화북이동 5755-1
1461,신광사거리,33.49384000000001,126.49333,396,99,495,388,91,479,제주특별자치도 제주시 연동 1928-4
1462,연동365의원,33.481759999999994,126.4912,5677,162,5839,5614,155,5769,제주특별자치도 제주시 연동 1546
1463,메종글래드제주,33.48608,126.4869,3747,289,4036,3671,268,3939,제주특별자치도 제주시 연동 252-14
1464,연동365의원,33.48196,126.49231,7853,316,8169,7718,306,8024,제주특별자치도 제주시 연동 1373-3
1465,한국BMI,33.44907,126.57299,3635,33,3668,3624,33,3657,제주특별자치도 제주시 영평동 2273
1467,첨단꿈에그린3단지아파트,33.4505,126.57721,58,2,60,58,1,59,제주특별자치도 제주시 월평동 747
1469,구산마을입구,33.4844,126.53505,4253,39,4292,4190,38,4228,제주특별자치도 제주시 아라일동 2567
1470,구산마을입구,33.483909999999995,126.53639,1020,11,1031,999,11,1010,제주특별자치도 제주시 아라일동 2602-4
1471,제주여자중고등학교제주지방해양경찰청,33.48516,126.54182,11153,147,11300,10996,147,11143,제주특별자치도 제주시 아라일동 2419-9
1472,제주여자중고등학교,33.485,126.54171,3687,16,3703,3635,16,3651,제주특별자치도 제주시 아라일동 2370-3
1474,하도리서문동,33.52722,126.8814,102,25,127,101,25,126,제주특별자치도 제주시 구좌읍 하도리 1931-3
1475,선진동,33.45753,126.70321,1413,259,1672,1384,252,1636,제주특별자치도 제주시 조천읍 선흘리 1938-10
1477,신연동,33.31624,126.2495,2,3,5,2,3,5,제주특별자치도 제주시 한경면 청수리 604-8
1479,가시나물,33.47252,126.56995,6150,37,6187,6001,37,6038,제주특별자치도 제주시 영평동 1924-4
1480,가시나물,33.471090000000004,126.57014,842,2,844,819,2,821,제주특별자치도 제주시 영평동 2010-2
1481,달샘마을,33.474509999999995,126.57015,2161,15,2176,2109,15,2124,제주특별자치도 제주시 월평동 1373-8
1482,달샘마을,33.47442,126.56996,664,14,678,654,14,668,제주특별자치도 제주시 월평동 1379
1483,제주삼양동유적,33.5232,126.58642,4548,142,4690,4469,124,4593,제주특별자치도 제주시 삼양이동 2124-2
1484,제주삼양동유적,33.52294000000001,126.58675,292,2,294,291,2,293,제주특별자치도 제주시 삼양이동 2184-1
1485,오라동주민센터,33.4952,126.51259,62,3,65,62,3,65,제주특별자치도 제주시 오라일동 1246-6
1486,오라1동복지회관,33.49392,126.51639,84,2,86,84,2,86,제주특별자치도 제주시 오라일동 1287-3
1487,해병대제9여단,33.47729,126.49974,339,7,346,336,6,342,제주특별자치도 제주시 연동 489-16
1488,해병대제9여단,33.477509999999995,126.49975,261,16,277,260,16,276,제주특별자치도 제주시 연동 489-9
1489,방선문빌리지,33.47766,126.5368,1177,1,1178,1166,1,1167,제주특별자치도 제주시 아라일동 2807-4
1490,방선문빌리지,33.47767,126.53635,2386,29,2415,2356,28,2384,제주특별자치도 제주시 아라일동 2807-1
1491,함덕농협주유소,33.5365,126.67492,394,5,399,390,5,395,제주특별자치도 제주시 조천읍 함덕리 72-141
1492,신사동(종점),33.52537,126.67791,8925,210,9135,8787,202,8989,제주특별자치도 제주시 조천읍 함덕리 317-12
1493,신산마을입구,33.479409999999994,126.45786,389,3,392,385,3,388,제주특별자치도 제주시 도평동 19-7
1494,신산마을입구,33.47922,126.45885,1376,9,1385,1363,9,1372,제주특별자치도 제주시 도평동 15-7
1495,한라도서관입구,33.480979999999995,126.51636,1016,12,1028,999,12,1011,제주특별자치도 제주시 오라이동 1567-3
1496,한라도서관입구,33.481190000000005,126.51493,1094,20,1114,1069,20,1089,제주특별자치도 제주시 오라이동 1550-5
1497,오등동입구,33.48123,126.52934,2926,25,2951,2900,25,2925,제주특별자치도 제주시 도남동 439-6
1498,오등동입구,33.48141,126.53056,2344,7,2351,2322,7,2329,제주특별자치도 제주시 도남동 214-2
1499,제주영지학교,33.489290000000004,126.54267,4103,24,4127,4040,24,4064,제주특별자치도 제주시 이도이동 695-3
1500,제주영지학교,33.48919,126.5429,2958,7,2965,2936,7,2943,제주특별자치도 제주시 이도이동 695-3
1501,탐라중학교,33.49075,126.5453,2620,11,2631,2514,10,2524,제주특별자치도 제주시 아라이동 1262-6
1502,탐라중학교,33.49112,126.54552,5740,53,5793,5671,53,5724,제주특별자치도 제주시 아라이동 1262-6
1503,한마음병원,33.496,126.54735,5181,67,5248,5141,66,5207,제주특별자치도 제주시 이도이동 212-5
1504,한마음병원,33.495940000000004,126.5472,5789,66,5855,5760,64,5824,제주특별자치도 제주시 이도이동 256-4
1505,돌선밭,33.45415,126.42516,345,5,350,343,5,348,제주특별자치도 제주시 애월읍 광령리 4059-2
1506,돌선밭,33.45397,126.42517,59,2,61,55,2,57,제주특별자치도 제주시 애월읍 광령리 4059-1
1507,던덕모롤,33.462309999999995,126.40817,192,2,194,190,2,192,제주특별자치도 제주시 애월읍 상귀리 698-2
1508,던덕모롤,33.4624,126.40838,261,2,263,254,2,256,제주특별자치도 제주시 애월읍 고성리 1412-1
1509,삼담우체국,33.50253,126.51304,690,15,705,684,14,698,제주특별자치도 제주시 용담일동 2830
1510,용해로,33.51522,126.50258,669,110,779,658,109,767,제주특별자치도 제주시 용담삼동 1034-4
1511,용해로,33.51575,126.50226,295,183,478,284,175,459,제주특별자치도 제주시 용담삼동 1034-26
1512,도두동,33.50287,126.4662,499,78,577,493,77,570,제주특별자치도 제주시 도두일동 2531-1
1513,우령서로입구,33.49155,126.4264,559,4,563,555,4,559,제주특별자치도 제주시 외도일동 648-1
1514,우령서로입구,33.49179,126.42621,2892,15,2907,2851,13,2864,제주특별자치도 제주시 외도일동 648-1
1515,함덕리(4구),33.53929,126.67422,506,91,597,499,90,589,제주특별자치도 제주시 조천읍 함덕리 4150-3
1517,하귀농협장례식장,33.47249,126.42647,176,3,179,173,3,176,제주특별자치도 제주시 애월읍 광령리 3674-4
1518,하귀1리,33.47222,126.41909,274,8,282,270,8,278,제주특별자치도 제주시 애월읍 하귀1리 909-1
1519,하귀1리,33.472409999999996,126.41769,16,3,19,16,3,19,제주특별자치도 제주시 애월읍 하귀1리 1130-4
1520,애조로광령1리입구,33.47137,126.43562,337,11,348,327,11,338,제주특별자치도 제주시 애월읍 광령리 1751-1
1521,애조로광령1리입구,33.47213,126.43417,26,6,32,25,6,31,제주특별자치도 제주시 애월읍 광령리 1695-6
1522,사라마을,33.46929,126.44087,405,11,416,405,11,416,제주특별자치도 제주시 애월읍 광령리 1872-2
1523,사라마을,33.46986,126.44001000000002,154,1,155,152,1,153,제주특별자치도 제주시 애월읍 광령리 1872-2
1525,청소년수련원,33.45456,126.61874,252,12,264,251,12,263,제주특별자치도 제주시 봉개동 2736
1526,4.3평화공원,33.451190000000004,126.62162,12,6,18,10,6,16,제주특별자치도 제주시 봉개동 산 78-30
1527,4.3평화공원,33.45103,126.6219,485,142,627,478,139,617,제주특별자치도 제주시 봉개동 산 53-1
1528,청소년수련원,33.45425,126.61921,383,66,449,374,62,436,제주특별자치도 제주시 봉개동 234-158
1529,4.3평화공원입구,33.453109999999995,126.62009,5,3,8,5,3,8,제주특별자치도 제주시 봉개동 237-2
1530,교래자연휴양림,33.443090000000005,126.66629,12,5,17,11,5,16,제주특별자치도 제주시 조천읍 교래리 산 52-1
1531,교래자연휴양림,33.44373,126.66605,1043,601,1644,856,522,1378,제주특별자치도 제주시 조천읍 교래리 산 52-1
1532,S중앙병원,33.49285,126.47167,4855,220,5075,4822,217,5039,제주특별자치도 제주시 도두일동 2280-3
1533,S중앙병원,33.49293,126.47182,3215,104,3319,3177,100,3277,제주특별자치도 제주시 도두일동 2280-3
1534,새마을금고연수원,33.41341,126.39676,143,26,169,139,25,164,제주특별자치도 제주시 애월읍 유수암리 3256
1535,새마을금고연수원,33.41285,126.39717,1053,91,1144,1010,82,1092,제주특별자치도 제주시 애월읍 유수암리 3257
1537,김녕미로공원,33.53613,126.77247,81,144,225,77,141,218,제주특별자치도 제주시 구좌읍 김녕리 산 38-1
1538,김녕미로공원,33.53604,126.77249,1305,1434,2739,1246,1402,2648,제주특별자치도 제주시 구좌읍 김녕리 산 38-1
1539,"다랑쉬오름입구(남),손지오름",33.46031,126.81712,317,351,668,311,347,658,제주특별자치도 제주시 구좌읍 세화리 3593-18
1540,"다랑쉬오름입구(남),손지오름",33.46024,126.81713,371,423,794,357,408,765,제주특별자치도 제주시 구좌읍 송당리 1-11
1541,메이즈랜드,33.49087,126.79907,190,202,392,186,196,382,제주특별자치도 제주시 구좌읍 한동리 4848
1542,근로복지공단,33.49986,126.54453999999998,1932,14,1946,1909,14,1923,제주특별자치도 제주시 일도이동 115
1543,근로복지공단,33.49983,126.54436,5602,41,5643,5548,41,5589,제주특별자치도 제주시 이도이동 443
1544,화북휴먼시아정문,33.51597,126.57632,6615,46,6661,6544,46,6590,제주특별자치도 제주시 화북일동 1002-1
1545,성수동,33.48095,126.4128,82,3,85,82,3,85,제주특별자치도 제주시 애월읍 하귀1리 215-8
1546,성수동,33.48079,126.41274,540,10,550,535,10,545,제주특별자치도 제주시 애월읍 하귀1리 586
1547,광평고치동산,33.4836,126.46373,607,9,616,604,9,613,제주특별자치도 제주시 노형동 2920-5
1549,대흘1리,33.49889,126.65166,26,8,34,25,8,33,제주특별자치도 제주시 조천읍 대흘리 2345-5
1551,멍중내,33.51123,126.6863,27,12,39,27,12,39,제주특별자치도 제주시 조천읍 선흘리 3687-5
1555,개법사,33.40442,126.33823,63,1,64,63,1,64,제주특별자치도 제주시 애월읍 어음리 3902
1556,두인빌라삼거리,33.42407,126.40409,167,2,169,165,2,167,제주특별자치도 제주시 애월읍 유수암리 1381-12
1557,두인빌라삼거리,33.4241,126.40412,142,2,144,141,2,143,제주특별자치도 제주시 애월읍 유수암리 1381-6
1558,유수암리입구,33.44339,126.39103,7,4,11,7,4,11,제주특별자치도 제주시 애월읍 장전리 628-2
1560,웃거리,33.43942,126.40256,75,3,78,75,3,78,제주특별자치도 제주시 애월읍 유수암리 1779-3
1561,웃거리,33.439840000000004,126.40307,181,3,184,180,3,183,제주특별자치도 제주시 애월읍 유수암리 3234
1562,전국환경감시협회,33.462270000000004,126.66095,204,8,212,182,8,190,제주특별자치도 제주시 조천읍 와흘리 산 13-6
1564,제주시외버스터미널,33.49946,126.51479,165061,11955,177016,162692,11434,174126,제주특별자치도 제주시 오라일동 2455-16
1565,시외버스출발지(가상정류소),33.49946,126.51478,116638,10105,126743,114107,9532,123639,제주특별자치도 제주시 오라일동 2441-4
1566,금능해수욕장,33.389540000000004,126.23559,730,496,1226,669,471,1140,제주특별자치도 제주시 한림읍 협재리 2689-2
1567,금능해수욕장,33.38947,126.23565,2051,800,2851,1915,770,2685,제주특별자치도 제주시 한림읍 협재리 2689-2
1568,당동산,33.46001,126.4334,206,5,211,203,5,208,제주특별자치도 제주시 애월읍 광령리 2150-4
1569,제주자동차검사정비사업조합,33.510290000000005,126.56191,1271,2,1273,1259,2,1261,제주특별자치도 제주시 화북이동 3583-5
1570,거로마을,33.50983,126.56043,2158,14,2172,2138,14,2152,제주특별자치도 제주시 화북이동 3467-1
1571,제주국제대학교,33.441320000000005,126.57243,3329,88,3417,3279,84,3363,제주특별자치도 제주시 영평동 2235
1572,제주절물자연휴양림,33.4407,126.63025,7094,697,7791,6924,637,7561,제주특별자치도 제주시 봉개동 산 65-1
1573,노루생태관찰원,33.44485,126.62753,432,95,527,426,85,511,제주특별자치도 제주시 봉개동 산 53-18
1575,영등물,33.55556,126.73614,294,112,406,288,109,397,제주특별자치도 제주시 구좌읍 김녕리 4322
1576,금산목,33.55366,126.80524,1135,193,1328,1111,185,1296,제주특별자치도 제주시 구좌읍 행원리 1351-2
1577,삼양3동포구,33.52717,126.57623999999998,912,18,930,906,18,924,제주특별자치도 제주시 삼양삼동 2682
1578,별빛누리공원/난타공연장,33.445440000000005,126.54831,325,62,387,301,58,359,제주특별자치도 제주시 오등동 10-1
1579,제주국제공항(600번),33.50577,126.49252,9129,25270,34399,9129,25270,34399,제주특별자치도 제주시 용담이동 1984-5
1580,전경대입구,33.50679,126.87714,72,4,76,71,3,74,제주특별자치도 제주시 구좌읍 상도리 산 7-2
1581,전경대입구,33.506809999999994,126.87764,539,11,550,534,11,545,제주특별자치도 제주시 구좌읍 하도리 산 76
1582,동부위생처리장입구,33.43631,126.69538,6,3,9,6,2,8,제주특별자치도 제주시 조천읍 교래리 산 39
1583,동부위생처리장입구,33.43645,126.69547,132,6,138,132,6,138,제주특별자치도 제주시 조천읍 교래리 산 39-3
1584,셰프라인월드,33.43468,126.73162,9,8,17,8,8,16,제주특별자치도 제주시 구좌읍 송당리 2635-1
1585,셰프라인월드,33.43489,126.73242,45,5,50,44,5,49,제주특별자치도 제주시 구좌읍 송당리 2635-3
1586,환경시설관리소,33.480340000000005,126.62542,74,32,106,72,32,104,제주특별자치도 제주시 회천동 424-10
1587,환경시설관리소,33.47952,126.62572,32,14,46,31,14,45,제주특별자치도 제주시 회천동 422-7
1588,당동산,33.4599,126.4336,692,14,706,688,14,702,제주특별자치도 제주시 애월읍 광령리 2151-1
1589,번대동,33.477740000000004,126.39225,2528,142,2670,2500,131,2631,제주특별자치도 제주시 애월읍 하귀2리 2966-5
1590,청용사,33.44166,126.33074,446,12,458,442,12,454,제주특별자치도 제주시 애월읍 납읍리 1827-7
1591,청용사,33.44191,126.33082,211,2,213,209,2,211,제주특별자치도 제주시 애월읍 납읍리 1781-1
1592,가원,33.49866,126.5629,38,1,39,37,1,38,제주특별자치도 제주시 화북이동 3089-1
1593,다희연,33.48723,126.70605,27,6,33,26,6,32,제주특별자치도 제주시 조천읍 선흘리 1672-2
1594,다희연,33.48748,126.70633,104,104,208,101,104,205,제주특별자치도 제주시 조천읍 선흘리 1672
1595,비자림로교래입구,33.41913,126.61716,482,568,1050,459,538,997,제주특별자치도 제주시 봉개동 산 78-1
1597,고상동,33.508590000000005,126.67321,35,1,36,32,1,33,제주특별자치도 제주시 조천읍 대흘리 144
1600,서부신협유통영농조합,33.3356,126.26114,4,3,7,4,3,7,제주특별자치도 제주시 한경면 저지리 2095-1
1601,저지리,33.3267,126.25343,20,4,24,20,4,24,제주특별자치도 제주시 한경면 저지리 1522-11
1602,청소년수련원,33.3776,126.23875,103,23,126,100,22,122,제주특별자치도 제주시 한림읍 협재리 2838
1603,청소년수련원,33.37684,126.23882,50,9,59,48,9,57,제주특별자치도 제주시 한림읍 금능리 산 19-5
1604,금능농공단지입구,33.36258,126.24721,2,4,6,2,4,6,제주특별자치도 제주시 한림읍 금능리 485-3
1605,금능농공단지입구,33.36266,126.24737,119,15,134,116,15,131,제주특별자치도 제주시 한림읍 금능리 485-6
1606,금능농공단지,33.35913,126.24327,54,6,60,53,6,59,제주특별자치도 제주시 한림읍 금능리 407-7
1607,금능농공단지,33.35899000000001,126.24346,348,23,371,341,23,364,제주특별자치도 제주시 한림읍 금능리 407-18
1608,더마파크,33.3571,126.24281,34,28,62,34,27,61,제주특별자치도 제주시 한림읍 금능리 2318
1609,더마파크,33.35725,126.24304,49,41,90,42,40,82,제주특별자치도 제주시 한림읍 금능리 409-2
1610,서부농업기술센터,33.35281,126.24745,30,5,35,30,5,35,제주특별자치도 제주시 한림읍 금능리 산 23-2
1612,제주유리의성,33.31413,126.27191,222,86,308,209,82,291,제주특별자치도 제주시 한경면 저지리 산 39-2
1613,제주유리의성,33.31367,126.27206,212,225,437,210,221,431,제주특별자치도 제주시 한경면 저지리 산 37-10
1614,제주평화양로원,33.46524,126.61133999999998,1302,36,1338,1297,33,1330,제주특별자치도 제주시 봉개동 234-200
1615,제주평화양로원,33.4655,126.61112,25,4,29,23,4,27,제주특별자치도 제주시 봉개동 275-39
1616,안국사,33.4686,126.61119,419,16,435,416,16,432,제주특별자치도 제주시 봉개동 2736
1617,안국사,33.46897,126.61088,10,2,12,7,1,8,제주특별자치도 제주시 봉개동 319
1619,방애왓,33.48123,126.60525,148,4,152,148,4,152,제주특별자치도 제주시 봉개동 685-18
1621,명도암,33.473859999999995,126.60987,23,2,25,22,2,24,제주특별자치도 제주시 봉개동 458-1
1622,축산마을,33.44656,126.4859,381,28,409,370,28,398,제주특별자치도 제주시 노형동 315-6
1623,월정리용천동,33.55072,126.78275,55,53,108,51,52,103,제주특별자치도 제주시 구좌읍 월정리 1320-2
1624,월정리용천동,33.5506,126.78202,4814,2218,7032,4533,2092,6625,제주특별자치도 제주시 구좌읍 월정리 1320-1
1626,애월하나로마트,33.46008,126.3213,2994,150,3144,2947,146,3093,제주특별자치도 제주시 애월읍 애월리 1400-7
1627,애월하나로마트,33.46001,126.32112,387,15,402,383,13,396,제주특별자치도 제주시 애월읍 애월리 1378-5
1628,붉은오름휴양림입구,33.40241,126.68274,236,50,286,233,49,282,제주특별자치도 서귀포시 표선면 가시리 산 158-3
1629,붉은오름휴양림입구,33.40326,126.68277,589,115,704,565,108,673,제주특별자치도 서귀포시 표선면 가시리 산 158-5
1630,메이즈랜드,33.49068,126.79833,347,207,554,334,201,535,제주특별자치도 제주시 구좌읍 한동리 4458-1
1632,한림천주교회,33.417790000000004,126.26528,546,30,576,539,30,569,제주특별자치도 제주시 한림읍 한림리 1309-3
1636,롯데호텔,33.24872,126.41032,858,1378,2236,858,1378,2236,제주특별자치도 서귀포시 색달동 2812-4
1637,캐슬렉스골프클럽,33.33905,126.35627,157,28,185,150,27,177,제주특별자치도 서귀포시 안덕면 광평리 산 123-5
1638,캐슬렉스골프클럽,33.33735,126.35543,237,5,242,237,5,242,제주특별자치도 서귀포시 안덕면 광평리 349
1639,상창보건진료소,33.274640000000005,126.36294,1855,982,2837,1754,935,2689,제주특별자치도 서귀포시 안덕면 상창리 626-2
1640,상창보건진료소,33.27458,126.3628,2443,636,3079,2401,610,3011,제주특별자치도 서귀포시 안덕면 상창리 626-2
1641,우남동,33.264540000000004,126.3909,1234,246,1480,1199,233,1432,제주특별자치도 서귀포시 상예동 4999
1642,우남동,33.26432,126.39088999999998,2490,205,2695,2451,195,2646,제주특별자치도 서귀포시 상예동 4999
1643,소보리당입구,33.26419,126.38201,32,8,40,31,7,38,제주특별자치도 서귀포시 상예동 4999
1644,예래사우나,33.26418,126.38501,519,105,624,497,93,590,제주특별자치도 서귀포시 상예동 2802-2
1645,중문관광단지입구,33.25593,126.41262,10795,4132,14927,10261,3967,14228,제주특별자치도 서귀포시 색달동 3383
1646,중문관광단지입구,33.255790000000005,126.4126,2588,763,3351,2531,720,3251,제주특별자치도 서귀포시 색달동 2551-3
1647,예래입구,33.25869,126.40464,3475,1541,5016,3388,1509,4897,제주특별자치도 서귀포시 색달동 3391
1648,예래입구,33.25862,126.40442,2434,730,3164,2332,694,3026,제주특별자치도 서귀포시 색달동 3391
1649,회수삼거리,33.26133,126.4424,616,1,617,612,1,613,제주특별자치도 서귀포시 회수동 769-2
1650,회수삼거리,33.26112,126.44223999999998,130,12,142,128,11,139,제주특별자치도 서귀포시 회수동 770-5
1651,볼목당,33.25665,126.43613,308,2,310,307,2,309,제주특별자치도 서귀포시 중문동 1835-2
1653,1100도로입구,33.25159,126.43164,1996,626,2622,1958,561,2519,제주특별자치도 서귀포시 중문동 1918-3
1654,대천동주민센터,33.25088,126.47828,2786,58,2844,2734,57,2791,제주특별자치도 서귀포시 도순동 266-5
1655,대천동주민센터,33.25107,126.47832,52,4,56,52,4,56,제주특별자치도 서귀포시 도순동 266-4
1656,도순동,33.25275,126.47478,3309,55,3364,3253,53,3306,제주특별자치도 서귀포시 도순동 896-12
1657,도순동,33.25263,126.4733,3566,29,3595,3526,27,3553,제주특별자치도 서귀포시 도순동 811
1658,속도르,33.252959999999995,126.46983,419,16,435,409,16,425,제주특별자치도 서귀포시 도순동 786-1
1659,속도르,33.25271,126.47048,286,2,288,283,2,285,제주특별자치도 서귀포시 도순동 759-4
1660,제주국제컨벤션센터중문대포해안주상절리대,33.24309,126.42472,1974,1150,3124,1896,1109,3005,제주특별자치도 서귀포시 중문동 2504
1661,씨에스호텔,33.24385,126.42033,1381,774,2155,1365,741,2106,제주특별자치도 서귀포시 중문동 2643-4
1662,씨에스호텔,33.24362,126.42032,72,331,403,72,331,403,제주특별자치도 서귀포시 중문동 2798-9
1663,상예2동,33.2644,126.3772,1026,47,1073,1021,45,1066,제주특별자치도 서귀포시 상예동 4999
1664,상예2동,33.26417,126.37717,2887,39,2926,2870,39,2909,제주특별자치도 서귀포시 상예동 4631-7
1665,창천리,33.26541,126.37153,5693,1444,7137,5573,1397,6970,제주특별자치도 서귀포시 안덕면 창천리 155-14
1666,창천리,33.26598,126.37082,2916,424,3340,2887,406,3293,제주특별자치도 서귀포시 안덕면 창천리 153-6
1667,지세못,33.253029999999995,126.46423,1615,28,1643,1595,26,1621,제주특별자치도 서귀포시 하원동 328-1
1668,서진아파트,33.25334,126.46391,1354,22,1376,1333,19,1352,제주특별자치도 서귀포시 하원동 1878
1669,하원동,33.25367,126.46167,6825,127,6952,6731,112,6843,제주특별자치도 서귀포시 월평동 232-4
1670,하원동,33.25413,126.4606,5633,137,5770,5493,134,5627,제주특별자치도 서귀포시 하원동 1878
1671,중문고등학교,33.252759999999995,126.44858,8500,194,8694,8100,187,8287,제주특별자치도 서귀포시 대포동 533-2
1672,중문고등학교,33.25283,126.4477,5553,360,5913,5454,348,5802,제주특별자치도 서귀포시 대포동 628-7
1673,한국통신,33.25367,126.51155,268,17,285,264,17,281,제주특별자치도 서귀포시 서호동 1478-2
1674,한국통신,33.25312,126.51116,77,24,101,76,23,99,제주특별자치도 서귀포시 법환동 753
1675,신시가지,33.24978,126.50628,10211,403,10614,10045,385,10430,제주특별자치도 서귀포시 강정동 248-3
1676,성산하이츠빌라,33.25011,126.5048,5531,375,5906,5430,362,5792,제주특별자치도 서귀포시 강정동 186-4
1677,반참모르,33.25022,126.50113,6610,168,6778,6500,162,6662,제주특별자치도 서귀포시 강정동 5630-1
1678,반참모르,33.25,126.5011,19,5,24,19,2,21,제주특별자치도 서귀포시 강정동 1233-2
1679,염돈,33.2499,126.49478,1490,35,1525,1471,35,1506,제주특별자치도 서귀포시 강정동 2144-5
1680,염돈동,33.25012,126.49405,767,28,795,759,27,786,제주특별자치도 서귀포시 강정동 2093-3
1681,묵은길입구,33.25065,126.48838,308,6,314,295,6,301,제주특별자치도 서귀포시 강정동 5630-10
1682,묵은길입구,33.250440000000005,126.48848999999998,590,18,608,576,17,593,제주특별자치도 서귀포시 강정동 3306-3
1683,용흥동,33.25025,126.48346,3553,37,3590,3516,35,3551,제주특별자치도 서귀포시 강정동 4024-4
1684,용흥동,33.25045,126.48251,1769,34,1803,1743,34,1777,제주특별자치도 서귀포시 강정동 4033-9
1685,플레이케이팝박물관,33.25007,126.41415,2533,1523,4056,2381,1429,3810,제주특별자치도 서귀포시 색달동 2864-20
1686,농업기술원,33.26091,126.48661,620,132,752,618,131,749,제주특별자치도 서귀포시 강정동 3436-5
1687,농업기술원,33.26082,126.48655,227,7,234,225,5,230,제주특별자치도 서귀포시 강정동 3462-2
1688,월산동,33.2599,126.49171,119,3,122,118,3,121,제주특별자치도 서귀포시 강정동 5630-1
1689,월산동,33.26012,126.49222,60,14,74,59,14,73,제주특별자치도 서귀포시 강정동 1914-12
1691,신시가지,33.26044,126.50995,248,5,253,247,5,252,제주특별자치도 서귀포시 서호동 1478
1692,신시가지,33.25898,126.51043,1678,21,1699,1664,18,1682,제주특별자치도 서귀포시 서호동 1478-1
1693,신시가지,33.258340000000004,126.51026,1443,23,1466,1437,20,1457,제주특별자치도 서귀포시 강정동 186
1694,시청후문,33.25675,126.51078,56,2,58,54,2,56,제주특별자치도 서귀포시 서호동 1478-2
1696,회수동,33.263690000000004,126.44392,39,5,44,36,5,41,제주특별자치도 서귀포시 회수동 389-2
1697,삼주연립주택,33.25025,126.51035,2477,39,2516,2447,39,2486,제주특별자치도 서귀포시 법환동 753
1698,동남아파트,33.249790000000004,126.50998,425,24,449,414,24,438,제주특별자치도 서귀포시 법환동 753
1699,제주월드컵경기장서귀포버스터미널,33.24912,126.509,44875,2913,47788,43480,2774,46254,제주특별자치도 서귀포시 법환동 816-9
1702,대림한숲빌라,33.25165,126.50598,177,5,182,176,5,181,제주특별자치도 서귀포시 강정동 186-1
1704,국민건강보험공단,33.25462,126.50681000000002,217,2,219,216,2,218,제주특별자치도 서귀포시 강정동 186-1
1705,서귀포우체국서귀포시청제2청사,33.25507,126.51007,6020,1336,7356,5996,1334,7330,제주특별자치도 서귀포시 법환동 754
1706,서귀포우체국서귀포시청제2청사,33.25517,126.50894,2649,95,2744,2630,88,2718,제주특별자치도 서귀포시 강정동 187
1707,서귀포경찰서,33.25608,126.5076,460,9,469,456,9,465,제주특별자치도 서귀포시 법환동 754
1708,서귀포경찰서,33.256370000000004,126.50761,520,8,528,511,8,519,제주특별자치도 서귀포시 강정동 186
1709,하원초등학교,33.25347,126.45985,266,7,273,263,7,270,제주특별자치도 서귀포시 월평동 239-7
1710,하원초등학교,33.253170000000004,126.46007,111,3,114,106,3,109,제주특별자치도 서귀포시 월평동 239-7
1711,머구낭동산,33.24566,126.45831,291,12,303,289,12,301,제주특별자치도 서귀포시 월평동 753-11
1712,머구낭동산,33.24573,126.45815,198,2,200,196,2,198,제주특별자치도 서귀포시 하원동 1615-2
1713,월평아왜낭목,33.24362,126.45867,279,20,299,272,19,291,제주특별자치도 서귀포시 월평동 741-3
1714,월평아왜낭목,33.24353,126.4588,724,80,804,685,77,762,제주특별자치도 서귀포시 월평동 513
1715,월평알동네,33.24343,126.46036,209,7,216,208,7,215,제주특별자치도 서귀포시 월평동 499-7
1716,월평알동네,33.24327,126.46055,359,32,391,354,31,385,제주특별자치도 서귀포시 월평동 510-2
1717,동병듸,33.24238,126.46349,220,12,232,219,12,231,제주특별자치도 서귀포시 월평동 558-1
1718,동병듸,33.24269,126.46326,97,2,99,97,2,99,제주특별자치도 서귀포시 월평동 400-5
1719,이천장물,33.24175,126.46748999999998,63,21,84,62,21,83,제주특별자치도 서귀포시 월평동 73-2
1720,이천장물,33.24179,126.46708999999998,165,20,185,165,20,185,제주특별자치도 서귀포시 월평동 72-2
1721,허물서,33.23877,126.47363,198,12,210,194,8,202,제주특별자치도 서귀포시 강정동 5491-2
1722,허물서,33.2385,126.47387,455,14,469,450,14,464,제주특별자치도 서귀포시 강정동 5492-7
1723,섯가름,33.23703,126.47582,3067,22,3089,3037,18,3055,제주특별자치도 서귀포시 강정동 4370-2
1724,섯가름,33.237120000000004,126.47605,996,8,1004,987,8,995,제주특별자치도 서귀포시 강정동 4370
1726,강정농협,33.23603,126.47827,5947,102,6049,5804,93,5897,제주특별자치도 서귀포시 강정동 4400-8
1727,강정초등학교,33.23561,126.47977,3046,84,3130,3001,78,3079,제주특별자치도 서귀포시 강정동 4548
1728,강정초등학교,33.235640000000004,126.4801,3086,306,3392,3059,301,3360,제주특별자치도 서귀포시 강정동 4521-10
1729,서귀포여자고등학교,33.24463,126.53137,8545,744,9289,8281,725,9006,제주특별자치도 서귀포시 호근동 1532-1
1730,서귀포여자고등학교,33.24438,126.53168,17593,866,18459,16905,826,17731,제주특별자치도 서귀포시 호근동 1561
1731,수모루,33.24593,126.52443999999998,288,28,316,278,24,302,제주특별자치도 서귀포시 서호동 30-7
1732,주거물,33.24394,126.52124,356,20,376,351,17,368,제주특별자치도 서귀포시 법환동 69-2
1733,주거물,33.24378,126.52122,301,55,356,294,52,346,제주특별자치도 서귀포시 법환동 72-2
1734,공물,33.24067,126.51635,687,78,765,677,72,749,제주특별자치도 서귀포시 법환동 454
1735,공물,33.24043,126.51628999999998,1660,94,1754,1635,88,1723,제주특별자치도 서귀포시 법환동 450
1736,신세계빌라,33.239540000000005,126.51467,555,21,576,549,21,570,제주특별자치도 서귀포시 법환동 424-3
1737,신세계빌라,33.23958,126.51502,2779,57,2836,2739,54,2793,제주특별자치도 서귀포시 법환동 425-6
1738,법환새마을금고,33.23843,126.51398,863,30,893,847,27,874,제주특별자치도 서귀포시 법환동 352
1739,법환새마을금고,33.23785,126.51342,2722,96,2818,2681,88,2769,제주특별자치도 서귀포시 법환동 260-5
1740,법환농협,33.23728,126.5119,1860,238,2098,1819,226,2045,제주특별자치도 서귀포시 법환동 1275-3
1741,뒷동산,33.23666,126.51068,2141,73,2214,2120,72,2192,제주특별자치도 서귀포시 법환동 1282
1742,법환초등학교,33.236740000000005,126.50941,1137,129,1266,1111,125,1236,제주특별자치도 서귀포시 법환동 1299-4
1743,법환초등학교,33.23653,126.50815,1191,288,1479,1154,276,1430,제주특별자치도 서귀포시 법환동 1291-4
1744,남성마을,33.24262,126.55417,789,32,821,776,32,808,제주특별자치도 서귀포시 서홍동 744-8
1745,종합문예진흥사업소,33.24508,126.55365,22,24,46,22,24,46,제주특별자치도 서귀포시 서홍동 586
1746,삼매봉도서관,33.24557,126.55364,511,32,543,502,29,531,제주특별자치도 서귀포시 서홍동 578-15
1747,남성마을입구,33.2477,126.5526,5658,1103,6761,5478,1055,6533,제주특별자치도 서귀포시 서홍동 558-1
1748,남성마을입구,33.24795,126.55224,5482,1365,6847,5310,1272,6582,제주특별자치도 서귀포시 서홍동 534-5
1749,삼매봉입구,33.24491,126.5438,757,384,1141,711,369,1080,제주특별자치도 서귀포시 호근동 268-5
1750,삼매봉,33.2447,126.54354,56,37,93,55,32,87,제주특별자치도 서귀포시 호근동 310-4
1751,여의물,33.24504,126.53822,156,95,251,151,92,243,제주특별자치도 서귀포시 호근동 461-3
1752,여의물,33.24483,126.53777,464,93,557,448,92,540,제주특별자치도 서귀포시 호근동 461-1
1753,솜반천,33.25015,126.55332,22,6,28,20,6,26,제주특별자치도 서귀포시 서홍동 1196-2
1755,외돌개,33.24096,126.54739,803,734,1537,747,672,1419,제주특별자치도 서귀포시 서홍동 795-3
1756,서호북문,33.26123,126.52205,1078,25,1103,1069,25,1094,제주특별자치도 서귀포시 서호동 595-7
1757,서호북문,33.26113,126.52301,1306,34,1340,1286,29,1315,제주특별자치도 서귀포시 서호동 609-1
1758,바가잣도,33.2614,126.52707,115,1,116,109,1,110,제주특별자치도 서귀포시 호근동 2142
1759,바가잣도,33.26126,126.52743,661,5,666,656,5,661,제주특별자치도 서귀포시 호근동 2013-2
1760,용천사입구,33.26145,126.52952,247,7,254,246,7,253,제주특별자치도 서귀포시 호근동 1170-2
1761,용천사입구,33.261309999999995,126.5302,1061,15,1076,1054,15,1069,제주특별자치도 서귀포시 호근동 1136-3
1762,돗소,33.26187,126.53613,73,4,77,73,4,77,제주특별자치도 서귀포시 호근동 801-4
1763,돗소,33.26197,126.5352,45,1,46,45,1,46,제주특별자치도 서귀포시 호근동 793
1764,자연빌라,33.26232,126.53863,164,1,165,163,1,164,제주특별자치도 서귀포시 호근동 814-3
1765,자연빌라,33.26218,126.53898,845,6,851,834,6,840,제주특별자치도 서귀포시 호근동 849-4
1766,진진내,33.26263,126.54298,380,7,387,380,7,387,제주특별자치도 서귀포시 서홍동 1780-7
1767,진진내,33.263020000000004,126.54467,47,2,49,47,2,49,제주특별자치도 서귀포시 서홍동 1782-1
1768,수모루,33.24657,126.52415,8009,342,8351,7894,327,8221,제주특별자치도 서귀포시 서호동 24-2
1769,광대왓,33.24752,126.51857,675,211,886,652,200,852,제주특별자치도 서귀포시 법환동 15-2
1770,광대왓,33.248090000000005,126.51593,333,100,433,323,95,418,제주특별자치도 서귀포시 서호동 1609
1771,고래왓,33.24848,126.5123,2959,549,3508,2892,515,3407,제주특별자치도 서귀포시 법환동 828-4
1772,대륜동주민센터,33.24848,126.51118999999998,5318,1713,7031,5130,1615,6745,제주특별자치도 서귀포시 법환동 816-9
1773,고근산,33.26033,126.51373,927,12,939,924,12,936,제주특별자치도 서귀포시 서호동 1237-7
1774,고근산,33.26048,126.51393,68,6,74,68,6,74,제주특별자치도 서귀포시 서호동 1238-6
1775,아이뜨락공원,33.264109999999995,126.55343,681,1,682,678,1,679,제주특별자치도 서귀포시 서홍동 1615-11
1776,솔대왓,33.26406,126.55546,1730,22,1752,1717,22,1739,제주특별자치도 서귀포시 서홍동 271-17
1777,양가왓,33.26421,126.5556,980,20,1000,972,18,990,제주특별자치도 서귀포시 서홍동 271-13
1778,서홍새마을금고,33.26424,126.55796,1306,15,1321,1293,15,1308,제주특별자치도 서귀포시 서홍동 257-4
1779,서귀북초등학교,33.26037,126.5594,4562,65,4627,4491,59,4550,제주특별자치도 서귀포시 동홍동 1557-4
1780,동덕아파트,33.25762,126.56009,8095,72,8167,7976,72,8048,제주특별자치도 서귀포시 서홍동 316-44
1781,서귀포고등학교,33.2576,126.56043,2883,14,2897,2850,12,2862,제주특별자치도 서귀포시 동홍동 1460-12
1782,서귀중앙여자중학교,33.25497,126.56055,2538,35,2573,2500,31,2531,제주특별자치도 서귀포시 서홍동 397-115
1783,서귀중앙여자중학교,33.25508,126.56078,5872,47,5919,5775,44,5819,제주특별자치도 서귀포시 동홍동 1484-3
1784,중앙로터리(동),33.25297,126.56135,87704,4905,92609,86505,4656,91161,제주특별자치도 서귀포시 서귀동 336
1786,도영슈퍼앞,33.24198,126.60045,83,4,87,81,4,85,제주특별자치도 서귀포시 보목동 735
1787,도영슈퍼,33.24225,126.60025,2024,38,2062,1980,37,2017,제주특별자치도 서귀포시 보목동 735
1788,농협보목지소,33.24323,126.5983,6129,155,6284,6071,151,6222,제주특별자치도 서귀포시 보목동 881-7
1789,함덕골,33.24317,126.59808,315,18,333,314,17,331,제주특별자치도 서귀포시 보목동 1311-1
1790,장안그랜드빌라,33.24375,126.5964,882,30,912,877,29,906,제주특별자치도 서귀포시 보목동 1225-3
1791,장안그랜드빌라,33.24365,126.59624,29,3,32,28,3,31,제주특별자치도 서귀포시 보목동 1230-3
1792,동부하수처리장입구,33.24436,126.59404,651,83,734,632,83,715,제주특별자치도 서귀포시 보목동 1170-2
1793,동부하수처리장입구,33.24443,126.59328,101,18,119,100,18,118,제주특별자치도 서귀포시 보목동 1480-10
1794,라임오렌지빌,33.246559999999995,126.58723,159,12,171,149,11,160,제주특별자치도 서귀포시 토평동 417-1
1795,라임오렌지빌,33.24686,126.58701,497,96,593,480,94,574,제주특별자치도 서귀포시 토평동 418-5
1796,검은여입구,33.24819,126.58287,1169,216,1385,1146,199,1345,제주특별자치도 서귀포시 토평동 635-2
1797,검은여입구,33.2481,126.58253,567,94,661,558,90,648,제주특별자치도 서귀포시 토평동 621-2
1798,칼호텔,33.24803,126.57823,148,67,215,144,64,208,제주특별자치도 서귀포시 토평동 580-2
1799,효성빌라,33.25165,126.57676,238,43,281,237,40,277,제주특별자치도 서귀포시 동홍동 192-43
1800,효성빌라,33.251870000000004,126.57683,519,23,542,516,20,536,제주특별자치도 서귀포시 토평동 820-11
1801,삼아아파트,33.25189,126.57442,10673,518,11191,10572,497,11069,제주특별자치도 서귀포시 동홍동 184-4
1802,주공34단지,33.2501,126.57187,8889,314,9203,8718,299,9017,제주특별자치도 서귀포시 동홍동 2174-17
1803,주공아파트,33.25108,126.57221,348,3,351,338,3,341,제주특별자치도 서귀포시 동홍동 175-1
1804,주공2아파트,33.25225,126.57185,827,12,839,821,11,832,제주특별자치도 서귀포시 동홍동 650-8
1805,보목신협앞,33.2416,126.6025,183,43,226,176,43,219,제주특별자치도 서귀포시 보목동 1637
1806,보목신협,33.24166,126.60199,4004,256,4260,3896,243,4139,제주특별자치도 서귀포시 보목동 750-4
1807,상효입구,33.2596,126.59567,517,42,559,507,41,548,제주특별자치도 서귀포시 신효동 1494-4
1808,상효입구,33.25965,126.59505,1020,54,1074,983,49,1032,제주특별자치도 서귀포시 신효동 1514-2
1809,보목입구,33.25871,126.59158,400,19,419,396,17,413,제주특별자치도 서귀포시 토평동 1093-3
1810,토평보목입구,33.25875,126.59062,992,12,1004,972,11,983,제주특별자치도 서귀포시 토평동 1073-3
1811,삼성여자고등학교,33.25732,126.58478,12004,61,12065,11559,59,11618,제주특별자치도 서귀포시 토평동 937-3
1812,삼성여자고등학교,33.257659999999994,126.58657,4085,53,4138,4011,50,4061,제주특별자치도 서귀포시 토평동 932
1813,창남거리,33.25627,126.58205,224,10,234,212,10,222,제주특별자치도 서귀포시 토평동 851-3
1814,창남거리,33.25623,126.58143,703,17,720,694,17,711,제주특별자치도 서귀포시 토평동 3245-48
1816,비석거리,33.25496,126.57824,5852,604,6456,5755,574,6329,제주특별자치도 서귀포시 토평동 827-2
1817,효돈중학교,33.26348,126.62143,3385,638,4023,3303,612,3915,제주특별자치도 서귀포시 하효동 300-1
1818,효돈중학교,33.26363,126.62008,6055,172,6227,5945,164,6109,제주특별자치도 서귀포시 하효동 1460
1819,효돈초등학교,33.26375,126.61641000000002,11982,189,12171,11831,181,12012,제주특별자치도 서귀포시 하효동 1460
1820,앞동산,33.26377,126.61425,1131,48,1179,1115,48,1163,제주특별자치도 서귀포시 신효동 842-1
1821,신효,33.263729999999995,126.61113,1179,68,1247,1153,65,1218,제주특별자치도 서귀포시 신효동 768-1
1822,신효동,33.26361,126.61012,3519,127,3646,3468,119,3587,제주특별자치도 서귀포시 신효동 746-1
1823,월라봉,33.26254,126.60624,1736,76,1812,1722,72,1794,제주특별자치도 서귀포시 신효동 1151-2
1824,월라봉,33.26225,126.60561,539,36,575,527,34,561,제주특별자치도 서귀포시 신효동 1544-20
1825,서귀포시중앙도서관,33.251670000000004,126.50773,1939,52,1991,1899,49,1948,제주특별자치도 서귀포시 강정동 187
1826,종보존연구센터,33.275929999999995,126.682,165,53,218,162,53,215,제주특별자치도 서귀포시 남원읍 위미리 690-1
1827,종보존연구센터,33.27612,126.68153,322,67,389,319,63,382,제주특별자치도 서귀포시 남원읍 위미리 4591-71
1828,세천동,33.27523,126.675,1031,71,1102,1006,68,1074,제주특별자치도 서귀포시 남원읍 위미리 894-4
1829,세천동,33.275240000000004,126.6747,2296,90,2386,2268,87,2355,제주특별자치도 서귀포시 남원읍 위미리 4591-71
1830,대원상동,33.27483,126.67058,773,14,787,766,12,778,제주특별자치도 서귀포시 남원읍 위미리 1658-1
1831,대원상동,33.27496,126.66989,1546,23,1569,1506,23,1529,제주특별자치도 서귀포시 남원읍 위미리 1574-3
1832,뒤통모루,33.27526,126.66707,1531,49,1580,1504,47,1551,제주특별자치도 서귀포시 남원읍 위미리 1846-1
1833,뒤통모루,33.2754,126.66689,3244,37,3281,3193,35,3228,제주특별자치도 서귀포시 남원읍 위미리 4591
1834,상원동,33.27505,126.66353,2098,94,2192,2052,84,2136,제주특별자치도 서귀포시 남원읍 위미리 1883-2
1835,위미문화의집,33.27474,126.65983,2154,298,2452,2102,282,2384,제주특별자치도 서귀포시 남원읍 위미리 2846-1
1836,위미문화의집,33.274770000000004,126.65837,5576,412,5988,5456,391,5847,제주특별자치도 서귀포시 남원읍 위미리 4591
1837,위미1리사무소,33.27411,126.65645,3934,171,4105,3799,165,3964,제주특별자치도 서귀포시 남원읍 위미리 3155-3
1838,위미초등학교,33.27367,126.65455,4738,193,4931,4663,185,4848,제주특별자치도 서귀포시 남원읍 위미리 3235-1
1839,대화동,33.27275,126.6518,1535,126,1661,1506,119,1625,제주특별자치도 서귀포시 남원읍 위미리 4144-2
1840,서성동,33.27245,126.65032,2591,110,2701,2535,104,2639,제주특별자치도 서귀포시 남원읍 위미리 4148-8
1841,농협주유소,33.27097,126.64738,346,16,362,339,15,354,제주특별자치도 서귀포시 남원읍 신례리 3
1842,신례2리교차로,33.26746,126.64324,521,32,553,514,32,546,제주특별자치도 서귀포시 남원읍 신례리 39-7
1843,농협주유소,33.27045,126.64648,919,34,953,910,30,940,제주특별자치도 서귀포시 남원읍 신례리 274-1
1844,신례2리교차로,33.26702,126.64294,680,71,751,665,68,733,제주특별자치도 서귀포시 남원읍 신례리 25-2
1845,공천포,33.26583,126.64053,3734,254,3988,3679,245,3924,제주특별자치도 서귀포시 남원읍 신례리 118-2
1846,공천포,33.26545,126.64017,1945,184,2129,1919,175,2094,제주특별자치도 서귀포시 남원읍 신례리 2191
1847,망장포입구,33.26408,126.6345,537,81,618,513,79,592,제주특별자치도 서귀포시 남원읍 하례리 1887
1848,망장포입구,33.26415,126.63392,2455,148,2603,2434,142,2576,제주특별자치도 서귀포시 남원읍 하례리 313-2
1849,하례1리입구,33.2635,126.62609,1542,223,1765,1492,211,1703,제주특별자치도 서귀포시 남원읍 하례리 351-2
1850,하례1리입구,33.26367,126.62618,4568,161,4729,4511,148,4659,제주특별자치도 서귀포시 남원읍 하례리 344-4
1852,신례교,33.293420000000005,126.62463,31,7,38,31,7,38,제주특별자치도 서귀포시 남원읍 신례리 2194
1853,신례교,33.29352,126.62462,757,9,766,754,9,763,제주특별자치도 서귀포시 남원읍 신례리 2194
1854,만지동,33.29325,126.62675,555,16,571,542,16,558,제주특별자치도 서귀포시 남원읍 신례리 1233-3
1855,만지동,33.2929,126.62658,602,9,611,598,9,607,제주특별자치도 서귀포시 남원읍 신례리 1225-1
1856,사가동,33.29008,126.62735,624,6,630,623,6,629,제주특별자치도 서귀포시 남원읍 신례리 2191
1857,사가동,33.29028,126.62735,631,10,641,627,10,637,제주특별자치도 서귀포시 남원읍 신례리 1301-1
1858,동문정류소,33.289320000000004,126.63025,880,6,886,870,6,876,제주특별자치도 서귀포시 남원읍 신례리 984-7
1859,동문정류소,33.2888,126.63032,563,17,580,558,16,574,제주특별자치도 서귀포시 남원읍 신례리 1024-13
1860,신례초등학교,33.28518,126.63263,725,11,736,715,11,726,제주특별자치도 서귀포시 남원읍 신례리 841-1
1861,신례초등학교,33.28393,126.63326,1194,9,1203,1131,8,1139,제주특별자치도 서귀포시 남원읍 신례리 836-12
1862,신례하동,33.281209999999994,126.63506,204,1,205,202,1,203,제주특별자치도 서귀포시 남원읍 신례리 652-1
1864,신성동,33.27479,126.6951,884,48,932,847,46,893,제주특별자치도 서귀포시 남원읍 남원리 2420-2
1865,신성동,33.27486,126.69457,1118,72,1190,1104,70,1174,제주특별자치도 서귀포시 남원읍 남원리 2490-116
1866,위미3리마을회관,33.27503,126.68867,1398,58,1456,1355,55,1410,제주특별자치도 서귀포시 남원읍 위미리 168-2
1867,위미3리,33.2754,126.68708,1658,77,1735,1619,75,1694,제주특별자치도 서귀포시 남원읍 위미리 172-7
1868,서귀포산업과학고등학교,33.29573,126.59512,121,36,157,116,34,150,제주특별자치도 서귀포시 상효동 1262-2
1869,서귀포산업과학고등학교,33.295970000000004,126.59557,4240,353,4593,4081,327,4408,제주특별자치도 서귀포시 상효동 1262-4
1870,하례환승정류장(하례리입구),33.29998,126.60048,2790,202,2992,2741,184,2925,제주특별자치도 서귀포시 상효동 1122-5
1871,감귤단지,33.30127,126.60908,146,2,148,146,2,148,제주특별자치도 서귀포시 남원읍 하례리 1763-6
1872,감귤단지,33.30115,126.60939,218,11,229,217,11,228,제주특별자치도 서귀포시 남원읍 하례리 1887
1873,심향사,33.29547,126.62207,69,10,79,69,10,79,제주특별자치도 서귀포시 남원읍 신례리 1638-9
1874,진학농원,33.29995,126.61587,56,1,57,55,1,56,제주특별자치도 서귀포시 남원읍 하례리 1210-4
1876,돈내코마을,33.30275,126.57352,12,1,13,12,1,13,제주특별자치도 서귀포시 상효동 2245-2
1877,돈내코,33.2997,126.58429,1008,166,1174,981,158,1139,제주특별자치도 서귀포시 상효동 1463
1878,돈내코,33.29977,126.58482,4,7,11,4,7,11,제주특별자치도 서귀포시 상효동 1453-1
1879,돈내코교,33.29934,126.58862,170,35,205,168,35,203,제주특별자치도 서귀포시 상효동 1449-4
1880,돈내코교,33.299620000000004,126.58878,59,14,73,58,13,71,제주특별자치도 서귀포시 상효동 1613
1881,고도농원,33.28753,126.59368,339,8,347,334,8,342,제주특별자치도 서귀포시 상효동 1350-2
1882,고도농원,33.28763,126.59334,355,8,363,344,8,352,제주특별자치도 서귀포시 상효동 1351-11
1883,법호촌입구,33.29008,126.59386,259,8,267,259,8,267,제주특별자치도 서귀포시 상효동 1344-1
1884,법호촌입구,33.29065,126.59457,685,11,696,681,11,692,제주특별자치도 서귀포시 상효동 1296-4
1885,법호촌온성학교,33.29186,126.59449,3454,40,3494,3411,36,3447,제주특별자치도 서귀포시 상효동 1290-1
1886,법호촌온성학교,33.29282,126.59475,2062,22,2084,2038,19,2057,제주특별자치도 서귀포시 상효동 1300-15
1887,서귀포산업과학고등학교,33.29515,126.59487,6292,203,6495,6086,194,6280,제주특별자치도 서귀포시 상효동 1262-3
1889,하례2리,33.28929,126.60599,620,12,632,616,11,627,제주특별자치도 서귀포시 남원읍 하례리 1648-4
1892,제2효레교,33.28477,126.60816,22,2,24,22,2,24,제주특별자치도 서귀포시 상효동 409-3
1896,동상효,33.27996,126.60717,1073,18,1091,1068,18,1086,제주특별자치도 서귀포시 상효동 454-6
1897,동상효,33.27965,126.6073,11,1,12,11,1,12,제주특별자치도 서귀포시 상효동 454-4
1899,뒤큰글,33.27584,126.60378,246,5,251,244,4,248,제주특별자치도 서귀포시 상효동 162-18
1901,고장낭밭,33.27414,126.59935,538,2,540,538,2,540,제주특별자치도 서귀포시 상효동 654-19
1903,서상효,33.2728,126.59652,920,11,931,918,9,927,제주특별자치도 서귀포시 상효동 915-1
1904,토평반석타운,33.27114,126.59432,120,2,122,120,2,122,제주특별자치도 서귀포시 토평동 176-1
1905,토평반석타운,33.27053,126.59375,1515,6,1521,1497,6,1503,제주특별자치도 서귀포시 토평동 176-3
1906,토평초등학교,33.26807,126.59055,293,9,302,286,8,294,제주특별자치도 서귀포시 토평동 1278-1
1907,토평초등학교,33.268,126.58888,1538,24,1562,1515,23,1538,제주특별자치도 서귀포시 토평동 1304-4
1908,한라산교회,33.27311,126.56826,2721,17,2738,2563,16,2579,제주특별자치도 서귀포시 동홍동 953-2
1910,동홍분식,33.26676,126.56816,329,5,334,325,5,330,제주특별자치도 서귀포시 동홍동 1073-34
1911,동홍분식,33.26671,126.56835,203,1,204,195,1,196,제주특별자치도 서귀포시 동홍동 1042-6
1912,동홍동청소년문화의집,33.26588,126.56872,485,5,490,479,5,484,제주특별자치도 서귀포시 동홍동 1126-2
1913,동홍동청소년문화의집,33.26608,126.56863,2365,34,2399,2311,33,2344,제주특별자치도 서귀포시 동홍동 1075-5
1914,서귀포향토오일시장,33.26574,126.57394,7444,184,7628,7344,174,7518,제주특별자치도 서귀포시 동홍동 807-4
1915,서귀포향토오일시장,33.265640000000005,126.57399,468,6,474,465,6,471,제주특별자치도 서귀포시 동홍동 789-3
1916,측골,33.26718,126.58332,985,20,1005,977,20,997,제주특별자치도 서귀포시 토평동 2272-7
1917,측골,33.26732,126.58328,393,24,417,386,22,408,제주특별자치도 서귀포시 토평동 3245
1918,비석거리,33.25613,126.57752,1401,17,1418,1385,17,1402,제주특별자치도 서귀포시 동홍동 657-4
1919,비석거리,33.25578,126.57745,18848,1860,20708,18446,1746,20192,제주특별자치도 서귀포시 토평동 867-11
1920,답다니,33.25882,126.57983,555,10,565,548,9,557,제주특별자치도 서귀포시 토평동 965-7
1921,답다니,33.2589,126.57973,360,5,365,360,5,365,제주특별자치도 서귀포시 토평동 978-3
1922,흙통,33.26239,126.5829,478,9,487,475,9,484,제주특별자치도 서귀포시 토평동 2322-6
1923,흙통,33.26191,126.58228,591,9,600,583,9,592,제주특별자치도 서귀포시 토평동 2335-7
1924,오희준공원,33.26621,126.58549,311,11,322,305,10,315,제주특별자치도 서귀포시 토평동 1200-2
1925,오희준공원,33.26618,126.5852,487,9,496,482,9,491,제주특별자치도 서귀포시 토평동 2263-5
1926,평안전문요양원,33.28135,126.58845,758,34,792,751,33,784,제주특별자치도 서귀포시 토평동 1700-1
1927,평안전문요양원,33.28068,126.58827,2003,64,2067,1979,61,2040,제주특별자치도 서귀포시 토평동 1693-18
1929,꽃동산,33.27942,126.58863999999998,73,13,86,71,13,84,제주특별자치도 서귀포시 토평동 1707-1
1930,뒷빌레,33.27391,126.58979,258,2,260,257,2,259,제주특별자치도 서귀포시 토평동 1600-1
1931,뒷빌레,33.273270000000004,126.58965,2112,10,2122,2103,9,2112,제주특별자치도 서귀포시 토평동 1541-1
1932,토평마을회관,33.27192,126.5898,6506,96,6602,6421,94,6515,제주특별자치도 서귀포시 토평동 1426-9
1934,토평마을회관,33.27053,126.58975,9919,90,10009,9823,87,9910,제주특별자치도 서귀포시 토평동 1341-10
1935,영천동주민센터,33.2688,126.58733,1843,60,1903,1818,60,1878,제주특별자치도 서귀포시 토평동 1310-5
1936,영천동주민센터,33.26888,126.58713,2787,45,2832,2750,43,2793,제주특별자치도 서귀포시 토평동 3245
1937,L마트,33.2643,126.56003,3707,39,3746,3669,38,3707,제주특별자치도 서귀포시 동홍동 2187
1938,주공아파트5단지,33.2646,126.56115,17280,188,17468,17082,180,17262,제주특별자치도 서귀포시 동홍동 1674
1939,남주중고등학교,33.2744,126.56615,1647,13,1660,1579,11,1590,제주특별자치도 서귀포시 동홍동 1910-1
1940,남주중고등학교,33.27488,126.56609,7773,25,7798,7323,23,7346,제주특별자치도 서귀포시 동홍동 948-1
1941,강정천,33.2336,126.48635,273,76,349,258,75,333,제주특별자치도 서귀포시 강정동 5647-1
1942,강정천,33.23402,126.4876,1593,140,1733,1483,131,1614,제주특별자치도 서귀포시 강정동 2673-4
1943,켄싱턴리조트악근천,33.2344,126.49043,1644,279,1923,1572,263,1835,제주특별자치도 서귀포시 강정동 5628
1944,켄싱턴리조트악근천,33.23462,126.49082,782,476,1258,767,462,1229,제주특별자치도 서귀포시 강정동 2626-1
1945,서년듸,33.23555,126.49468,489,55,544,475,54,529,제주특별자치도 서귀포시 강정동 2483-3
1946,서년듸,33.23574,126.49488,72,25,97,70,21,91,제주특별자치도 서귀포시 강정동 2483-1
1947,고향모루,33.23645,126.49823,344,67,411,327,63,390,제주특별자치도 서귀포시 강정동 851-6
1948,고향모루,33.23638,126.49852,986,103,1089,929,95,1024,제주특별자치도 서귀포시 강정동 885-2
1949,서건도입구,33.23592,126.50313,303,98,401,274,91,365,제주특별자치도 서귀포시 강정동 572-4
1950,서건도입구,33.23584,126.50332,524,139,663,498,119,617,제주특별자치도 서귀포시 강정동 637-3
1951,중문관광단지,33.2522,126.41271,225,249,474,216,231,447,제주특별자치도 서귀포시 색달동 2822-1
1952,(구)중앙파출소,33.2476,126.56089,6742,1686,8428,6505,1563,8068,제주특별자치도 서귀포시 서귀동 341
1953,제주은행,33.24807,126.56356,61564,3068,64632,60200,2847,63047,제주특별자치도 서귀포시 서귀동 274-11
1954,동미빌딩,33.24866,126.56658,10735,1098,11833,10474,1055,11529,제주특별자치도 서귀포시 서귀동 256-11
1955,청소년문화의집,33.25043,126.56505,13303,495,13798,13109,472,13581,제주특별자치도 서귀포시 서귀동 335
1956,청소년문화의집,33.25088,126.56405,16525,1595,18120,16318,1519,17837,제주특별자치도 서귀포시 서귀동 279-14
1957,중앙로터리,33.25285,126.56058,66471,1887,68358,65446,1794,67240,제주특별자치도 서귀포시 서귀동 336
1958,서귀북초등학교,33.26095,126.55896,28605,301,28906,28256,292,28548,제주특별자치도 서귀포시 서홍동 307-3
1959,구삼일금고,33.2492,126.56168,13404,681,14085,13218,630,13848,제주특별자치도 서귀포시 서귀동 336
1960,오션팰리스호텔,33.24617,126.56208,842,568,1410,826,507,1333,제주특별자치도 서귀포시 서귀동 494-7
1961,오션팰리스호텔,33.24603,126.56187,371,269,640,365,254,619,제주특별자치도 서귀포시 서귀동 437-2
1962,솔동산입구,33.244609999999994,126.56369,1075,273,1348,1054,258,1312,제주특별자치도 서귀포시 서귀동 961
1963,솔동산입구,33.24474,126.56368,1297,449,1746,1243,425,1668,제주특별자치도 서귀포시 서귀동 475-3
1964,송산동주민센터,33.24537,126.56561,776,196,972,757,185,942,제주특별자치도 서귀포시 서귀동 553-11
1966,서귀포중학교,33.24765,126.56875,825,122,947,797,115,912,제주특별자치도 서귀포시 서귀동 221-14
1967,세기아파트,33.25268,126.57523,8461,188,8649,8362,180,8542,제주특별자치도 서귀포시 동홍동 139-11
1968,보목포구입구,33.24128,126.60458,371,23,394,362,23,385,제주특별자치도 서귀포시 보목동 470-1
1970,칼호텔,33.24797,126.57787,28,38,66,28,37,65,제주특별자치도 서귀포시 동홍동 216-2
1971,서귀포중학교,33.247679999999995,126.56906,3299,112,3411,3225,108,3333,제주특별자치도 서귀포시 서귀동 222-3
1973,주공2단지,33.2548,126.57252,6244,71,6315,6117,67,6184,제주특별자치도 서귀포시 동홍동 657-5
1974,산남새마을금고,33.254909999999995,126.57378,16753,189,16942,16473,185,16658,제주특별자치도 서귀포시 동홍동 657-5
1975,동홍초등학교,33.25923,126.57083,459,1,460,446,1,447,제주특별자치도 서귀포시 동홍동 657-1
1976,동홍초등학교,33.25933,126.57018,154,1,155,151,1,152,제주특별자치도 서귀포시 동홍동 657-1
1977,거문머들,33.256879999999995,126.53424,749,5,754,742,5,747,제주특별자치도 서귀포시 호근동 628-11
1979,동문,33.25745,126.53098,257,6,263,257,6,263,제주특별자치도 서귀포시 호근동 2142
1980,동문,33.25732,126.53099,1345,52,1397,1320,52,1372,제주특별자치도 서귀포시 호근동 1309-9
1981,고갠드르,33.25472,126.52419,1446,84,1530,1412,80,1492,제주특별자치도 서귀포시 서호동 1490
1982,남문,33.25257,126.52434,691,6,697,685,5,690,제주특별자치도 서귀포시 서호동 276-2
1983,남문,33.25263,126.52421,398,11,409,387,10,397,제주특별자치도 서귀포시 서호동 276-3
1984,서호입구,33.24757,126.52424,100,2,102,100,2,102,제주특별자치도 서귀포시 서호동 1539
1985,서호입구,33.247640000000004,126.52439,125,5,130,125,5,130,제주특별자치도 서귀포시 서호동 140-2
1986,대평리사무소,33.238240000000005,126.36632,32,8,40,32,8,40,제주특별자치도 서귀포시 안덕면 창천리 890-1
1988,대평리,33.23492,126.36692,2834,411,3245,2788,393,3181,제주특별자치도 서귀포시 안덕면 창천리 823-2
1989,대평리,33.235209999999995,126.36693,5339,606,5945,5235,567,5802,제주특별자치도 서귀포시 안덕면 창천리 876-5
1990,하예하동,33.23628,126.37321,16,1,17,16,1,17,제주특별자치도 서귀포시 하예동 1560
1991,하예하동,33.23613,126.37333,3089,127,3216,3056,121,3177,제주특별자치도 서귀포시 하예동 1561-1
1992,하예중동,33.2416,126.38413,2529,225,2754,2494,210,2704,제주특별자치도 서귀포시 하예동 1962
1993,하예중동,33.24179,126.38416,103,18,121,99,17,116,제주특별자치도 서귀포시 하예동 392
1994,예래동가동거리,33.24533,126.38805,3375,150,3525,3291,128,3419,제주특별자치도 서귀포시 하예동 266-3
1999,벼락동산,33.24783,126.39242,5,2,7,5,1,6,제주특별자치도 서귀포시 상예동 1216-3
2000,정문동,33.24938,126.39367,892,17,909,887,15,902,제주특별자치도 서귀포시 상예동 1178-2
2001,정문동,33.24965,126.39363,92,2,94,92,2,94,제주특별자치도 서귀포시 상예동 1309-2
2002,예래동주민센터,33.25377,126.39772,146,13,159,143,12,155,제주특별자치도 서귀포시 상예동 528
2003,예래동주민센터,33.25425,126.39855,2117,92,2209,2086,89,2175,제주특별자치도 서귀포시 상예동 534-4
2004,상예입구,33.2576,126.40434,253,44,297,244,42,286,제주특별자치도 서귀포시 색달동 2094-5
2005,상예입구,33.2578,126.40448,997,230,1227,984,219,1203,제주특별자치도 서귀포시 색달동 2091-6
2007,파라다이스호텔입구,33.24753,126.57692,168,190,358,168,187,355,제주특별자치도 서귀포시 동홍동 317-16
2008,서귀포항,33.23977,126.5645,238,92,330,233,91,324,제주특별자치도 서귀포시 서귀동 783-15
2009,뉴경남호텔,33.24613,126.55957,49,185,234,49,183,232,제주특별자치도 서귀포시 서귀동 803
2010,플레이케이팝박물관,33.25018,126.41343,759,832,1591,731,812,1543,제주특별자치도 서귀포시 색달동 2864-36
2012,하나호텔한국관광공사,33.2502,126.40843,1763,759,2522,1740,722,2462,제주특별자치도 서귀포시 색달동 2822-1
2013,신라호텔,33.24775,126.40793,200,784,984,200,784,984,제주특별자치도 서귀포시 색달동 3039-3
2014,하얏트호텔,33.24511,126.40579,1188,1424,2612,1186,1415,2601,제주특별자치도 서귀포시 색달동 3039-1
2016,동홍동청소년문화의집,33.26521,126.56798,43,1,44,43,1,44,제주특별자치도 서귀포시 동홍동 1137-15
2019,아랑조을거리입구,33.25116,126.55937,1542,471,2013,1497,449,1946,제주특별자치도 서귀포시 서귀동 305-11
2020,평생학습관,33.2495,126.55807,3572,1643,5215,3460,1522,4982,제주특별자치도 서귀포시 서귀동 337
2021,제주국제컨벤션센터,33.2434,126.42466,6235,4484,10719,5968,4340,10308,제주특별자치도 서귀포시 중문동 2507
2022,향토오일시장,33.26743,126.57516,721,36,757,711,33,744,제주특별자치도 서귀포시 동홍동 2174
2023,대포동,33.24293,126.43168,1179,24,1203,1167,21,1188,제주특별자치도 서귀포시 대포동 1599-1
2024,큰솔동산,33.24742,126.43185,293,60,353,286,55,341,제주특별자치도 서귀포시 대포동 760-2
2025,큰솔동산,33.2474,126.43174,527,30,557,519,30,549,제주특별자치도 서귀포시 대포동 760-3
2026,법환농협,33.23721,126.5121,4067,363,4430,4014,343,4357,제주특별자치도 서귀포시 법환동 1275-5
2027,수모루,33.24605,126.52442,940,107,1047,924,100,1024,제주특별자치도 서귀포시 서호동 24-1
2028,제석공원,33.24612,126.56731,479,61,540,475,58,533,제주특별자치도 서귀포시 서귀동 961
2029,서귀포YWCA,33.24457,126.56529,1149,52,1201,1141,51,1192,제주특별자치도 서귀포시 서귀동 558-8
2030,서귀포초등학교,33.2427,126.56508,2060,139,2199,2052,135,2187,제주특별자치도 서귀포시 서귀동 725-2
2031,파인힐호텔,33.24112,126.56464,440,180,620,429,173,602,제주특별자치도 서귀포시 서귀동 782-5
2032,천지연폭포입구,33.241209999999995,126.56131,2395,968,3363,2284,916,3200,제주특별자치도 서귀포시 서귀동 961
2033,천지연폭포입구,33.241240000000005,126.56147,32,10,42,32,8,40,제주특별자치도 서귀포시 서귀동 659-2
2034,서귀포항,33.23978,126.56393,12,3,15,12,3,15,제주특별자치도 서귀포시 서귀동 788-10
2035,파인힐호텔,33.24122,126.56453,132,29,161,132,29,161,제주특별자치도 서귀포시 서귀동 776-1
2036,송산동주민센터,33.24445,126.56516,112,21,133,109,21,130,제주특별자치도 서귀포시 서귀동 575-2
2037,제석공원,33.24608,126.56696,474,87,561,456,82,538,제주특별자치도 서귀포시 서귀동 166-4
2038,천지동주민센터,33.24808,126.5617,8003,615,8618,7950,580,8530,제주특별자치도 서귀포시 서귀동 294-21
2039,서귀포농협,33.251529999999995,126.56115,5757,367,6124,5711,352,6063,제주특별자치도 서귀포시 서귀동 297-38
2040,서홍새마을금고,33.2641,126.55802,1724,14,1738,1714,14,1728,제주특별자치도 서귀포시 서홍동 256-4
2043,앞거리,33.258309999999994,126.42768999999998,75,9,84,75,9,84,제주특별자치도 서귀포시 중문동 1355-5
2044,앞거리,33.2582,126.4275,8,2,10,8,2,10,제주특별자치도 서귀포시 중문동 1355-5
2051,천제연폭포,33.25353,126.41953,7663,1992,9655,7390,1886,9276,제주특별자치도 서귀포시 중문동 2232
2052,중문환승정류장(중문우체국),33.2518,126.4238,30408,1651,32059,29787,1568,31355,제주특별자치도 서귀포시 중문동 2774
2053,중문환승정류장(중문우체국),33.25189,126.42339,42736,4231,46967,42024,3987,46011,제주특별자치도 서귀포시 중문동 2087-14
2054,중문동,33.25155,126.4269,20697,403,21100,20272,377,20649,제주특별자치도 서귀포시 중문동 2774
2055,중문동,33.25163,126.42746,8933,495,9428,8772,472,9244,제주특별자치도 서귀포시 중문동 1965-7
2056,중문초등학교,33.25147,126.42982,21231,1106,22337,20916,1045,21961,제주특별자치도 서귀포시 중문동 1905-2
2057,중문초등학교,33.25135,126.42988,32391,891,33282,31881,844,32725,제주특별자치도 서귀포시 중문동 2774
2058,(구)중문동주민센터,33.25103,126.43435,4382,220,4602,4299,214,4513,제주특별자치도 서귀포시 중문동 2774
2059,(구)중문동주민센터,33.25114,126.43425,2536,194,2730,2461,185,2646,제주특별자치도 서귀포시 중문동 1880-2
2060,어두모루,33.25162,126.43853,340,84,424,336,81,417,제주특별자치도 서귀포시 대포동 700-2
2061,어두모루,33.25147,126.43851,497,45,542,486,41,527,제주특별자치도 서귀포시 대포동 2606-20
2062,현대산부인과,33.24918,126.5671,7826,433,8259,7726,415,8141,제주특별자치도 서귀포시 서귀동 335
2063,남군농협,33.2482,126.565,23481,621,24102,23108,580,23688,제주특별자치도 서귀포시 서귀동 404-14
2064,서문로터리입구,33.24727,126.55635,244,94,338,231,92,323,제주특별자치도 서귀포시 서귀동 961-37
2065,고갠드르,33.25461,126.52411,338,25,363,331,25,356,제주특별자치도 서귀포시 서호동 302
2066,서호새마을금고,33.25727,126.52292,1988,26,2014,1983,26,2009,제주특별자치도 서귀포시 서호동 1490
2067,서호동마을회관,33.257290000000005,126.52279,677,17,694,673,17,690,제주특별자치도 서귀포시 서호동 806
2068,호근사거리,33.25733,126.52753,3426,36,3462,3396,36,3432,제주특별자치도 서귀포시 호근동 2142
2069,호근새마을금고,33.25745,126.52756,1024,40,1064,1012,39,1051,제주특별자치도 서귀포시 호근동 2157
2070,용당,33.25523,126.54007,369,20,389,363,19,382,제주특별자치도 서귀포시 호근동 689-12
2071,용당,33.25533,126.54014,129,25,154,113,23,136,제주특별자치도 서귀포시 호근동 690-4
2072,효돈초등학교,33.26358,126.61695,3117,94,3211,3053,88,3141,제주특별자치도 서귀포시 하효동 140
2073,평생학습관,33.2496,126.558,5247,1663,6910,5072,1508,6580,제주특별자치도 서귀포시 서귀동 326-8
2074,신협,33.2642,126.61324,9075,124,9199,8979,121,9100,제주특별자치도 서귀포시 신효동 714-1
2075,효례교,33.263659999999994,126.62268,45,4,49,45,4,49,제주특별자치도 서귀포시 하효동 367-13
2078,대한목장,33.3015,126.61407,42,3,45,42,3,45,제주특별자치도 서귀포시 남원읍 하례리 1339-4
2080,(구)중앙파출소,33.247,126.56036,2747,368,3115,2673,345,3018,제주특별자치도 서귀포시 서귀동 832-1
2081,동홍초등학교입구,33.25857,126.56811,655,1,656,642,1,643,제주특별자치도 서귀포시 동홍동 2174-46
2082,아랑조을거리입구,33.25108,126.55955,483,323,806,472,311,783,제주특별자치도 서귀포시 서귀동 337
2083,LH아파트,33.24725,126.52281,7902,447,8349,7822,434,8256,제주특별자치도 서귀포시 서호동 968-1
2084,아시아CGI애니메이션센터,33.252309999999994,126.56782,1164,2,1166,1150,2,1152,제주특별자치도 서귀포시 동홍동 449
2085,아시아CGI애니메이션센터,33.25235,126.56762,1815,15,1830,1799,14,1813,제주특별자치도 서귀포시 동홍동 447-38
2086,공업단지입구,33.28412,126.59041,1001,63,1064,982,61,1043,제주특별자치도 서귀포시 토평동 1761-2
2087,공업단지입구,33.28351,126.5903,1135,75,1210,1116,71,1187,제주특별자치도 서귀포시 토평동 1716-1
2088,동문로터리,33.24868,126.56835,7773,317,8090,7630,306,7936,제주특별자치도 서귀포시 서귀동 216-3
2090,반석아르미아파트,33.26251,126.5674,2548,15,2563,2510,15,2525,제주특별자치도 서귀포시 동홍동 1240-4
2091,동홍동청소년문화의집,33.265,126.56777,921,11,932,905,11,916,제주특별자치도 서귀포시 동홍동 1137-12
2093,고래왓,33.24794,126.51469,2635,552,3187,2566,528,3094,제주특별자치도 서귀포시 법환동 1665-7
2094,한국콘도입구,33.250240000000005,126.41022,5296,1431,6727,5194,1372,6566,제주특별자치도 서귀포시 색달동 2822-1
2095,켄싱턴제주호텔입구,33.250370000000004,126.40992,77,98,175,77,95,172,제주특별자치도 서귀포시 색달동 2822-1
2096,신라호텔,33.24748,126.40689,303,18,321,302,16,318,제주특별자치도 서귀포시 색달동 3039-3
2097,중문골프장,33.24985,126.40751000000002,44,8,52,43,8,51,제주특별자치도 서귀포시 색달동 2798-7
2098,색달,33.25985,126.4057,192,25,217,178,25,203,제주특별자치도 서귀포시 색달동 2138-1
2099,색달,33.259879999999995,126.40553,5,4,9,5,4,9,제주특별자치도 서귀포시 색달동 2137-3
2100,색달동,33.26177,126.41227,39,7,46,38,6,44,제주특별자치도 서귀포시 색달동 3383
2101,색달동,33.26167,126.41228,1453,25,1478,1419,23,1442,제주특별자치도 서귀포시 색달동 1934-2
2102,서홍동복지회관,33.263729999999995,126.55038,280,7,287,273,7,280,제주특별자치도 서귀포시 서홍동 1645-1
2103,서홍동복지회관,33.263659999999994,126.55131000000002,2170,22,2192,2143,22,2165,제주특별자치도 서귀포시 서홍동 1627-6
2104,뉴경남호텔,33.24671,126.55825,1046,3791,4837,1045,3788,4833,제주특별자치도 서귀포시 서귀동 841-2
2105,서귀포항,33.23988,126.56422,834,1153,1987,834,1153,1987,제주특별자치도 서귀포시 서귀동 786-16
2106,서귀포여자중학교,33.254290000000005,126.54702,6302,123,6425,6101,116,6217,제주특별자치도 서귀포시 서홍동 2576
2107,서귀포여자중학교,33.254870000000004,126.54642,2099,233,2332,2035,215,2250,제주특별자치도 서귀포시 서홍동 1335-6
2108,남성마을,33.24295,126.55423,33,11,44,33,10,43,제주특별자치도 서귀포시 서홍동 641-1
2109,예비군훈련장,33.28808,126.57491,169,4,173,166,4,170,제주특별자치도 서귀포시 토평동 3058-3
2111,서귀포칼호텔,33.24694,126.58149,690,1871,2561,690,1871,2561,제주특별자치도 서귀포시 토평동 486-3
2113,천지연폭포(종점),33.243109999999994,126.56025,1679,711,2390,1562,664,2226,제주특별자치도 서귀포시 서홍동 689-1
2114,스위트호텔,33.24904,126.40767,7848,1567,9415,7706,1459,9165,제주특별자치도 서귀포시 색달동 2798-7
2115,보목포구(도착),33.23936,126.60687,493,34,527,479,30,509,제주특별자치도 서귀포시 보목동 566-3
2116,열린병원,33.25387,126.56467,4500,42,4542,4446,42,4488,제주특별자치도 서귀포시 서귀동 263-24
2117,열린병원,33.25415,126.56525,8705,82,8787,8598,78,8676,제주특별자치도 서귀포시 동홍동 1503-18
2120,한국오우퍼빌,33.25758,126.57195,780,2,782,767,1,768,제주특별자치도 서귀포시 동홍동 93-2
2122,동홍대림,33.25592,126.57202,682,5,687,667,5,672,제주특별자치도 서귀포시 동홍동 657-5
2123,동홍대림,33.25573,126.57212,238,2,240,236,2,238,제주특별자치도 서귀포시 동홍동 657-5
2124,감산리,33.26007,126.35693,208,26,234,207,26,233,제주특별자치도 서귀포시 안덕면 감산리 1947
2125,안덕계곡,33.25816,126.35336,2317,116,2433,2292,112,2404,제주특별자치도 서귀포시 안덕면 감산리 346
2126,감산리,33.2598,126.35702,933,66,999,919,62,981,제주특별자치도 서귀포시 안덕면 감산리 299-1
2127,창천리남당물동산,33.26168,126.36617,3408,681,4089,3368,654,4022,제주특별자치도 서귀포시 안덕면 창천리 365-2
2128,창천리남당물동산,33.2617,126.36732,515,40,555,510,40,550,제주특별자치도 서귀포시 안덕면 창천리 434-1
2129,창천초등학교,33.2641,126.37078,1037,319,1356,1002,312,1314,제주특별자치도 서귀포시 안덕면 창천리 1440
2130,창천초등학교,33.264759999999995,126.37104,56,13,69,54,12,66,제주특별자치도 서귀포시 안덕면 창천리 155-46
2132,강창학종합경기장,33.26178,126.50146,1242,351,1593,1242,351,1593,제주특별자치도 서귀포시 강정동 1515-3
2133,강창학종합경기장,33.26162,126.50145,1259,79,1338,1241,66,1307,제주특별자치도 서귀포시 강정동 1515-2
2134,숨비나리,33.2839,126.35415,438,275,713,413,255,668,제주특별자치도 서귀포시 안덕면 상창리 1946-1
2135,숨비나리,33.28403,126.35422,495,221,716,450,201,651,제주특별자치도 서귀포시 안덕면 상창리 1946-1
2136,상창리사무소,33.27268,126.36505,469,78,547,462,72,534,제주특별자치도 서귀포시 안덕면 상창리 646-8
2137,천제연폭포,33.25395,126.41898,4516,1647,6163,4314,1563,5877,제주특별자치도 서귀포시 중문동 1489-15
2138,중문사거리,33.25164,126.43152,30,8,38,30,8,38,제주특별자치도 서귀포시 중문동 1789
2139,비석거리,33.25427,126.57672,638,122,760,629,119,748,제주특별자치도 서귀포시 토평동 824-2
2140,동문로터리,33.24859,126.56853,34548,4399,38947,33712,4143,37855,제주특별자치도 서귀포시 서귀동 216-21
2141,안덕계곡,33.25786,126.35238,2208,136,2344,2179,128,2307,제주특별자치도 서귀포시 안덕면 감산리 362-7
2151,안좌동,33.35837,126.75583,71,1,72,71,1,72,제주특별자치도 서귀포시 표선면 가시리 2966-1
2155,토산1리리사무소,33.32595,126.76588999999998,323,8,331,323,7,330,제주특별자치도 서귀포시 표선면 토산리 1377-4
2159,동광단지,33.31388,126.35939,154,45,199,153,44,197,제주특별자치도 서귀포시 안덕면 동광리 74-34
2161,월광동,33.29311,126.2551,39,2,41,39,2,41,제주특별자치도 서귀포시 대정읍 무릉리 13
2162,산양곶자왈,33.29072,126.25085,54,9,63,54,9,63,제주특별자치도 제주시 한경면 청수리 955-2
2165,신도2리,33.2777,126.17565,24,4,28,23,4,27,제주특별자치도 서귀포시 대정읍 신도리 2606-2
2166,신도2리,33.27763,126.17567,57,4,61,57,3,60,제주특별자치도 서귀포시 대정읍 신도리 2566-1
2169,평지동옹기박물관,33.28242,126.2235,24,1,25,24,1,25,제주특별자치도 서귀포시 대정읍 무릉리 933-22
2170,좌기동,33.2747,126.23404,39,9,48,39,9,48,제주특별자치도 서귀포시 대정읍 무릉리 616-26
2173,산이수동,33.20847,126.29025,339,133,472,329,127,456,제주특별자치도 서귀포시 대정읍 상모리 125-1
2174,새소망요양병원,33.27882,126.36135,27,23,50,27,19,46,제주특별자치도 서귀포시 안덕면 상창리 2885
2175,새소망요양병원,33.27867,126.36139,13,22,35,13,20,33,제주특별자치도 서귀포시 안덕면 상창리 1276-3
2176,한밭입구,33.251059999999995,126.35806,30,8,38,30,7,37,제주특별자치도 서귀포시 안덕면 감산리 554
2177,한밭입구,33.25142,126.35817,19,2,21,19,2,21,제주특별자치도 서귀포시 안덕면 감산리 555
2178,광평리,33.3293,126.38198,223,19,242,213,17,230,제주특별자치도 서귀포시 안덕면 광평리 205-23
2179,상천리사무소,33.30743,126.3798,204,24,228,202,23,225,제주특별자치도 서귀포시 안덕면 상천리 472-2
2180,상천리사무소,33.30723,126.37999,160,332,492,148,316,464,제주특별자치도 서귀포시 안덕면 상천리 471-1
2185,토산초등학교,33.31185,126.77648,10,1,11,10,1,11,제주특별자치도 서귀포시 표선면 토산리 506-5
2186,토산초등학교,33.31007,126.7769,54,7,61,54,7,61,제주특별자치도 서귀포시 표선면 토산리 519-10
2187,토산초등학교,33.30986,126.77703,8,1,9,8,1,9,제주특별자치도 서귀포시 표선면 토산리 519-5
2192,하천리몰고랑터,33.35382,126.83679,472,1,473,472,1,473,제주특별자치도 서귀포시 표선면 하천리 788-2
2195,하천상동회관앞,33.3528,126.8389,444,3,447,444,3,447,제주특별자치도 서귀포시 표선면 하천리 725-4
2199,하천리세골세,33.34935,126.84028,34,1,35,33,1,34,제주특별자치도 서귀포시 표선면 하천리 563-2
2201,하천리중동,33.34723,126.84062,865,1,866,865,1,866,제주특별자치도 서귀포시 표선면 하천리 496-2
2202,물진밭입구,33.371,126.86158,110,76,186,101,74,175,제주특별자치도 서귀포시 성산읍 삼달리 108-6
2203,물진밭입구,33.37108,126.8616,44,7,51,43,6,49,제주특별자치도 서귀포시 성산읍 삼달리 105-2
2204,삼달1리삼달보건진료소,33.37325,126.85217,368,17,385,368,14,382,제주특별자치도 서귀포시 성산읍 삼달리 434-6
2205,삼달1리삼달보건진료소,33.37313,126.85223,358,10,368,357,10,367,제주특별자치도 서귀포시 성산읍 삼달리 448-2
2206,삼달1리사무소,33.37421,126.8481,343,19,362,343,15,358,제주특별자치도 서귀포시 성산읍 삼달리 726-1
2207,삼달1리,33.37406,126.84816000000001,105,4,109,105,4,109,제주특별자치도 서귀포시 성산읍 삼달리 729-3
2209,수산2리비석거리,33.4396,126.86507,293,31,324,293,30,323,제주특별자치도 서귀포시 성산읍 수산리 2481-2
2211,수산2리퐁낭거리,33.44113,126.86193,163,7,170,162,7,169,제주특별자치도 서귀포시 성산읍 수산리 4764
2214,수산1리비석거리,33.44354000000001,126.88844,55,37,92,55,36,91,제주특별자치도 서귀포시 성산읍 수산리 4764
2215,고성리장만이동산,33.44555,126.90047,597,169,766,577,162,739,제주특별자치도 서귀포시 성산읍 고성리 2088
2216,고성리장만이동산,33.44535,126.90068,392,428,820,376,420,796,제주특별자치도 서귀포시 성산읍 고성리 2087-6
2217,고성리노인회관,33.44662,126.90875,291,57,348,286,56,342,제주특별자치도 서귀포시 성산읍 고성리 1472-4
2218,고성리노인회관,33.44675,126.90865,1354,96,1450,1328,93,1421,제주특별자치도 서귀포시 성산읍 고성리 1485-2
2219,그린카센터,33.31698,126.82857,340,41,381,333,37,370,제주특별자치도 서귀포시 표선면 표선리 1461-4
2221,성산항,33.47032,126.93008,475,283,758,436,272,708,제주특별자치도 서귀포시 성산읍 성산리 347-16
2222,삼달1리삼거리,33.37116,126.84139,200,5,205,199,5,204,제주특별자치도 서귀포시 성산읍 삼달리 2260
2223,신풍리사거리,33.36458,126.83539,145,12,157,130,12,142,제주특별자치도 서귀포시 성산읍 신풍리 1728
2224,신풍리사무소,33.36172,126.83623,258,17,275,257,16,273,제주특별자치도 서귀포시 성산읍 신풍리 797
2225,신풍리화단이소,33.35848,126.8371,122,4,126,122,4,126,제주특별자치도 서귀포시 성산읍 신풍리 882-2
2226,신풍리사무소,33.36074,126.83562,666,19,685,662,19,681,제주특별자치도 서귀포시 성산읍 신풍리 746-1
2227,삼달1리삼거리,33.3714,126.84161,416,4,420,411,4,415,제주특별자치도 서귀포시 성산읍 삼달리 1223-2
2228,가시리,33.36135,126.76687,169,5,174,169,5,174,제주특별자치도 서귀포시 표선면 가시리 2502-2
2230,신풍리사거리,33.36465,126.83528,304,6,310,304,6,310,제주특별자치도 서귀포시 성산읍 신풍리 1728
2231,삼달1리,33.37397,126.84318,107,13,120,106,12,118,제주특별자치도 서귀포시 성산읍 삼달리 1152-13
2232,성읍1리,33.39208,126.80026,602,26,628,594,26,620,제주특별자치도 서귀포시 표선면 성읍리 3294
2233,표선환승정류장(표선면사무소),33.3265,126.83218,2200,100,2300,2163,91,2254,제주특별자치도 서귀포시 표선면 표선리 699
2236,가시농협,33.35263,126.77147,505,11,516,499,11,510,제주특별자치도 서귀포시 표선면 가시리 2015-4
2237,제주민속촌,33.32474000000001,126.84236,775,48,823,758,36,794,제주특별자치도 서귀포시 표선면 표선리 40
2238,영락리,33.257909999999995,126.21001,267,18,285,266,16,282,제주특별자치도 서귀포시 대정읍 영락리 2169
2239,감산리서동,33.2567,126.34952,18,8,26,17,1,18,제주특별자치도 서귀포시 안덕면 감산리 1471-1
2240,성산포수협,33.44888,126.91644,1064,881,1945,1009,835,1844,제주특별자치도 서귀포시 성산읍 고성리 298-2
2241,신흥리취락구조,33.29873,126.76482,1027,19,1046,1017,18,1035,제주특별자치도 서귀포시 남원읍 신흥리 632-38
2242,표선환승정류장(표선리사무소),33.32528,126.83246,14539,925,15464,14335,873,15208,제주특별자치도 서귀포시 표선면 표선리 631-6
2243,고성리제주은행,33.44868,126.916,13733,3115,16848,13412,3000,16412,제주특별자치도 서귀포시 성산읍 고성리 316-2
2244,하모3리,33.22158,126.25107,14469,526,14995,14314,497,14811,제주특별자치도 서귀포시 대정읍 하모리 1029-1
2246,하모2리,33.22146,126.25277,22909,1327,24236,22490,1240,23730,제주특별자치도 서귀포시 대정읍 하모리 921-19
2247,일과1리,33.2351,126.23592,18,15,33,18,14,32,제주특별자치도 서귀포시 대정읍 일과리 1954-1
2248,일과2리사무소,33.2452,126.22381,922,19,941,901,18,919,제주특별자치도 서귀포시 대정읍 일과리 1954
2249,안성리사무소앞,33.249340000000004,126.28127,598,24,622,592,22,614,제주특별자치도 서귀포시 대정읍 안성리 1589
2250,대정농공단지입구,33.24807,126.22026,545,33,578,537,32,569,제주특별자치도 서귀포시 대정읍 일과리 1838-4
2251,대정농공단지입구,33.24819,126.2204,186,26,212,181,26,207,제주특별자치도 서귀포시 대정읍 일과리 1954-3
2252,불미거동산,33.31768,126.74501,60,3,63,59,3,62,제주특별자치도 서귀포시 남원읍 신흥리 1586-3
2254,옛성정문,33.31817,126.74521,197,2,199,197,2,199,제주특별자치도 서귀포시 남원읍 신흥리 1593-1
2261,신흥1리사무소,33.305170000000004,126.76581000000002,95,1,96,95,1,96,제주특별자치도 서귀포시 남원읍 신흥리 245-2
2263,남원농협신흥지소,33.30238,126.76703,178,2,180,178,2,180,제주특별자치도 서귀포시 남원읍 신흥리 217-2
2264,남원농협신흥지소,33.302409999999995,126.76713,177,4,181,173,4,177,제주특별자치도 서귀포시 남원읍 신흥리 217-2
2265,거물여,33.33227,126.8005,71,3,74,71,1,72,제주특별자치도 서귀포시 표선면 세화리 2489
2266,거물여,33.33218,126.8007,479,18,497,477,14,491,제주특별자치도 서귀포시 표선면 세화리 1049-1
2267,세화1리마을회관,33.33176,126.79836,131,6,137,131,6,137,제주특별자치도 서귀포시 표선면 세화리 1122-1
2268,세화1리마을회관,33.33165,126.79838,882,5,887,876,4,880,제주특별자치도 서귀포시 표선면 세화리 1086-2
2270,세화1리북문,33.33266,126.79538,124,2,126,123,2,125,제주특별자치도 서귀포시 표선면 세화리 1989-4
2271,남원리월산동,33.29153,126.71058,302,8,310,301,8,309,제주특별자치도 서귀포시 남원읍 남원리 1058-6
2272,남원리월산동,33.29162,126.7107,158,1,159,156,1,157,제주특별자치도 서귀포시 남원읍 남원리 2490
2273,일과2리서림수원지입구,33.243390000000005,126.22758,54,6,60,53,6,59,제주특별자치도 서귀포시 대정읍 일과리 1472-3
2274,안덕초등학교,33.25007,126.33507,38,1,39,37,1,38,제주특별자치도 서귀포시 안덕면 화순리 1128-9
2275,안덕초등학교,33.25018,126.33513,1163,23,1186,1143,23,1166,제주특별자치도 서귀포시 안덕면 화순리 1290
2276,산방산,33.2368,126.31057,486,210,696,441,201,642,제주특별자치도 서귀포시 안덕면 사계리 190-2
2277,안성리,33.249390000000005,126.28195,704,58,762,696,58,754,제주특별자치도 서귀포시 대정읍 안성리 2038
2278,인성리(남문지앞사거리),33.24786,126.27762,2671,481,3152,2630,453,3083,제주특별자치도 서귀포시 대정읍 인성리 365-1
2279,하모3리 축협,33.22531,126.2524,2073,359,2432,2048,341,2389,제주특별자치도 서귀포시 대정읍 하모리 1423-20
2279,하모3리축협,33.22531,126.2524,2073,359,2432,2048,341,2389,제주특별자치도 서귀포시 대정읍 하모리 1423-20
2280,인성리(남문지앞사거리),33.2479,126.27734,1973,131,2104,1930,126,2056,제주특별자치도 서귀포시 대정읍 인성리 255-1
2281,서귀포자연휴양림,33.31185,126.45751,392,103,495,369,81,450,제주특별자치도 서귀포시 대포동 산 1-7
2282,거린사슴전망대,33.3076,126.45498,17,5,22,15,5,20,제주특별자치도 서귀포시 대포동 산 2-5
2283,법정사입구,33.3028,126.45845,154,19,173,150,19,169,제주특별자치도 서귀포시 대포동 산 6-5
2285,수산초등학교,33.44625,126.88632,436,48,484,434,46,480,제주특별자치도 서귀포시 성산읍 수산리 4764
2289,가시리사무소,33.35303,126.77152,114,18,132,106,16,122,제주특별자치도 서귀포시 표선면 가시리 3805
2290,가시농협,33.35269,126.7716,694,21,715,691,21,712,제주특별자치도 서귀포시 표선면 가시리 2009-2
2291,가시리동하동,33.35014,126.7739,154,2,156,151,1,152,제주특별자치도 서귀포시 표선면 가시리 3806
2292,가시리동하동,33.35025,126.77391,138,16,154,138,10,148,제주특별자치도 서귀포시 표선면 가시리 2050
2294,토산1리운동장,33.33283,126.76894,34,9,43,34,9,43,제주특별자치도 서귀포시 표선면 토산리 2057
2295,토산1리운동장입구,33.33267,126.7691,34,3,37,34,3,37,제주특별자치도 서귀포시 표선면 토산리 2057
2296,토산1리노인회관앞,33.32963,126.7704,313,1,314,313,1,314,제주특별자치도 서귀포시 표선면 토산리 936-2
2297,토산보건소동쪽,33.32748,126.76815,44,1,45,44,1,45,제주특별자치도 서귀포시 표선면 토산리 1434-2
2298,토산1리리사무소앞,33.32595,126.76573,418,11,429,413,10,423,제주특별자치도 서귀포시 표선면 토산리 1376-3
2302,신흥2리보건진료소,33.3197,126.74796,249,19,268,248,19,267,제주특별자치도 서귀포시 남원읍 신흥리 1770-10
2303,신흥2리보건진료소,33.31969,126.74817,155,9,164,154,9,163,제주특별자치도 서귀포시 남원읍 신흥리 1770-6
2304,신흥2리사무소,33.32173,126.74543,183,1,184,183,1,184,제주특별자치도 서귀포시 남원읍 신흥리 1784-2
2305,신흥2리사무소,33.32159,126.74536,128,2,130,128,2,130,제주특별자치도 서귀포시 남원읍 신흥리 1756-5
2309,무릉2리소공원,33.27234,126.24558,159,4,163,156,3,159,제주특별자치도 서귀포시 대정읍 무릉리 산 65-14
2310,좌기동,33.27454,126.23425,543,18,561,536,18,554,제주특별자치도 서귀포시 대정읍 무릉리 605-15
2311,평지동,33.28078,126.22647,226,4,230,226,4,230,제주특별자치도 서귀포시 대정읍 무릉리 965-2
2312,평지동,33.28114,126.22645,46,2,48,46,2,48,제주특별자치도 서귀포시 대정읍 무릉리 965-16
2313,평지동옹기박물관,33.28217,126.22381,254,2,256,254,2,256,제주특별자치도 서귀포시 대정읍 무릉리 945-3
2314,응전동,33.28295,126.30022,183,5,188,182,5,187,제주특별자치도 서귀포시 안덕면 서광리 2471
2315,응전동,33.28295,126.30037,58,7,65,58,7,65,제주특별자치도 서귀포시 안덕면 서광리 2140-4
2316,덕수도련동,33.26498,126.30442,107,7,114,99,7,106,제주특별자치도 서귀포시 안덕면 덕수리 1967-2
2317,덕수도련동,33.26505,126.30468,91,8,99,90,6,96,제주특별자치도 서귀포시 안덕면 덕수리 1969-1
2318,덕수리새마을금고,33.25672,126.30459,184,4,188,183,4,187,제주특별자치도 서귀포시 안덕면 덕수리 2153-7
2319,덕수리새마을금고,33.25659,126.30437,151,5,156,147,5,152,제주특별자치도 서귀포시 안덕면 덕수리 2137-1
2320,불미공방,33.25349,126.30433,274,6,280,273,6,279,제주특별자치도 서귀포시 안덕면 덕수리 2330-9
2321,불미공방,33.25323,126.30402,207,6,213,206,6,212,제주특별자치도 서귀포시 안덕면 덕수리 3004
2322,해병부대,33.231,126.26273,3082,196,3278,2978,194,3172,제주특별자치도 서귀포시 대정읍 상모리 3396-2
2323,제주조각공원,33.24901,126.32132,11,1,12,11,1,12,제주특별자치도 서귀포시 안덕면 사계리 3606
2324,골물동입구,33.25095,126.33397,91,5,96,90,5,95,제주특별자치도 서귀포시 안덕면 화순리 1234-3
2325,상수동,33.25626,126.33525,76,4,80,76,4,80,제주특별자치도 서귀포시 안덕면 화순리 1686-4
2332,한남농장,33.29913,126.6814,34,1,35,34,1,35,제주특별자치도 서귀포시 남원읍 한남리 480-24
2340,난산리사무소,33.40124,126.87116,1041,5,1046,1040,5,1045,제주특별자치도 서귀포시 성산읍 난산리 1075-3
2343,난산동동네,33.40206,126.8758,733,3,736,733,3,736,제주특별자치도 서귀포시 성산읍 난산리 373-4
2346,성산리입구,33.46067,126.93132,1073,413,1486,1034,391,1425,제주특별자치도 서귀포시 성산읍 성산리 400-3
2347,성산리입구,33.46085,126.93127,4826,1075,5901,4690,1025,5715,제주특별자치도 서귀포시 성산읍 성산리 168-11
2348,성산일출봉입구,33.462709999999994,126.93303,4949,3680,8629,4600,3490,8090,제주특별자치도 서귀포시 성산읍 성산리 178-12
2349,성산일출봉입구,33.46376,126.93377,17064,8548,25612,16023,7993,24016,제주특별자치도 서귀포시 성산읍 성산리 229-2
2350,성산리,33.46521,126.93519,1034,1021,2055,961,975,1936,제주특별자치도 서귀포시 성산읍 성산리 284-3
2351,성산리취락구조,33.46603,126.9349,788,495,1283,734,472,1206,제주특별자치도 서귀포시 성산읍 성산리 299-1
2352,성산리취락구조,33.46603,126.93441,317,135,452,302,129,431,제주특별자치도 서귀포시 성산읍 성산리 261-8
2353,성산항입구,33.4682,126.92955,4591,3096,7687,4264,2915,7179,제주특별자치도 서귀포시 성산읍 성산리 369-3
2354,성산항입구,33.46849,126.92917,5286,4318,9604,4790,4049,8839,제주특별자치도 서귀포시 성산읍 성산리 363
2355,성산항,33.47043,126.92994,12214,8383,20597,10718,7584,18302,제주특별자치도 서귀포시 성산읍 성산리 347-5
2356,오조해녀의집,33.46885,126.92253,1272,376,1648,1205,364,1569,제주특별자치도 서귀포시 성산읍 오조리 2-4
2357,오조해녀의집,33.4687,126.92232,471,326,797,442,310,752,제주특별자치도 서귀포시 성산읍 오조리 2-5
2358,성산고입구삼거리,33.46545,126.90917,129,78,207,125,77,202,제주특별자치도 서귀포시 성산읍 오조리 618-4
2359,오조리,33.46712,126.91305,337,124,461,328,119,447,제주특별자치도 서귀포시 성산읍 오조리 623-3
2360,오조리입구,33.46715,126.91345,204,152,356,194,150,344,제주특별자치도 서귀포시 성산읍 오조리 268-1
2361,성산고등학교,33.46845,126.91674,1418,249,1667,1329,238,1567,제주특별자치도 서귀포시 성산읍 오조리 337-1
2362,성산고등학교,33.46858,126.91678,1667,234,1901,1591,225,1816,제주특별자치도 서귀포시 성산읍 오조리 2210
2364,모슬포우체국,33.22255,126.25518999999998,431,56,487,425,55,480,제주특별자치도 서귀포시 대정읍 하모리 820-1
2365,덕수초등학교,33.25023,126.30357,693,136,829,681,132,813,제주특별자치도 서귀포시 안덕면 사계리 757-1
2366,제주조각공원,33.249309999999994,126.32133,296,12,308,294,11,305,제주특별자치도 서귀포시 안덕면 사계리 3591-4
2367,상수동,33.25627,126.33512,44,5,49,44,5,49,제주특별자치도 서귀포시 안덕면 화순리 1688-1
2368,신풍입구,33.36131,126.82042,1490,44,1534,1477,43,1520,제주특별자치도 서귀포시 표선면 하천리 2611
2369,신풍입구,33.36105,126.82045,9,1,10,9,1,10,제주특별자치도 서귀포시 표선면 하천리 1451-6
2370,하천리마을입구,33.35399,126.82377,1222,35,1257,1203,33,1236,제주특별자치도 서귀포시 표선면 하천리 1251-7
2371,하천리마을입구,33.353970000000004,126.82334,173,35,208,164,33,197,제주특별자치도 서귀포시 표선면 하천리 1559-1
2372,표선청년회의소,33.33729,126.82802,38,17,55,38,12,50,제주특별자치도 서귀포시 표선면 표선리 1860-3
2373,표선청년회의소,33.33701,126.82823,167,5,172,165,5,170,제주특별자치도 서귀포시 표선면 표선리 1881-2
2374,표선고등학교,33.33104,126.82975,508,8,516,494,8,502,제주특별자치도 서귀포시 표선면 표선리 314-12
2375,표선고등학교,33.3313,126.82988,3008,121,3129,2913,114,3027,제주특별자치도 서귀포시 표선면 표선리 309-2
2377,표선중학교,33.32826,126.83122,1072,8,1080,1042,8,1050,제주특별자치도 서귀포시 표선면 표선리 2954
2379,표선환승정류장(표선면사무소),33.32658,126.83235,27398,2314,29712,26817,2131,28948,제주특별자치도 서귀포시 표선면 표선리 600-4
2380,표선초등학교,33.329840000000004,126.83618,884,48,932,866,41,907,제주특별자치도 서귀포시 표선면 표선리 447-3
2381,표선초등학교,33.32875,126.83543,1138,253,1391,1093,242,1335,제주특별자치도 서귀포시 표선면 표선리 466-6
2382,표선환승정류장(표선리제주은행),33.32662,126.83322,11951,1149,13100,11605,1083,12688,제주특별자치도 서귀포시 표선면 표선리 597-1
2383,표선파출소,33.32406,126.83109,1591,11,1602,1587,11,1598,제주특별자치도 서귀포시 표선면 표선리 671-1
2384,표선파출소,33.32421,126.83074,236,2,238,235,2,237,제주특별자치도 서귀포시 표선면 표선리 671-1
2386,관통사,33.32705,126.82712,101,2,103,100,2,102,제주특별자치도 서귀포시 표선면 표선리 1681-1
2387,역지동,33.34689,126.78357,198,1,199,198,1,199,제주특별자치도 서귀포시 표선면 가시리 3801
2389,가시리동상동,33.35351,126.77388,386,7,393,384,7,391,제주특별자치도 서귀포시 표선면 가시리 1983-1
2390,가시리동상동,33.35381,126.77391,134,3,137,132,3,135,제주특별자치도 서귀포시 표선면 가시리 1973-1
2391,가시리,33.36144,126.76661,253,10,263,253,10,263,제주특별자치도 서귀포시 표선면 가시리 3805
2394,성읍1리,33.386520000000004,126.79911,1133,107,1240,1091,98,1189,제주특별자치도 서귀포시 표선면 성읍리 727-1
2395,성읍1리,33.38649,126.79897,980,96,1076,965,94,1059,제주특별자치도 서귀포시 표선면 성읍리 731-1
2396,성읍1리,33.38375,126.79949,632,65,697,619,63,682,제주특별자치도 서귀포시 표선면 성읍리 998
2397,성읍1리,33.3837,126.7997,569,46,615,552,41,593,제주특별자치도 서귀포시 표선면 성읍리 993-3
2398,성읍농협앞,33.39078,126.8008,3620,189,3809,3586,180,3766,제주특별자치도 서귀포시 표선면 성읍리 603-2
2399,성읍농협,33.39047,126.801,4993,180,5173,4930,175,5105,제주특별자치도 서귀포시 표선면 성읍리 592
2400,성읍1리,33.3921,126.79992,888,28,916,879,28,907,제주특별자치도 서귀포시 표선면 성읍리 1615
2401,바스메,33.405640000000005,126.77834,105,16,121,99,13,112,제주특별자치도 서귀포시 표선면 성읍리 3294
2402,바스메,33.405809999999995,126.77842,152,13,165,142,13,155,제주특별자치도 서귀포시 표선면 성읍리 2675-1
2403,성읍2리,33.41011,126.76987,668,78,746,647,74,721,제주특별자치도 서귀포시 표선면 성읍리 3030-1
2404,성읍2리,33.41088,126.76887,864,91,955,834,89,923,제주특별자치도 서귀포시 표선면 성읍리 3031-3
2405,표선면충혼묘지,33.416129999999995,126.7626,233,165,398,232,162,394,제주특별자치도 서귀포시 표선면 성읍리 3144-2
2406,표선면충혼묘지,33.41621,126.76281000000002,302,293,595,284,290,574,제주특별자치도 서귀포시 표선면 성읍리 3144-4
2407,서의동,33.3009,126.70448,77,1,78,77,1,78,제주특별자치도 서귀포시 남원읍 남원리 2490
2408,원불교,33.2845,126.71523,276,4,280,276,4,280,제주특별자치도 서귀포시 남원읍 남원리 1227-4
2409,원불교,33.28485,126.7149,573,2,575,569,2,571,제주특별자치도 서귀포시 남원읍 남원리 1228-8
2410,남원2리,33.2951,126.70787,257,2,259,257,2,259,제주특별자치도 서귀포시 남원읍 남원리 989-2
2411,남원2리,33.29553,126.70779,35,2,37,34,2,36,제주특별자치도 서귀포시 남원읍 남원리 948-1
2412,서의동,33.3011,126.70385,509,3,512,508,3,511,제주특별자치도 서귀포시 남원읍 남원리 734-5
2414,한남리사무소,33.31192,126.69555,812,7,819,807,7,814,제주특별자치도 서귀포시 남원읍 한남리 359-2
2416,대전동,33.31392,126.70043,24,2,26,24,2,26,제주특별자치도 서귀포시 남원읍 한남리 62-1
2417,의귀서동네,33.30986,126.71198,451,5,456,451,5,456,제주특별자치도 서귀포시 남원읍 의귀리 1480-2
2418,의귀서동네,33.30964,126.71174,70,1,71,70,1,71,제주특별자치도 서귀포시 남원읍 의귀리 2006
2421,입석동,33.31636,126.59728,728,54,782,698,53,751,제주특별자치도 서귀포시 남원읍 하례리 산 144
2422,입석동,33.31595,126.59673,356,32,388,345,31,376,제주특별자치도 서귀포시 상효동 산 108-10
2424,신도3리,33.28585,126.18588,693,20,713,690,18,708,제주특별자치도 서귀포시 대정읍 신도리 1880-7
2425,신도1리,33.27841,126.19133,714,45,759,706,44,750,제주특별자치도 서귀포시 대정읍 신도리 1381-23
2426,신도1리,33.2777,126.1915,2173,41,2214,2154,41,2195,제주특별자치도 서귀포시 대정읍 신도리 1402
2427,무릉문화의집,33.27273,126.1991,225,14,239,222,14,236,제주특별자치도 서귀포시 대정읍 무릉리 3314-6
2428,무릉문화의집,33.27243,126.19948,992,20,1012,984,19,1003,제주특별자치도 서귀포시 대정읍 무릉리 3295-8
2429,무릉1리학교앞,33.271440000000005,126.20182,993,38,1031,981,38,1019,제주특별자치도 서귀포시 대정읍 무릉리 2802-1
2430,무릉1리리사무소앞,33.2703,126.2031,2299,39,2338,2248,37,2285,제주특별자치도 서귀포시 대정읍 무릉리 2929-2
2431,영락사통,33.26071,126.20782,197,1,198,196,1,197,제주특별자치도 서귀포시 대정읍 영락리 1240-3
2432,영락사통,33.2606,126.20777,923,16,939,910,16,926,제주특별자치도 서귀포시 대정읍 영락리 2169
2433,영락리,33.25708,126.21033,1613,28,1641,1604,25,1629,제주특별자치도 서귀포시 대정읍 영락리 1297-8
2434,일과2리사무소,33.24536,126.22415,200,20,220,197,20,217,제주특별자치도 서귀포시 대정읍 일과리 1499-4
2435,일과2리서림수원지입구,33.24273,126.22842,21,2,23,20,2,22,제주특별자치도 서귀포시 대정읍 일과리 901-11
2436,대수동,33.24001,126.23389,169,47,216,165,46,211,제주특별자치도 서귀포시 대정읍 일과리 1055-4
2437,대수동,33.23959,126.23362,622,61,683,611,60,671,제주특별자치도 서귀포시 대정읍 일과리 1110-10
2439,대정서초등학교,33.23195,126.23825,85,3,88,84,3,87,제주특별자치도 서귀포시 대정읍 동일리 2659-2
2440,대정서초등학교,33.23178,126.23817,307,29,336,305,26,331,제주특별자치도 서귀포시 대정읍 동일리 3168-3
2441,동일1리,33.22848,126.24271,404,33,437,396,32,428,제주특별자치도 서귀포시 대정읍 동일리 2821-5
2442,동일1리,33.22818,126.24307,1134,55,1189,1127,53,1180,제주특별자치도 서귀포시 대정읍 동일리 2823-3
2443,대정읍사무소,33.22592,126.25171,2339,36,2375,2316,34,2350,제주특별자치도 서귀포시 대정읍 하모리 1423-2
2445,대정초교후문,33.225570000000005,126.25638,3270,61,3331,3229,58,3287,제주특별자치도 서귀포시 대정읍 상모리 3856-3
2446,대정초교후문,33.22575,126.25616,376,66,442,370,65,435,제주특별자치도 서귀포시 대정읍 상모리 3856-5
2447,진개동산,33.22531,126.24736,1056,51,1107,1043,50,1093,제주특별자치도 서귀포시 대정읍 동일리 2998-2
2448,모슬포우체국,33.22253,126.25548,4044,131,4175,3989,121,4110,제주특별자치도 서귀포시 대정읍 상모리 3944-5
2449,상모2리,33.22318,126.2578,318,8,326,315,7,322,제주특별자치도 서귀포시 대정읍 상모리 3978-1
2450,상모3리,33.22312,126.25812,1539,45,1584,1517,43,1560,제주특별자치도 서귀포시 대정읍 상모리 3976-2
2451,상모리감협,33.2241,126.26184,267,43,310,263,41,304,제주특별자치도 서귀포시 대정읍 상모리 3169-1
2452,상모리감협,33.22415,126.26252,1165,74,1239,1135,72,1207,제주특별자치도 서귀포시 대정읍 상모리 3175-4
2453,상모리이교동,33.2254,126.26717,1106,64,1170,1099,64,1163,제주특별자치도 서귀포시 대정읍 상모리 2675-2
2454,상모리이교동,33.22558,126.26746,437,12,449,436,12,448,제주특별자치도 서귀포시 대정읍 상모리 2667-2
2456,상모,33.2247,126.26579,55,5,60,46,5,51,제주특별자치도 서귀포시 대정읍 상모리 3200-4
2457,사계리서동,33.230270000000004,126.2926,1337,75,1412,1318,73,1391,제주특별자치도 서귀포시 안덕면 사계리 3439-4
2458,사계리서동,33.23106,126.29331,128,2,130,128,2,130,제주특별자치도 서귀포시 안덕면 사계리 2699
2459,사계리사무소,33.23128,126.29752,3620,435,4055,3543,414,3957,제주특별자치도 서귀포시 안덕면 사계리 3582
2460,사계리사무소,33.23161,126.29804,2225,116,2341,2200,112,2312,제주특별자치도 서귀포시 안덕면 사계리 2843-1
2461,사계리동동,33.23451,126.30772,1723,453,2176,1656,440,2096,제주특별자치도 서귀포시 안덕면 사계리 3578
2462,사계리동동,33.23489,126.30823,61,30,91,58,30,88,제주특별자치도 서귀포시 안덕면 사계리 3578
2463,산방산,33.23673,126.31046,105,27,132,103,27,130,제주특별자치도 서귀포시 안덕면 사계리 192-6
2464,산방산,33.23612,126.31248,1036,824,1860,979,786,1765,제주특별자치도 서귀포시 안덕면 사계리 176-2
2465,산방산,33.23623,126.31245,509,292,801,489,276,765,제주특별자치도 서귀포시 안덕면 사계리 166-4
2466,화순리,33.246320000000004,126.33197,4174,349,4523,4108,339,4447,제주특별자치도 서귀포시 안덕면 화순리 1061-8
2467,화순리,33.24642,126.33197,2429,302,2731,2375,285,2660,제주특별자치도 서귀포시 안덕면 화순리 1061-2
2468,화순환승정류장(안덕농협),33.246520000000004,126.33507,14514,604,15118,14298,575,14873,제주특별자치도 서귀포시 안덕면 화순리 1075-7
2469,화순환승정류장(안덕농협),33.24665,126.33519,6652,425,7077,6515,411,6926,제주특별자치도 서귀포시 안덕면 화순리 1075-5
2470,화순동취락지구,33.24922,126.33932,153,73,226,150,69,219,제주특별자치도 서귀포시 안덕면 화순리 233
2471,화순동취락지구,33.25006,126.34033,567,140,707,556,137,693,제주특별자치도 서귀포시 안덕면 화순리 230-5
2472,덕수리군물왓,33.250640000000004,126.31592,147,21,168,147,21,168,제주특별자치도 서귀포시 안덕면 덕수리 617-2
2473,덕수리군물왓,33.250809999999994,126.31438,359,31,390,356,30,386,제주특별자치도 서귀포시 안덕면 덕수리 663-4
2474,덕수리동동,33.25053,126.30857,703,121,824,683,117,800,제주특별자치도 서귀포시 안덕면 덕수리 2369-5
2475,덕수리동동,33.25072,126.30794,402,20,422,400,20,420,제주특별자치도 서귀포시 안덕면 덕수리 2368-1
2476,덕수초등학교,33.25053,126.30433,2577,257,2834,2526,254,2780,제주특별자치도 서귀포시 안덕면 사계리 753-4
2477,덕수초등학교,33.25069000000001,126.30298,834,56,890,821,55,876,제주특별자치도 서귀포시 안덕면 덕수리 2439-1
2478,대정고등학교,33.23035,126.2619,681,71,752,626,70,696,제주특별자치도 서귀포시 대정읍 상모리 3396-2
2479,대정농공단지,33.257220000000004,126.22922,68,10,78,67,9,76,제주특별자치도 서귀포시 대정읍 일과리 551-17
2480,대정농공단지,33.257459999999995,126.22935,193,16,209,192,15,207,제주특별자치도 서귀포시 대정읍 일과리 산 1-2
2482,동일2리입구,33.26041,126.23403,21,2,23,19,1,20,제주특별자치도 서귀포시 대정읍 동일리 산 6
2483,인향동입구,33.272290000000005,126.24571,592,6,598,587,6,593,제주특별자치도 서귀포시 대정읍 무릉리 산 65-6
2484,신평리,33.26467,126.2593,1360,13,1373,1352,13,1365,제주특별자치도 서귀포시 대정읍 신평리 364-4
2485,보성상동,33.2522,126.27336,204,1,205,204,1,205,제주특별자치도 서귀포시 대정읍 보성리 2138
2486,보성상동,33.25246,126.27336,386,1,387,381,1,382,제주특별자치도 서귀포시 대정읍 보성리 1693-3
2487,보성초등학교,33.24994,126.27675,825,163,988,805,155,960,제주특별자치도 서귀포시 대정읍 보성리 2138
2488,보성초등학교,33.2498,126.27714,218,17,235,216,14,230,제주특별자치도 서귀포시 대정읍 인성리 227
2489,서광리,33.28887,126.32491,1933,283,2216,1890,269,2159,제주특별자치도 서귀포시 안덕면 서광리 366-10
2490,서광리,33.289190000000005,126.32465,628,51,679,623,49,672,제주특별자치도 서귀포시 안덕면 서광리 367-3
2491,동광리,33.30637,126.33837,1018,29,1047,1012,25,1037,제주특별자치도 서귀포시 안덕면 동광리 995-2
2492,동광문화마을,33.30592,126.33815,751,68,819,746,68,814,제주특별자치도 서귀포시 안덕면 동광리 1597
2493,동광환승정류장6(모슬포방면),33.30968,126.34025,3447,509,3956,3394,494,3888,제주특별자치도 서귀포시 안덕면 동광리 950-3
2494,동광환승정류장5(서귀방면),33.30958,126.34083,12058,3402,15460,11814,3296,15110,제주특별자치도 서귀포시 안덕면 동광리 807-5
2495,동광환승정류장4(제주방면),33.31044,126.34099,25438,6524,31962,24748,6245,30993,제주특별자치도 서귀포시 안덕면 동광리 824-1
2496,동광환승정류장3(한림방면),33.31048,126.34052,1663,99,1762,1654,98,1752,제주특별자치도 서귀포시 안덕면 동광리 825-3
2497,감산리서동,33.256809999999994,126.34866,966,14,980,966,14,980,제주특별자치도 서귀포시 안덕면 감산리 1516-1
2499,안성리가스충전소,33.251020000000004,126.2837,25,7,32,25,7,32,제주특별자치도 서귀포시 대정읍 안성리 1454-20
2500,추사유배지,33.2491,126.27888,105,8,113,102,8,110,제주특별자치도 서귀포시 대정읍 인성리 208-2
2501,인성리(보성농협앞),33.2482,126.27692,29,6,35,29,6,35,제주특별자치도 서귀포시 대정읍 인성리 728
2502,신평리,33.26512,126.2588,69,8,77,68,8,76,제주특별자치도 서귀포시 대정읍 신평리 367-21
2503,신평리,33.265159999999995,126.25931,1424,40,1464,1404,40,1444,제주특별자치도 서귀포시 대정읍 신평리 367-5
2505,신평리상동,33.26815,126.26233,213,12,225,213,12,225,제주특별자치도 서귀포시 대정읍 신평리 610-7
2506,구억리,33.27237,126.2789,1812,119,1931,1762,109,1871,제주특별자치도 서귀포시 대정읍 보성리 463-7
2507,구억리삼거리,33.27278,126.2794,524,114,638,519,113,632,제주특별자치도 서귀포시 대정읍 안성리 2030-26
2508,구억리상동,33.2786,126.28355,270,12,282,265,11,276,제주특별자치도 서귀포시 대정읍 구억리 858-7
2509,구억리상동,33.27891,126.2835,176,32,208,172,31,203,제주특별자치도 서귀포시 대정읍 구억리 1055
2511,평화의마을,33.27955,126.29337,360,5,365,358,5,363,제주특별자치도 서귀포시 대정읍 구억리 305-4
2512,서광서보건진료소,33.28335,126.29848,389,22,411,387,22,409,제주특별자치도 서귀포시 안덕면 서광리 2055-11
2513,서광서보건진료소,33.2836,126.29855,211,14,225,211,13,224,제주특별자치도 서귀포시 안덕면 서광리 2055-10
2514,서광서리,33.28607,126.30263,2232,151,2383,2196,150,2346,제주특별자치도 서귀포시 안덕면 서광리 2471
2515,서광서리,33.28618,126.30273,1058,52,1110,1039,51,1090,제주특별자치도 서귀포시 안덕면 서광리 1906-8
2516,서광서리사수동,33.28797,126.30676,128,26,154,128,26,154,제주특별자치도 서귀포시 안덕면 서광리 1788-1
2517,서광서리사수동,33.28797,126.30703,193,110,303,189,108,297,제주특별자치도 서귀포시 안덕면 서광리 1789-6
2518,서광동리마을,33.28682,126.32885,430,99,529,425,95,520,제주특별자치도 서귀포시 안덕면 서광리 274-24
2519,서광동리마을,33.28693,126.32873,376,50,426,370,48,418,제주특별자치도 서귀포시 안덕면 서광리 283-3
2520,서광동리소랑못,33.28596,126.33143,429,7,436,427,7,434,제주특별자치도 서귀포시 안덕면 서광리 75-8
2521,서광동리소랑못,33.285920000000004,126.33172,256,7,263,253,6,259,제주특별자치도 서귀포시 안덕면 서광리 80-5
2522,남원읍사무소,33.27957,126.72102,12055,442,12497,11895,424,12319,제주특별자치도 서귀포시 남원읍 남원리 97-5
2523,남원읍사무소,33.2794,126.71975,11124,191,11315,10947,186,11133,제주특별자치도 서귀포시 남원읍 남원리 100-3
2524,동부보건소,33.27526,126.70338,2122,238,2360,2061,207,2268,제주특별자치도 서귀포시 남원읍 남원리 2490-116
2525,씨사이드홈,33.28035,126.7232,1024,17,1041,1015,16,1031,제주특별자치도 서귀포시 남원읍 남원리 2490-116
2526,씨사이드홈,33.28052,126.72421,709,22,731,703,17,720,제주특별자치도 서귀포시 남원읍 남원리 70-1
2527,진은동,33.28242,126.72973,1091,26,1117,1087,25,1112,제주특별자치도 서귀포시 남원읍 태흥리 1771-3
2529,서소동,33.28365,126.73523,2277,17,2294,2268,13,2281,제주특별자치도 서귀포시 남원읍 태흥리 2008
2530,서소동,33.28366,126.73605,380,20,400,380,20,400,제주특별자치도 서귀포시 남원읍 태흥리 1204-4
2531,무도동,33.28479,126.74089,2667,76,2743,2641,73,2714,제주특별자치도 서귀포시 남원읍 태흥리 979-2
2532,무도동,33.28496,126.74192,626,40,666,620,40,660,제주특별자치도 서귀포시 남원읍 태흥리 2003
2533,태흥초등학교,33.28635,126.74501,3338,70,3408,3288,69,3357,제주특별자치도 서귀포시 남원읍 태흥리 2003
2534,폭낭사거리,33.28663,126.74597,812,46,858,805,46,851,제주특별자치도 서귀포시 남원읍 태흥리 527-3
2535,어촌계입구,33.2878,126.74771,2070,115,2185,2060,102,2162,제주특별자치도 서귀포시 남원읍 태흥리 616-2
2536,어촌계입구,33.28829,126.749,390,62,452,373,48,421,제주특별자치도 서귀포시 남원읍 태흥리 369-1
2537,태흥3리사무소,33.29358,126.75783,2671,34,2705,2644,31,2675,제주특별자치도 서귀포시 남원읍 태흥리 2001
2538,태흥3리사무소,33.29437,126.75918,1044,24,1068,1033,22,1055,제주특별자치도 서귀포시 남원읍 태흥리 120-8
2539,태흥3리,33.29568,126.76083,479,10,489,469,10,479,제주특별자치도 서귀포시 남원읍 태흥리 20-13
2540,신흥리취락구조,33.298590000000004,126.76491,435,7,442,432,7,439,제주특별자치도 서귀포시 남원읍 신흥리 134-10
2541,신흥교차로,33.300259999999994,126.76677,5,2,7,5,2,7,제주특별자치도 서귀포시 남원읍 신흥리 138-5
2542,신흥교차로,33.30072,126.76699,2665,61,2726,2643,61,2704,제주특별자치도 서귀포시 남원읍 신흥리 167-19
2543,수농원,33.30299,126.76973999999998,488,29,517,486,28,514,제주특별자치도 서귀포시 남원읍 신흥리 196-8
2544,수농원,33.30323,126.77051000000002,1415,92,1507,1400,88,1488,제주특별자치도 서귀포시 남원읍 신흥리 115-3
2545,송천교,33.3075,126.77767,461,21,482,449,21,470,제주특별자치도 서귀포시 표선면 토산리 2057
2546,송천교,33.30733,126.77843,649,26,675,645,26,671,제주특별자치도 서귀포시 표선면 토산리 454-4
2547,산여리통입구,33.30731,126.78144,1851,58,1909,1825,55,1880,제주특별자치도 서귀포시 표선면 토산리 2057
2548,산여리통입구,33.307520000000004,126.78143,1332,42,1374,1276,41,1317,제주특별자치도 서귀포시 표선면 토산리 436-10
2549,토산관광지구입구,33.30737,126.78657,264,17,281,256,14,270,제주특별자치도 서귀포시 표선면 토산리 71-3
2550,토산관광지구입구,33.30713,126.78666,117,6,123,114,6,120,제주특별자치도 서귀포시 표선면 토산리 69-2
2551,샤인빌리조트입구,33.30672,126.79413999999998,1555,355,1910,1496,322,1818,제주특별자치도 서귀포시 표선면 세화리 1567-3
2552,샤인빌리조트입구,33.306940000000004,126.79386,1406,169,1575,1375,158,1533,제주특별자치도 서귀포시 표선면 세화리 1579-11
2553,가마초등학교,33.3067,126.79962,782,43,825,774,42,816,제주특별자치도 서귀포시 표선면 세화리 1522-4
2554,가마초등학교,33.30655,126.80033,1385,48,1433,1350,46,1396,제주특별자치도 서귀포시 표선면 세화리 1540-4
2555,세화2리사무소,33.30685,126.8039,520,32,552,508,30,538,제주특별자치도 서귀포시 표선면 세화리 2491
2556,세화2리사무소,33.30682,126.80492,1702,74,1776,1689,71,1760,제주특별자치도 서귀포시 표선면 세화리 250-23
2557,가흥동,33.30712,126.80675,386,28,414,380,26,406,제주특별자치도 서귀포시 표선면 세화리 2489-7
2558,가흥동,33.30758,126.80851,890,24,914,876,24,900,제주특별자치도 서귀포시 표선면 세화리 133-4
2559,한지동,33.309059999999995,126.81153,453,58,511,444,56,500,제주특별자치도 서귀포시 표선면 표선리 2905-6
2560,한지동,33.30918,126.81223,646,54,700,631,54,685,제주특별자치도 서귀포시 표선면 표선리 2913-7
2561,동원산업,33.31227,126.82212,124,7,131,122,7,129,제주특별자치도 서귀포시 표선면 표선리 2302-2
2562,동원산업,33.31221,126.8225,206,8,214,204,8,212,제주특별자치도 서귀포시 표선면 표선리 2305-2
2563,그린카센터,33.31687,126.82866,154,32,186,153,30,183,제주특별자치도 서귀포시 표선면 표선리 1466-3
2564,표선오일시장,33.321,126.8303,1419,30,1449,1399,28,1427,제주특별자치도 서귀포시 표선면 표선리 2954
2565,표선오일시장,33.32183,126.83083,666,28,694,654,28,682,제주특별자치도 서귀포시 표선면 표선리 1018-6
2566,표선파출소,33.32328,126.83152,1176,49,1225,1165,47,1212,제주특별자치도 서귀포시 표선면 표선리 779-6
2567,성산포수협표선지점,33.32405,126.83173,11028,389,11417,10854,368,11222,제주특별자치도 서귀포시 표선면 표선리 663-1
2568,막상올레,33.32582,126.83392,8903,80,8983,8741,75,8816,제주특별자치도 서귀포시 표선면 표선리 2954
2569,표선리사거리,33.3257,126.8335,861,187,1048,851,182,1033,제주특별자치도 서귀포시 표선면 표선리 634
2571,하천리취락구조,33.3376,126.84278,174,29,203,170,28,198,제주특별자치도 서귀포시 표선면 하천리 292-7
2572,하천하동,33.33973,126.84422,2367,62,2429,2347,58,2405,제주특별자치도 서귀포시 표선면 하천리 275-1
2573,하천하동,33.34033,126.84489,464,50,514,459,49,508,제주특별자치도 서귀포시 표선면 하천리 295-5
2574,신천리,33.34441,126.84885,2731,39,2770,2710,38,2748,제주특별자치도 서귀포시 성산읍 신천리 892-2
2575,신천리,33.34488,126.84978,967,43,1010,959,41,1000,제주특별자치도 서귀포시 성산읍 신천리 482
2576,신천리취락구조,33.34805,126.85363,230,8,238,227,8,235,제주특별자치도 서귀포시 성산읍 신천리 562-2
2577,신천리취락구조,33.34848,126.85395,828,78,906,813,74,887,제주특별자치도 서귀포시 성산읍 신천리 595-2
2580,신풍리하동,33.36257,126.86511000000002,542,105,647,523,103,626,제주특별자치도 서귀포시 성산읍 신풍리 75-2
2581,신풍리하동,33.36393,126.8653,472,50,522,468,44,512,제주특별자치도 서귀포시 성산읍 신풍리 1728
2582,삼달교차로,33.36868,126.86825,1308,90,1398,1285,80,1365,제주특별자치도 서귀포시 성산읍 삼달리 20-2
2583,삼달교차로,33.36933,126.86903,905,131,1036,890,125,1015,제주특별자치도 서귀포시 성산읍 삼달리 2262
2584,희진주유소,33.37661,126.87364,548,49,597,516,49,565,제주특별자치도 서귀포시 성산읍 신산리 1155-2
2585,희진주유소,33.37757,126.87404,824,76,900,809,74,883,제주특별자치도 서귀포시 성산읍 신산리 1085-20
2586,신산환승정류장(성산농협신산지점),33.37993,126.87569,2753,148,2901,2721,143,2864,제주특별자치도 서귀포시 성산읍 신산리 1085-20
2587,신산환승정류장(성산농협신산지점),33.380340000000004,126.87618,3290,337,3627,3229,319,3548,제주특별자치도 서귀포시 성산읍 신산리 1100-16
2588,신산리,33.38233,126.87695,762,36,798,752,34,786,제주특별자치도 서귀포시 성산읍 신산리 1026-2
2589,신산리,33.383309999999994,126.87767,1544,34,1578,1531,31,1562,제주특별자치도 서귀포시 성산읍 신산리 611-2
2590,난산입구,33.38583,126.88054,363,18,381,360,16,376,제주특별자치도 서귀포시 성산읍 신산리 658-1
2591,난산입구(성산기상대),33.38602,126.88173,345,14,359,338,14,352,제주특별자치도 서귀포시 성산읍 신산리 680-9
2592,화성농장,33.39124,126.88933,61,50,111,59,49,108,제주특별자치도 서귀포시 성산읍 신산리 1978
2593,화성농장,33.39197,126.88953,82,6,88,82,6,88,제주특별자치도 서귀포시 성산읍 신산리 137-1
2594,온평리,33.40226,126.89555,209,22,231,205,20,225,제주특별자치도 서귀포시 성산읍 온평리 1407-8
2595,온평리,33.40432,126.89656,531,95,626,516,90,606,제주특별자치도 서귀포시 성산읍 온평리 2822
2596,온평초등학교,33.4066,126.89692,834,69,903,821,65,886,제주특별자치도 서귀포시 성산읍 온평리 2822
2597,온평초등학교,33.40828,126.89775,2305,292,2597,2260,277,2537,제주특별자치도 서귀포시 성산읍 온평리 1563-1
2598,혼인지입구,33.41102,126.89882,730,114,844,715,106,821,제주특별자치도 서귀포시 성산읍 온평리 520-6
2599,혼인지입구,33.41122,126.89907,1560,192,1752,1535,184,1719,제주특별자치도 서귀포시 성산읍 온평리 522-4
2600,성산농협종합유통센터,33.42582,126.90687,838,153,991,820,146,966,제주특별자치도 서귀포시 성산읍 고성리 1905-3
2601,성산농협종합유통센터,33.42586,126.90671,140,12,152,137,12,149,제주특별자치도 서귀포시 성산읍 고성리 2747
2602,신양리입구,33.43415,126.90923,931,516,1447,888,479,1367,제주특별자치도 서귀포시 성산읍 고성리 1772-3
2603,신양리입구,33.43565,126.90993,1230,894,2124,1159,842,2001,제주특별자치도 서귀포시 성산읍 고성리 896-4
2604,성산읍사무소,33.44097,126.9111,760,81,841,733,80,813,제주특별자치도 서귀포시 성산읍 고성리 919-2
2605,성산읍사무소,33.44225,126.91203,607,162,769,598,154,752,제주특별자치도 서귀포시 성산읍 고성리 937-5
2606,오조리하동,33.4587,126.91228,114,37,151,112,37,149,제주특별자치도 서귀포시 성산읍 오조리 2210
2607,오조리하동,33.45853,126.91225,40,9,49,39,9,48,제주특별자치도 서귀포시 성산읍 오조리 956-1
2610,고성오일시장,33.4523,126.91413,636,238,874,623,233,856,제주특별자치도 서귀포시 성산읍 고성리 2747
2611,고성오일시장,33.45206,126.91405,68,32,100,68,31,99,제주특별자치도 서귀포시 성산읍 고성리 2747
2612,고성리제주은행,33.449459999999995,126.91505,1258,285,1543,1226,281,1507,제주특별자치도 서귀포시 성산읍 고성리 313-6
2613,고성리구성산농협,33.44798,126.91496,10217,1111,11328,10009,1058,11067,제주특별자치도 서귀포시 성산읍 고성리 322-8
2614,신양리입구,33.4448,126.91354,70,38,108,69,34,103,제주특별자치도 서귀포시 성산읍 고성리 999-4
2615,신양입구,33.44481,126.91339,44,7,51,44,7,51,제주특별자치도 서귀포시 성산읍 고성리 1009-2
2616,성산환승정류장(고성리회전교차로),33.44728,126.91378,8218,3768,11986,7889,3599,11488,제주특별자치도 서귀포시 성산읍 고성리 1099-5
2617,성산환승정류장(고성리한국물류),33.44744,126.91379,25173,6004,31177,24497,5639,30136,제주특별자치도 서귀포시 성산읍 고성리 1099-4
2618,오조리상동입구,33.462,126.91033,114,12,126,113,12,125,제주특별자치도 서귀포시 성산읍 오조리 797-3
2619,오조리상동입구,33.46282,126.91028,127,40,167,125,38,163,제주특별자치도 서귀포시 성산읍 오조리 2210
2620,성산고입구삼거리,33.46503,126.90863,17,17,34,15,17,32,제주특별자치도 서귀포시 성산읍 오조리 1305-4
2621,성산고입구삼거리,33.4657,126.90842,363,77,440,359,69,428,제주특별자치도 서귀포시 성산읍 오조리 2210
2622,성산국민체육센터,33.46885,126.90588,499,95,594,492,91,583,제주특별자치도 서귀포시 성산읍 오조리 446-1
2623,성산국민체육센터,33.468720000000005,126.90579,769,108,877,746,101,847,제주특별자치도 서귀포시 성산읍 오조리 447-2
2624,시흥리,33.47663,126.89632,986,123,1109,954,121,1075,제주특별자치도 서귀포시 성산읍 시흥리 1127-1
2625,시흥리,33.47625,126.89673,720,99,819,704,96,800,제주특별자치도 서귀포시 성산읍 시흥리 2644-11
2626,시흥리사무소,33.4743,126.89845,1205,42,1247,1182,33,1215,제주특별자치도 서귀포시 성산읍 시흥리 653-1
2627,시흥리사무소,33.47335,126.89898,2183,89,2272,2155,82,2237,제주특별자치도 서귀포시 성산읍 시흥리 2644-12
2628,영실입구,33.333040000000004,126.45959,135,29,164,122,25,147,제주특별자치도 서귀포시 중문동 산 1-1
2629,위호텔,33.28502,126.4546,86,23,109,86,23,109,제주특별자치도 서귀포시 대포동 2603
2631,위호텔,33.28508,126.45448,23,11,34,23,11,34,제주특별자치도 서귀포시 대포동 25-1
2632,서귀포천문과학문화관,33.28846,126.45733,76,15,91,76,15,91,제주특별자치도 서귀포시 하원동 1885-4
2633,법정사입구,33.302440000000004,126.45822,26,4,30,25,3,28,제주특별자치도 서귀포시 대포동 산 6-2
2634,거린사슴전망대,33.30763,126.45473,30,8,38,26,7,33,제주특별자치도 서귀포시 대포동 산 2-3
2635,서귀포자연휴양림,33.31201,126.45751,668,211,879,628,192,820,제주특별자치도 서귀포시 대포동 산 1-7
2636,영실매표소,33.34025,126.48022,2077,1006,3083,1878,941,2819,제주특별자치도 서귀포시 하원동 산 1-1
2637,영실입구,33.33317,126.45951,158,24,182,142,20,162,제주특별자치도 서귀포시 중문동 산 1-1
2638,1100고지휴게소,33.357820000000004,126.46308,294,72,366,278,69,347,제주특별자치도 서귀포시 색달동 산 1-1
2639,올리수,33.32457,126.71366,538,17,555,518,15,533,제주특별자치도 서귀포시 남원읍 수망리 217-2
2640,사리물,33.35065,126.69815,105,26,131,105,25,130,제주특별자치도 서귀포시 남원읍 수망리 산 126-1
2641,수악교,33.33738,126.61097,262,27,289,217,23,240,제주특별자치도 서귀포시 남원읍 신례리 산 2-1
2643,"남원읍충혼묘지,물영아리",33.35954,126.69268,18,7,25,17,3,20,제주특별자치도 서귀포시 남원읍 수망리 산 182-1
2644,사리물,33.35022,126.69859,54,8,62,51,8,59,제주특별자치도 서귀포시 남원읍 수망리 산 126-1
2645,디삘레,33.33122,126.71093,510,18,528,509,16,525,제주특별자치도 서귀포시 남원읍 수망리 1086
2646,수망사거리,33.32808,126.7124,1246,46,1292,1230,45,1275,제주특별자치도 서귀포시 남원읍 수망리 322-1
2647,수망가름,33.32714,126.71314,1224,182,1406,1211,163,1374,제주특별자치도 서귀포시 남원읍 수망리 244
2648,올리수,33.3245,126.71396,173,11,184,171,11,182,제주특별자치도 서귀포시 남원읍 수망리 217-5
2649,돈물교,33.31478,126.71425,312,2,314,308,2,310,제주특별자치도 서귀포시 남원읍 의귀리 2008
2650,의귀교회앞,33.31235,126.71387,628,3,631,623,3,626,제주특별자치도 서귀포시 남원읍 의귀리 2008
2651,의귀환승정류장(의귀초등학교),33.31082,126.71495,2824,240,3064,2770,208,2978,제주특별자치도 서귀포시 남원읍 의귀리 1485-3
2652,산하동,33.305640000000004,126.7191,126,8,134,123,7,130,제주특별자치도 서귀포시 남원읍 의귀리 893-5
2654,농협하나로마트,33.28408,126.72072,679,13,692,669,13,682,제주특별자치도 서귀포시 남원읍 남원리 225-12
2655,남원1리사무소,33.27793,126.71463,5068,91,5159,5040,90,5130,제주특별자치도 서귀포시 남원읍 남원리 1345-8
2656,광지동,33.27643,126.70932,2666,305,2971,2622,291,2913,제주특별자치도 서귀포시 남원읍 남원리 1419-2
2657,남원생활체육관,33.2755,126.7059,1356,423,1779,1273,362,1635,제주특별자치도 서귀포시 남원읍 남원리 2377-1
2658,동부보건소,33.27511,126.70271,2915,232,3147,2851,212,3063,제주특별자치도 서귀포시 남원읍 남원리 2368-2
2659,남원생활체육관,33.27572,126.70634,752,76,828,725,74,799,제주특별자치도 서귀포시 남원읍 남원리 1451-2
2660,광지동,33.27641,126.70868,3074,140,3214,3015,134,3149,제주특별자치도 서귀포시 남원읍 남원리 1447-3
2661,남원1리사무소,33.27793,126.71403,7530,78,7608,7439,74,7513,제주특별자치도 서귀포시 남원읍 남원리 1339-2
2662,농협하나로마트,33.28408,126.7206,50,8,58,49,3,52,제주특별자치도 서귀포시 남원읍 남원리 225-2
2663,의귀산하동,33.29888,126.72084,189,6,195,186,5,191,제주특별자치도 서귀포시 남원읍 의귀리 1032-5
2664,산하동,33.30467,126.71895,445,1,446,445,1,446,제주특별자치도 서귀포시 남원읍 의귀리 932-9
2665,의귀환승정류장(의귀초등학교),33.31067,126.71483,3512,37,3549,3420,36,3456,제주특별자치도 서귀포시 남원읍 의귀리 1484-3
2666,의귀교회앞,33.31243,126.71355,436,1,437,434,1,435,제주특별자치도 서귀포시 남원읍 의귀리 1523-3
2667,돈물교,33.31469,126.71402,446,3,449,446,3,449,제주특별자치도 서귀포시 남원읍 의귀리 1585-1
2668,디삘레,33.33093,126.71119,301,7,308,301,7,308,제주특별자치도 서귀포시 남원읍 수망리 1086
2669,"남원읍충혼묘지,물영아리",33.36084,126.69166,111,18,129,109,18,127,제주특별자치도 서귀포시 남원읍 수망리 산 182
2670,태흥목장,33.3798,126.68486,45,7,52,41,7,48,제주특별자치도 서귀포시 표선면 가시리 산 133
2673,수악교,33.33469,126.61037,664,51,715,645,50,695,제주특별자치도 서귀포시 남원읍 신례리 산 2-36
2674,성판악,33.38463,126.62035,1969,1177,3146,1786,1112,2898,제주특별자치도 서귀포시 남원읍 신례리 산 2-13
2675,온평초등학교,33.40745,126.897,37,1,38,36,1,37,제주특별자치도 서귀포시 성산읍 온평리 1577-6
2678,토산보건진료소,33.32648,126.76751000000002,411,3,414,410,3,413,제주특별자치도 서귀포시 표선면 토산리 1360-3
2679,수산초등학교,33.44635,126.88616,634,270,904,598,247,845,제주특별자치도 서귀포시 성산읍 수산리 4764
2682,수산2리,33.43975,126.86513,488,143,631,468,131,599,제주특별자치도 서귀포시 성산읍 수산리 2412-1
2685,신양리,33.43581,126.91632,28,22,50,27,21,48,제주특별자치도 서귀포시 성산읍 고성리 507-14
2686,신양리,33.435590000000005,126.91621,440,176,616,425,175,600,제주특별자치도 서귀포시 성산읍 고성리 580-1
2691,삼달1리,33.37427,126.8433,86,7,93,86,7,93,제주특별자치도 서귀포시 성산읍 삼달리 1152-4
2692,감산입구,33.26085,126.3622,284,16,300,284,16,300,제주특별자치도 서귀포시 안덕면 창천리 342-1
2693,감산입구,33.26063,126.36214,296,20,316,295,19,314,제주특별자치도 서귀포시 안덕면 감산리 142-4
2694,동홍사거리,33.25472,126.56838,9973,155,10128,9829,149,9978,제주특별자치도 서귀포시 동홍동 462-3
2695,동홍사거리,33.2545,126.56831,5912,79,5991,5828,74,5902,제주특별자치도 서귀포시 동홍동 462-3
2696,(구)중앙파출소,33.24751,126.56089,116,12,128,114,10,124,제주특별자치도 서귀포시 서귀동 341
2697,대포항,33.239740000000005,126.43773,231,258,489,231,258,489,제주특별자치도 서귀포시 대포동 2072-2
2698,대포항,33.23987,126.43767,245,347,592,245,347,592,제주특별자치도 서귀포시 대포동 2072-2
2699,약천사,33.24289,126.45084,539,214,753,521,198,719,제주특별자치도 서귀포시 하원동 1878-4
2700,약천사,33.243,126.45034,735,590,1325,698,569,1267,제주특별자치도 서귀포시 하원동 1662-4
2703,광치기해변,33.45143,126.92337,1312,1091,2403,1228,1042,2270,제주특별자치도 서귀포시 성산읍 고성리 224-33
2704,광치기해변,33.4523,126.92366,921,542,1463,880,532,1412,제주특별자치도 서귀포시 성산읍 고성리 224-40
2706,수산2리입구,33.43883,126.87389,462,20,482,458,20,478,제주특별자치도 서귀포시 성산읍 수산리 1668-4
2707,수산2리입구,33.4389,126.87385,281,9,290,277,9,286,제주특별자치도 서귀포시 성산읍 수산리 1668-1
2708,일출랜드입구,33.38074,126.84507,40,46,86,36,45,81,제주특별자치도 서귀포시 성산읍 삼달리 807-2
2709,일출랜드입구,33.38077,126.84492,73,20,93,66,20,86,제주특별자치도 서귀포시 성산읍 삼달리 1059-9
2710,사농동산,33.34422,126.70319,250,5,255,248,5,253,제주특별자치도 서귀포시 남원읍 수망리 산 91-2
2711,사농동산,33.34279,126.70398,61,5,66,61,5,66,제주특별자치도 서귀포시 남원읍 수망리 산 89-1
2712,트릭아트뮤지엄,33.39946,126.78723,421,192,613,407,183,590,제주특별자치도 서귀포시 표선면 성읍리 2375-5
2714,문화마을,33.39302,126.7979,1383,216,1599,1330,210,1540,제주특별자치도 서귀포시 표선면 성읍리 1609
2715,문화마을,33.39298,126.79821,1413,86,1499,1396,83,1479,제주특별자치도 서귀포시 표선면 성읍리 1636-2
2716,표선허브동산,33.33056,126.81652,171,59,230,165,56,221,제주특별자치도 서귀포시 표선면 표선리 2632-2
2717,선인장마을,33.39499,126.85942,7,1,8,6,1,7,제주특별자치도 서귀포시 성산읍 난산리 1961-14
2718,붉은오름,33.3946,126.68534,1013,461,1474,954,423,1377,제주특별자치도 서귀포시 표선면 가시리 산 158-1
2719,붉은오름,33.39522,126.68525,2501,944,3445,2319,907,3226,제주특별자치도 서귀포시 표선면 가시리 산 158-5
2720,표선허브동산,33.3307,126.81598,162,45,207,157,45,202,제주특별자치도 서귀포시 표선면 표선리 2632-3
2721,탄산온천,33.25045,126.29808,1629,718,2347,1560,682,2242,제주특별자치도 서귀포시 안덕면 사계리 1030-1
2722,화순문화마을,33.25251,126.33019,643,30,673,639,29,668,제주특별자치도 서귀포시 안덕면 화순리 1202-2
2723,안덕면사무소,33.25731,126.33003,713,76,789,705,73,778,제주특별자치도 서귀포시 안덕면 화순리 2029
2724,안덕면사무소,33.25772,126.32967,299,16,315,295,16,311,제주특별자치도 서귀포시 안덕면 화순리 2026-34
2725,화순문화마을,33.2527,126.33002,187,10,197,187,9,196,제주특별자치도 서귀포시 안덕면 화순리 1202-7
2726,산방산,33.23625,126.31142,12,11,23,12,11,23,제주특별자치도 서귀포시 안덕면 사계리 157-5
2729,돈내코마을,33.3029,126.57366,3,1,4,3,1,4,제주특별자치도 서귀포시 상효동 2245
2730,충혼묘지광장,33.30751,126.57037,722,213,935,683,188,871,제주특별자치도 서귀포시 상효동 2190
2732,하례2리입구,33.30061,126.60209,1406,195,1601,1388,188,1576,제주특별자치도 서귀포시 남원읍 하례리 1869-1
2733,오설록,33.30507,126.28946,42,17,59,41,14,55,제주특별자치도 서귀포시 안덕면 서광리 1224-44
2734,오설록,33.30513,126.28913,508,547,1055,487,524,1011,제주특별자치도 서귀포시 안덕면 서광리 1224-58
2735,대정초등학교,33.22478,126.25639,1175,80,1255,1161,78,1239,제주특별자치도 서귀포시 대정읍 상모리 3871-1
2737,토요시장입구,33.22129,126.25192,589,119,708,584,119,703,제주특별자치도 서귀포시 대정읍 하모리 943-5
2738,하모체육공원,33.21845,126.25209,129,31,160,125,26,151,제주특별자치도 서귀포시 대정읍 하모리 2126-5
2739,구억리옹기체험관,33.27407,126.27868,1450,385,1835,1407,364,1771,제주특별자치도 서귀포시 대정읍 구억리 979
2740,하모체육공원,33.21875,126.25229,39,20,59,36,15,51,제주특별자치도 서귀포시 대정읍 하모리 2148
2741,NLCS제주,33.296620000000004,126.28563,872,202,1074,862,188,1050,제주특별자치도 서귀포시 대정읍 구억리 1066
2742,NLCS제주,33.296440000000004,126.28516,329,8,337,324,8,332,제주특별자치도 서귀포시 대정읍 구억리 1110
2743,동광환승정류장2(영어교육도시방면),33.310340000000004,126.33936,9580,3490,13070,9426,3322,12748,제주특별자치도 서귀포시 안덕면 동광리 942-3
2744,차남동산,33.45255,126.83808,6,5,11,6,5,11,제주특별자치도 서귀포시 성산읍 수산리 4200-1
2745,차남동산,33.45263,126.83825,200,32,232,199,30,229,제주특별자치도 서귀포시 성산읍 수산리 4200-1
2746,서귀포등기소,33.25314,126.56015,35570,4299,39869,34957,4153,39110,제주특별자치도 서귀포시 서홍동 441-39
2747,비안동,33.28211,126.72055,59,5,64,59,2,61,제주특별자치도 서귀포시 남원읍 남원리 214-22
2748,비안동,33.281209999999994,126.72096,181,25,206,180,25,205,제주특별자치도 서귀포시 남원읍 남원리 211-2
2749,남원중학교,33.280640000000005,126.71764,675,5,680,673,5,678,제주특별자치도 서귀포시 남원읍 남원리 2490-115
2751,남원포구입구,33.27887,126.71773,10277,240,10517,10060,229,10289,제주특별자치도 서귀포시 남원읍 남원리 116-6
2752,남원포구입구,33.27871,126.71777,11905,274,12179,11739,264,12003,제주특별자치도 서귀포시 남원읍 남원리 119-7
2754,풍력생태길입구,33.433170000000004,126.82412,7,16,23,7,16,23,제주특별자치도 서귀포시 성산읍 수산리 4711-4
2755,모슬포항,33.21754,126.2524,765,107,872,731,100,831,제주특별자치도 서귀포시 대정읍 하모리 2148
2756,대포포구,33.23888,126.43565,771,405,1176,712,385,1097,제주특별자치도 서귀포시 대포동 2415
2757,대포포구,33.23879,126.43575,388,284,672,377,270,647,제주특별자치도 서귀포시 대포동 2415
2760,농기구수리센터,33.329840000000004,126.82171,46,9,55,46,9,55,제주특별자치도 서귀포시 표선면 표선리 2050-4
2761,농기구수리센터,33.329809999999995,126.82152,67,25,92,65,25,90,제주특별자치도 서귀포시 표선면 표선리 2954
2765,주공34단지,33.25115,126.5729,13432,100,13532,13297,93,13390,제주특별자치도 서귀포시 동홍동 145-4
2767,LH12단지,33.25002,126.52263,465,80,545,465,80,545,제주특별자치도 서귀포시 서호동 1534
2768,LH12단지,33.24983,126.52315,6042,68,6110,5888,66,5954,제주특별자치도 서귀포시 서호동 1577
2771,"테디밸리골프앤리조트,헬로키티아일랜드",33.2919,126.3512,713,340,1053,656,298,954,제주특별자치도 서귀포시 안덕면 상창리 2014
2772,산방복지회관,33.233290000000004,126.30192,1350,176,1526,1321,170,1491,제주특별자치도 서귀포시 안덕면 사계리 1839-1
2773,산방복지회관,33.2332,126.30225,334,22,356,328,21,349,제주특별자치도 서귀포시 안덕면 사계리 1841-2
2774,성박물관,33.25548,126.34533,745,358,1103,721,342,1063,제주특별자치도 서귀포시 안덕면 감산리 1736
2775,성박물관,33.25547,126.34407,243,99,342,236,98,334,제주특별자치도 서귀포시 안덕면 화순리 118-4
2778,"테디밸리골프앤리조트,헬로키티아일랜드",33.29178,126.35151,1162,380,1542,1096,337,1433,제주특별자치도 서귀포시 안덕면 상창리 2888
2779,표선도서관,33.32491,126.83859,17,2,19,17,2,19,제주특별자치도 서귀포시 표선면 표선리 40-8
2780,표선도서관,33.32547,126.83874,1423,67,1490,1380,67,1447,제주특별자치도 서귀포시 표선면 표선리 44-4
2781,달산봉입구,33.34257,126.82662,168,14,182,153,13,166,제주특별자치도 서귀포시 표선면 하천리 1100-3
2782,달산봉입구,33.343779999999995,126.82656,261,13,274,259,13,272,제주특별자치도 서귀포시 표선면 하천리 1118-1
2783,세성로입구,33.37863,126.802,63,2,65,63,2,65,제주특별자치도 서귀포시 표선면 성읍리 1096-1
2784,세성로입구,33.378659999999996,126.80211,362,20,382,358,20,378,제주특별자치도 서귀포시 표선면 성읍리 3294
2785,진우파크빌,33.44613,126.90501,630,24,654,619,23,642,제주특별자치도 서귀포시 성산읍 고성리 1588-3
2786,진우파크빌,33.44607,126.90562,327,44,371,321,41,362,제주특별자치도 서귀포시 성산읍 고성리 1528-5
2788,수산1리사거리,33.44242,126.88377,592,22,614,590,22,612,제주특별자치도 서귀포시 성산읍 수산리 734-2
2789,수산1리사거리,33.44225,126.88403999999998,296,9,305,295,9,304,제주특별자치도 서귀포시 성산읍 수산리 796-18
2792,제주민속촌,33.32547,126.84103,8050,2043,10093,7700,1845,9545,제주특별자치도 서귀포시 표선면 표선리 44-7
2793,고성리성산농협,33.44611,126.91261000000002,3559,496,4055,3501,483,3984,제주특별자치도 서귀포시 성산읍 고성리 1093-13
2794,농협하나로마트,33.44623,126.91282,507,203,710,483,193,676,제주특별자치도 서귀포시 성산읍 고성리 2747
2796,탄산온천,33.25058,126.29749,1268,302,1570,1233,292,1525,제주특별자치도 서귀포시 안덕면 덕수리 3004
2797,혼착밭,33.23935,126.47111,33,2,35,31,2,33,제주특별자치도 서귀포시 강정동 5508
2798,혼착밭,33.23922,126.47097,114,11,125,113,10,123,제주특별자치도 서귀포시 강정동 5508-1
2799,수산1리비석거리,33.44357,126.889,1395,227,1622,1377,225,1602,제주특별자치도 서귀포시 성산읍 수산리 271-2
2800,수산1리비석거리,33.44338,126.88894,887,320,1207,877,314,1191,제주특별자치도 서귀포시 성산읍 수산리 246-11
2801,수산2리생태체험센터,33.43925,126.86307,339,50,389,338,49,387,제주특별자치도 서귀포시 성산읍 수산리 4764
2802,수산2리생태체험센터,33.439170000000004,126.86315,418,10,428,409,10,419,제주특별자치도 서귀포시 성산읍 수산리 4764
2804,미타요양원,33.44658,126.85212,63,6,69,62,6,68,제주특별자치도 서귀포시 성산읍 수산리 3069-2
2806,돔뱅이왓,33.235,126.3695,1090,134,1224,1064,127,1191,제주특별자치도 서귀포시 하예동 1810-1
2807,관광단지입구,33.25621,126.41473,19,9,28,19,9,28,제주특별자치도 서귀포시 색달동 2511-3
2808,관광단지입구,33.25639,126.41461,124,35,159,122,33,155,제주특별자치도 서귀포시 색달동 2511-4
2809,색달마을입구,33.26031,126.41348,619,30,649,595,29,624,제주특별자치도 서귀포시 색달동 2233-1
2810,색달마을입구,33.2604,126.41359,27,9,36,27,9,36,제주특별자치도 서귀포시 색달동 1926-7
2811,성산농협,33.447070000000004,126.91104,2191,160,2351,2145,155,2300,제주특별자치도 서귀포시 성산읍 고성리 1063-5
2812,성산농협,33.446909999999995,126.91127,136,35,171,135,33,168,제주특별자치도 서귀포시 성산읍 고성리 2747
2813,송악도서관,33.22573,126.24824,461,26,487,459,25,484,제주특별자치도 서귀포시 대정읍 하모리 1235-5
2814,동백동산,33.28935,126.36739,454,602,1056,421,579,1000,제주특별자치도 서귀포시 안덕면 상창리 999
2816,블랭섬홀아시아,33.29189,126.2848,2851,610,3461,2758,561,3319,제주특별자치도 서귀포시 대정읍 구억리 1117
2817,블랭섬홀아시아,33.29115,126.28391,769,37,806,759,36,795,제주특별자치도 서귀포시 대정읍 보성리 2373
2818,한국국제학교,33.28725,126.28173,1542,60,1602,1508,55,1563,제주특별자치도 서귀포시 대정읍 보성리 2417
2819,한국국제학교,33.28755,126.28241,4253,868,5121,4117,786,4903,제주특별자치도 서귀포시 대정읍 구억리 1132
2820,삼정지에듀,33.28481,126.2785,3951,871,4822,3830,800,4630,제주특별자치도 서귀포시 대정읍 보성리 2432
2821,삼정지에듀,33.2849,126.27766,832,109,941,804,106,910,제주특별자치도 서귀포시 대정읍 보성리 2424
2825,중문관광단지여미지식물원입구,33.2517,126.41264,2048,1870,3918,2048,1870,3918,제주특별자치도 서귀포시 색달동 2822-1
2830,진군을리,33.283640000000005,126.36423,1,12,13,1,12,13,제주특별자치도 서귀포시 안덕면 상창리 899-3
2831,진군을리,33.28382,126.36412,42,67,109,35,65,100,제주특별자치도 서귀포시 안덕면 상창리 897-1
2833,방아동,33.2798,126.17494,29,1,30,29,1,30,제주특별자치도 서귀포시 대정읍 신도리 2633-8
2834,남원취락구조,33.27496,126.70031000000002,377,64,441,359,61,420,제주특별자치도 서귀포시 남원읍 남원리 2446
2835,남원취락구조,33.27515,126.7002,399,41,440,384,39,423,제주특별자치도 서귀포시 남원읍 남원리 2447-3
2836,주공6단지,33.26269,126.55905,2659,20,2679,2627,19,2646,제주특별자치도 서귀포시 동홍동 1577-5
2837,이교동삼거리,33.22619,126.27201,156,3,159,148,3,151,제주특별자치도 서귀포시 대정읍 상모리 2151-5
2838,이교동삼거리,33.226240000000004,126.27115,1249,46,1295,1231,42,1273,제주특별자치도 서귀포시 대정읍 상모리 2659-3
2839,산지물,33.265370000000004,126.5647,637,15,652,603,13,616,제주특별자치도 서귀포시 동홍동 1701-3
2840,산지물,33.26518,126.56463,155,2,157,153,2,155,제주특별자치도 서귀포시 동홍동 1702-1
2842,제주오설록티뮤지엄,33.30522,126.28801,913,949,1862,856,917,1773,제주특별자치도 서귀포시 안덕면 서광리 산 50-13
2843,중문관광단지여미지식물원입구,33.252140000000004,126.41268,168,312,480,168,312,480,제주특별자치도 서귀포시 색달동 2822-1
2844,제주월드컵경기장(600번),33.249340000000004,126.50903999999998,2496,1190,3686,2496,1190,3686,제주특별자치도 서귀포시 법환동 760
2845,동홍초등학교입구,33.25888,126.56848,640,1,641,630,1,631,제주특별자치도 서귀포시 동홍동 588-6
2846,굿밭거리,33.257459999999995,126.52505,526,16,542,520,16,536,제주특별자치도 서귀포시 호근동 1841-1
2847,굿밭거리,33.25736,126.52496,1643,29,1672,1633,29,1662,제주특별자치도 서귀포시 호근동 1841-1
2848,서귀포보건소,33.25212,126.55465,2839,48,2887,2789,48,2837,제주특별자치도 서귀포시 서귀동 973
2849,남양맨션,33.25592,126.5679,819,4,823,816,4,820,제주특별자치도 서귀포시 동홍동 518-5
2850,남양맨션,33.25584,126.56808,793,2,795,789,2,791,제주특별자치도 서귀포시 동홍동 515
2851,제주월드컵경기장(600번),33.249109999999995,126.50907,425,276,701,425,276,701,제주특별자치도 서귀포시 법환동 816-9
2852,제주해안경비단,33.35691,126.82304,748,24,772,739,23,762,제주특별자치도 서귀포시 표선면 하천리 1493-4
2854,사거리,33.24475,126.43218,1809,18,1827,1784,18,1802,제주특별자치도 서귀포시 대포동 2606
2855,사거리,33.24497,126.43207,462,17,479,451,17,468,제주특별자치도 서귀포시 대포동 1672
2856,소보리당,33.26432,126.38418,596,106,702,575,104,679,제주특별자치도 서귀포시 상예동 4999
2857,상원동,33.275209999999994,126.66335,3802,72,3874,3723,71,3794,제주특별자치도 서귀포시 남원읍 위미리 1902-2
2858,원물오름,33.3186,126.34651,201,99,300,196,98,294,제주특별자치도 서귀포시 안덕면 동광리 386
2859,원물오름,33.318290000000005,126.34655,95,4,99,92,4,96,제주특별자치도 서귀포시 안덕면 동광리 377-1
2864,난산리노인복지회관,33.40098,126.87403,342,3,345,338,3,341,제주특별자치도 서귀포시 성산읍 난산리 301-3
2865,한남교,33.31258,126.69629,83,4,87,82,4,86,제주특별자치도 서귀포시 남원읍 한남리 270-3
2866,한남교,33.31257,126.69675,191,4,195,189,4,193,제주특별자치도 서귀포시 남원읍 한남리 1656
2867,화순리생태탐방로,33.26418,126.33355,16,1,17,16,1,17,제주특별자치도 서귀포시 안덕면 화순리 2045-4
2868,화순리생태탐방로,33.26507,126.3335,98,14,112,97,14,111,제주특별자치도 서귀포시 안덕면 화순리 2046
2869,서광리넙게오름(축협),33.29019,126.31806,89,11,100,88,11,99,제주특별자치도 서귀포시 안덕면 서광리 980-5
2870,서광리넙게오름(축협),33.290040000000005,126.3182,187,24,211,184,22,206,제주특별자치도 서귀포시 안덕면 서광리 985-3
2871,남원2리복지회관,33.29323,126.71003,175,1,176,175,1,176,제주특별자치도 서귀포시 남원읍 남원리 1015-7
2873,제주공천포전지훈련센터,33.27528,126.63896,165,11,176,159,9,168,제주특별자치도 서귀포시 남원읍 신례리 364-1
2875,송악펜션단지,33.21201,126.29237,54,92,146,53,91,144,제주특별자치도 서귀포시 대정읍 상모리 87-27
2876,송악펜션단지,33.21229,126.29235,61,21,82,61,20,81,제주특별자치도 서귀포시 대정읍 상모리 73-1
2877,산이수동,33.20835,126.29012,312,268,580,305,257,562,제주특별자치도 서귀포시 대정읍 상모리 132
2878,섭지코지,33.43665,126.922,208,163,371,195,156,351,제주특별자치도 서귀포시 성산읍 고성리 203-6
2879,섭지코지,33.43687,126.9224,975,752,1727,919,712,1631,제주특별자치도 서귀포시 성산읍 고성리 186-5
2880,동모루왓,33.43902,126.91925,207,118,325,197,116,313,제주특별자치도 서귀포시 성산읍 고성리 489-1
2881,동모루왓,33.4389,126.91983,55,17,72,54,16,70,제주특별자치도 서귀포시 성산읍 고성리 537-1
2882,서건도,33.23605,126.50425,460,370,830,458,370,828,제주특별자치도 서귀포시 강정동 579-1
2883,서건도,33.23595,126.50491,30,37,67,30,37,67,제주특별자치도 서귀포시 강정동 609-2
2884,월평마을,33.24282,126.46083,1114,175,1289,1098,173,1271,제주특별자치도 서귀포시 월평동 510-5
2885,월평마을,33.24273,126.46096,2143,177,2320,2118,174,2292,제주특별자치도 서귀포시 월평동 510-3
2886,보성리하동,33.25068,126.27456,186,7,193,178,7,185,제주특별자치도 서귀포시 대정읍 보성리 2138
2887,보성리상동,33.2508,126.27433,53,3,56,53,3,56,제주특별자치도 서귀포시 대정읍 보성리 1591-9
2888,비석거리,33.25473,126.57586,2564,129,2693,2525,125,2650,제주특별자치도 서귀포시 동홍동 657-4
2891,교래리보건소,33.43665,126.67669,637,283,920,588,266,854,제주특별자치도 제주시 조천읍 교래리 483-1
2892,함덕리(4구),33.54011,126.67474,2561,704,3265,2482,678,3160,제주특별자치도 제주시 조천읍 함덕리 4170
2893,삼화지구,33.51723,126.58124,5474,17,5491,5391,17,5408,제주특별자치도 제주시 도련일동 2002
2894,삼화지구,33.51743,126.57886,15485,90,15575,15301,90,15391,제주특별자치도 제주시 삼양이동 2338
2895,오름중학교,33.517109999999995,126.58563,1124,6,1130,1105,5,1110,제주특별자치도 제주시 도련일동 1895-1
2896,오름중학교,33.51729,126.58582,11445,52,11497,11353,51,11404,제주특별자치도 제주시 삼양이동 2338
2897,삼화부영1차아파트,33.51696,126.58757,4258,26,4284,4207,25,4232,제주특별자치도 제주시 도련이동 552
2898,도련초등학교,33.51421,126.58301000000002,5428,15,5443,5365,14,5379,제주특별자치도 제주시 도련일동 1994-5
2899,삼화초등학교,33.51419,126.57673,3765,20,3785,3718,20,3738,제주특별자치도 제주시 화북이동 120
2900,수산저수지입구,33.4732,126.39014,324,14,338,324,13,337,제주특별자치도 제주시 애월읍 수산리 785-1
2901,수산저수지입구,33.47313,126.39055,101,7,108,100,7,107,제주특별자치도 제주시 애월읍 수산리 785-8
2902,수산교차로,33.471140000000005,126.39579,475,17,492,471,17,488,제주특별자치도 제주시 애월읍 하귀2리 2221
2903,수산교차로,33.4714,126.39443,144,15,159,144,14,158,제주특별자치도 제주시 애월읍 수산리 559-3
2904,신산머루,33.45006,126.43747,1284,13,1297,1252,11,1263,제주특별자치도 제주시 애월읍 광령리 959
2905,신산머루,33.44981,126.43758,399,6,405,384,4,388,제주특별자치도 제주시 애월읍 광령리 909
2908,자운당사거리,33.46667,126.35762,116,7,123,116,7,123,제주특별자치도 제주시 애월읍 하가리 297-3
2909,자운당사거리,33.466640000000005,126.35776,83,3,86,83,3,86,제주특별자치도 제주시 애월읍 하가리 297-7
2910,어음2리,33.40247,126.33843,391,2,393,391,2,393,제주특별자치도 제주시 애월읍 어음리 2962-1
2911,명리동알동네,33.31691,126.26816,42,4,46,29,4,33,제주특별자치도 제주시 한경면 저지리 3168
2912,명리동알동네,33.31678,126.26825,24,8,32,23,7,30,제주특별자치도 제주시 한경면 저지리 3166-2
2913,평화박물관입구,33.30466,126.25858999999998,50,15,65,50,13,63,제주특별자치도 제주시 한경면 청수리 147-2
2915,테왓동네,33.319,126.24317,134,3,137,134,3,137,제주특별자치도 제주시 한경면 청수리 2303-3
2916,테왓동네,33.319,126.24297,59,1,60,59,1,60,제주특별자치도 제주시 한경면 청수리 2263-6
2917,서부신협유통영농조합,33.33546,126.26125,560,10,570,559,10,569,제주특별자치도 제주시 한경면 저지리 2725-3
2918,못거리,33.39258,126.27786,17,5,22,17,5,22,제주특별자치도 제주시 한림읍 동명리 380-2
2922,목다운목,33.520140000000005,126.68844,11,1,12,10,1,11,제주특별자치도 제주시 조천읍 선흘리 3620-2
2923,목다운목,33.52017,126.68866,65,6,71,62,4,66,제주특별자치도 제주시 조천읍 선흘리 3459-3
2926,농굴왓입구,33.50806,126.82654,8,3,11,8,3,11,제주특별자치도 제주시 구좌읍 평대리 2541
2927,농굴왓입구,33.50808,126.82616000000002,18,1,19,17,1,18,제주특별자치도 제주시 구좌읍 평대리 2544-5
2933,벌탬못,33.50768,126.77183,2,3,5,2,3,5,제주특별자치도 제주시 구좌읍 덕천리 321
2934,뒷산길,33.49275,126.65061,5,3,8,5,3,8,제주특별자치도 제주시 조천읍 대흘리 2628-1
2936,앞밭가름,33.44273,126.40166,263,5,268,263,5,268,제주특별자치도 제주시 애월읍 유수암리 1928-9
2937,앞밭가름,33.44283,126.40166,634,24,658,627,24,651,제주특별자치도 제주시 애월읍 유수암리 2033-1
2939,막거리,33.42743,126.4014,75,2,77,75,2,77,제주특별자치도 제주시 애월읍 유수암리 1521
2940,평화동회관,33.30704,126.25355,16,5,21,15,5,20,제주특별자치도 제주시 한경면 청수리 3389
2945,신안동,33.515,126.63504,32,5,37,32,5,37,제주특별자치도 제주시 조천읍 신촌리 308
2946,상하수도본부,33.499140000000004,126.64996,13,8,21,13,8,21,제주특별자치도 제주시 조천읍 대흘리 2651-1
2948,한흘마을입구,33.49565,126.66202,18,2,20,16,1,17,제주특별자치도 제주시 조천읍 대흘리 1568-1
2949,한흘마을입구,33.495740000000005,126.66211,100,1,101,99,1,100,제주특별자치도 제주시 조천읍 대흘리 1038-3
2950,와산리경로당,33.49276,126.68148,225,110,335,215,106,321,제주특별자치도 제주시 조천읍 와산리 903-3
2951,와산리경로당,33.49287,126.68109,268,107,375,249,105,354,제주특별자치도 제주시 조천읍 와산리 909
2952,금산,33.49532,126.68012,93,25,118,92,24,116,제주특별자치도 제주시 조천읍 와산리 1707
2953,금산,33.495059999999995,126.67997,163,10,173,161,10,171,제주특별자치도 제주시 조천읍 와산리 872-1
2954,틀라목,33.50076,126.67753,173,13,186,165,13,178,제주특별자치도 제주시 조천읍 대흘리 197-1
2955,틀라목,33.50097,126.67696,123,2,125,123,2,125,제주특별자치도 제주시 조천읍 대흘리 198-7
2956,원노형,33.48617,126.48319,3967,275,4242,3881,258,4139,제주특별자치도 제주시 노형동 913-7
2957,정든마을3단지,33.49007,126.47129,92,3,95,92,3,95,제주특별자치도 제주시 노형동 2712-1
2958,정든마을3단지,33.48981,126.4713,342,1,343,339,1,340,제주특별자치도 제주시 노형동 2712-1
2959,임항로,33.52071,126.54028,486,51,537,473,49,522,제주특별자치도 제주시 건입동 918-13
2961,소길장밭,33.4425,126.38427,46,2,48,44,2,46,제주특별자치도 제주시 애월읍 장전리 1797
2962,백화동,33.46699,126.71017,7,5,12,7,5,12,제주특별자치도 제주시 조천읍 선흘리 4203
2963,백화동,33.46683,126.71042,13,7,20,13,7,20,제주특별자치도 제주시 조천읍 선흘리 547-1
2964,롯데시티호텔(600번),33.4899,126.48894,145,172,317,145,172,317,제주특별자치도 제주시 연동 260
2965,제주도립미술관,33.45284,126.48787,1153,443,1596,1099,426,1525,제주특별자치도 제주시 연동 680-7
2966,롯데시티호텔(600번),33.49002,126.48856,461,1300,1761,461,1300,1761,제주특별자치도 제주시 연동 260
2967,관음사,33.42642,126.55787,1617,1081,2698,1524,1035,2559,제주특별자치도 제주시 아라일동 387-1
2968,관음사,33.42661,126.55773,24,9,33,23,9,32,제주특별자치도 제주시 아라일동 산 64-4
2969,제주버스터미널(종점),33.49919000000001,126.51632,835,54,889,827,52,879,제주특별자치도 제주시 삼도일동 560-2
2970,제주시외버스터미널(종점),33.49993,126.51414,1638,189,1827,1607,184,1791,제주특별자치도 제주시 오라일동 2455-2
2971,제주한라대학교(종점),33.47779,126.47574,8380,669,9049,8231,647,8878,제주특별자치도 제주시 노형동 1490-2
2972,제주국제공항(종점),33.50571,126.49318999999998,2739,2532,5271,2678,2432,5110,제주특별자치도 제주시 용담이동 1462
2972,제주국제공항(종점),33.505720000000004,126.49329,2739,2532,5271,2678,2432,5110,제주특별자치도 제주시 용담이동 1462
2972,제주국제공항(종점),33.505720000000004,126.49356,2739,2532,5271,2678,2432,5110,제주특별자치도 제주시 용담이동 1462
2973,제주국제공항,33.5045,126.49455,22301,8683,30984,20733,8048,28781,제주특별자치도 제주시 용담이동 1972-2
2975,신안동교차로,33.51912,126.63399,161,6,167,161,6,167,제주특별자치도 제주시 조천읍 조천리 3441
2977,하귀하나로마트,33.48464,126.41138,3379,32,3411,3343,32,3375,제주특별자치도 제주시 애월읍 하귀1리 584
2978,성화마을회관,33.51227,126.50279,525,33,558,511,31,542,제주특별자치도 제주시 용담이동 941-8
2980,용담어린이집,33.51175,126.50532,4204,108,4312,4172,106,4278,제주특별자치도 제주시 용담이동 928-74
2981,용담어린이집,33.51171,126.50548,4878,70,4948,4841,66,4907,제주특별자치도 제주시 용담이동 608-40
2982,화북휴먼시아정문,33.51589,126.57657,4933,30,4963,4860,28,4888,제주특별자치도 제주시 화북일동 1029
2983,삼화초등학교,33.51439,126.57696,4368,43,4411,4307,43,4350,제주특별자치도 제주시 화북일동 1027
2984,도련초등학교,33.51443,126.58328,6410,41,6451,6349,40,6389,제주특별자치도 제주시 도련일동 1895-1
2985,삼화부영1차아파트,33.51717,126.58768,6534,61,6595,6457,60,6517,제주특별자치도 제주시 삼양이동 2336
2986,존손이굴,33.452940000000005,126.35934,87,3,90,86,3,89,제주특별자치도 제주시 애월읍 하가리 556-7
2988,동복리관광체험어장,33.553329999999995,126.71654,24,9,33,23,9,32,제주특별자치도 제주시 구좌읍 동복리 726-1
2989,신흥1번지,33.30573,126.77368,83,14,97,80,14,94,제주특별자치도 서귀포시 남원읍 신흥리 33-4
2990,김영갑갤러리두모악,33.37194,126.85655,4,5,9,4,5,9,제주특별자치도 서귀포시 성산읍 삼달리 256-3
2991,김영갑갤러리두모악,33.37202,126.85684,124,29,153,123,29,152,제주특별자치도 서귀포시 성산읍 삼달리 270-6
2993,바겟도동산,33.33691,126.70822,34,6,40,34,6,40,제주특별자치도 서귀포시 남원읍 수망리 720-1
2994,위미농협하례지소,33.29768,126.60955,629,7,636,627,7,634,제주특별자치도 서귀포시 남원읍 하례리 1367-3
2996,하례2리,33.28933,126.60623,67,1,68,67,1,68,제주특별자치도 서귀포시 남원읍 하례리 1633-3
2998,장애인복지회관,33.28642,126.58431000000002,427,7,434,425,7,432,제주특별자치도 서귀포시 토평동 1940-2
2999,하례2리,33.293009999999995,126.60836,101,5,106,99,5,104,제주특별자치도 서귀포시 남원읍 하례리 1887
3003,가시리체육공원,33.35236,126.77491,109,1,110,109,1,110,제주특별자치도 서귀포시 표선면 가시리 1989-5
3004,논오름,33.27414,126.33348,20,1,21,20,1,21,제주특별자치도 서귀포시 안덕면 덕수리 산 2-4
3005,논오름,33.27432,126.33371,5,5,10,5,5,10,제주특별자치도 서귀포시 안덕면 덕수리 산 2-1
3006,동하동,33.347359999999995,126.77732,122,2,124,121,2,123,제주특별자치도 서귀포시 표선면 가시리 1114-3
3010,삼달1리게이트볼장,33.37625,126.84345,101,13,114,101,12,113,제주특별자치도 서귀포시 성산읍 삼달리 1152-1
3011,삼달1리사무소,33.37436,126.84705,477,8,485,477,6,483,제주특별자치도 서귀포시 성산읍 삼달리 723-1
3012,상천리,33.30731,126.38148,102,46,148,98,45,143,제주특별자치도 서귀포시 안덕면 상천리 470-2
3013,상천리,33.307140000000004,126.38141,308,153,461,303,146,449,제주특별자치도 서귀포시 안덕면 상천리 470-5
3014,서귀포보건소,33.252340000000004,126.55485,2112,39,2151,2082,38,2120,제주특별자치도 서귀포시 서홍동 449-13
3015,성산기상대관사,33.38425,126.86922,16,1,17,16,1,17,제주특별자치도 서귀포시 성산읍 신산리 1363
3019,동문로터리,33.24988,126.56776,174,9,183,172,9,181,제주특별자치도 서귀포시 서귀동 254-17
3020,동문로터리,33.24986,126.56792,1330,10,1340,1308,10,1318,제주특별자치도 서귀포시 서귀동 253-24
3021,서귀포초등학교,33.24316,126.56507,52,12,64,52,11,63,제주특별자치도 서귀포시 서귀동 723-5
3022,석교동,33.31033,126.34951,61,12,73,57,9,66,제주특별자치도 서귀포시 안덕면 동광리 490
3023,석교동,33.31048,126.34918,138,34,172,126,31,157,제주특별자치도 서귀포시 안덕면 동광리 458
3026,비석거리,33.25489,126.57619,8532,477,9009,8399,454,8853,제주특별자치도 서귀포시 동홍동 657-4
3027,사계어촌체험어장,33.22793,126.30442,304,18,322,303,16,319,제주특별자치도 서귀포시 안덕면 사계리 2147-21
3028,사계어촌체험어장,33.227940000000004,126.30476000000002,133,33,166,130,32,162,제주특별자치도 서귀포시 안덕면 사계리 2147-21
3029,사계용해경로당,33.23081,126.30849,86,16,102,86,16,102,제주특별자치도 서귀포시 안덕면 사계리 2029-5
3030,사계용해경로당,33.23123,126.30848,260,13,273,259,13,272,제주특별자치도 서귀포시 안덕면 사계리 2029-3
3031,서귀포칼호텔(종점),33.24701,126.58078,193,416,609,193,416,609,제주특별자치도 서귀포시 토평동 486-3
3032,강다리,33.40578,126.88895,98,7,105,96,6,102,제주특별자치도 서귀포시 성산읍 온평리 2131-3
3035,도린동산,33.35837,126.76827,17,1,18,17,1,18,제주특별자치도 서귀포시 표선면 가시리 2483-2
3037,제3의귀교,33.31235,126.71925,10,3,13,10,3,13,제주특별자치도 서귀포시 남원읍 의귀리 849-1
3038,화순해안경기안전센터사계출장소,33.226009999999995,126.30018,103,15,118,103,12,115,제주특별자치도 서귀포시 안덕면 사계리 2294-41
3040,신흥교,33.313959999999994,126.75096,24,1,25,24,1,25,제주특별자치도 서귀포시 남원읍 신흥리 1378-2
3041,신흥1번지,33.30614,126.77395,87,15,102,86,14,100,제주특별자치도 서귀포시 남원읍 신흥리 2481-8
3042,모슬포항,33.21652,126.25223,11,7,18,11,7,18,제주특별자치도 서귀포시 대정읍 하모리 2133-1
3045,불미터,33.31943,126.71482,190,13,203,189,12,201,제주특별자치도 서귀포시 남원읍 의귀리 1714-8
3046,새서귀초등학교,33.25433,126.51297,841,28,869,709,27,736,제주특별자치도 서귀포시 서호동 1462-4
3048,대포동,33.24301,126.43182,3004,62,3066,2977,56,3033,제주특별자치도 서귀포시 대포동 1597-4
3050,공무원연금공단,33.25437,126.51794,1479,165,1644,1466,158,1624,제주특별자치도 서귀포시 서호동 1583
3051,국세공무원교육원생활관,33.25556,126.51944,415,86,501,406,81,487,제주특별자치도 서귀포시 서호동 1607
3053,서귀포시중앙도서관,33.251870000000004,126.50769,1917,80,1997,1875,78,1953,제주특별자치도 서귀포시 강정동 187
3054,대림아파트,33.25052,126.50557,153,9,162,151,7,158,제주특별자치도 서귀포시 강정동 186-1
3055,하귀농협경제사업장,33.45816,126.42355,245,12,257,232,12,244,제주특별자치도 제주시 애월읍 광령리 3979-2
3056,국세공무원교육원국토교통부인재개발원,33.254490000000004,126.51552,453,61,514,449,61,510,제주특별자치도 서귀포시 서호동 1513
3057,청화마을입구,33.45608,126.43023,578,7,585,572,7,579,제주특별자치도 제주시 애월읍 광령리 3313-2
3058,안덕119센터,33.250609999999995,126.3289,486,33,519,481,32,513,제주특별자치도 서귀포시 안덕면 화순리 1773-2
3059,안덕119센터,33.250029999999995,126.32989,187,29,216,187,27,214,제주특별자치도 서귀포시 안덕면 화순리 1770-3
3061,제주조각공원입구,33.25039,126.322,326,27,353,325,26,351,제주특별자치도 서귀포시 안덕면 사계리 3602-5
3062,서귀포시외버스터미널(가상정류소),33.24985,126.50723,4225,995,5220,4176,980,5156,제주특별자치도 서귀포시 강정동 186-4
3063,이스트소프트,33.44722,126.57148,1,1,2,1,1,2,제주특별자치도 제주시 영평동 2187-1
3064,이스트소프트,33.44756,126.57161,56,3,59,50,3,53,제주특별자치도 제주시 영평동 2273
3065,서광동리웃네거리,33.294290000000004,126.32976,105,21,126,102,21,123,제주특별자치도 서귀포시 안덕면 서광리 475
3066,막동산,33.256240000000005,126.52346,197,4,201,196,4,200,제주특별자치도 서귀포시 서호동 350-3
3067,막동산,33.25647,126.52343,726,24,750,713,23,736,제주특별자치도 서귀포시 호근동 1822-2
3068,국세공무원교육원국토교통부인재개발원,33.254290000000005,126.51553,282,54,336,282,52,334,제주특별자치도 서귀포시 서호동 1583
3069,공무원연금공단,33.25464,126.51773,737,157,894,729,153,882,제주특별자치도 서귀포시 서호동 1583
3070,삼다체육공원입구,33.25158,126.51888999999998,5519,480,5999,5422,478,5900,제주특별자치도 서귀포시 서호동 1608
3071,삼다체육공원입구,33.25159,126.51863,468,19,487,427,18,445,제주특별자치도 서귀포시 서호동 1605
3072,회수마을회관,33.26323,126.44466,3172,224,3396,3165,224,3389,제주특별자치도 서귀포시 회수동 376-7
3073,회수마을회관,33.26308,126.44472,1432,27,1459,1428,27,1455,제주특별자치도 서귀포시 회수동 409-1
3074,법화사사거리,33.26306,126.45946,334,113,447,331,113,444,제주특별자치도 서귀포시 하원동 684-11
3075,법화사사거리,33.26299,126.46136,289,12,301,286,12,298,제주특별자치도 서귀포시 하원동 650-2
3076,새서귀초등학교,33.25416,126.51293,2484,26,2510,2444,23,2467,제주특별자치도 서귀포시 서호동 1478-2
3077,제주월드컵경기장,33.24838,126.50723,2207,186,2393,2165,174,2339,제주특별자치도 서귀포시 강정동 232
3078,제주월드컵경기장서문,33.24647,126.50686,314,14,328,311,14,325,제주특별자치도 서귀포시 법환동 914
3079,제주월드컵경기장서문,33.24522,126.50605,297,20,317,287,19,306,제주특별자치도 서귀포시 법환동 1638
3080,유승한내들아파트,33.25265,126.50453,3820,200,4020,3728,199,3927,제주특별자치도 서귀포시 강정동 209
3081,유승한내들아파트,33.25246,126.50443,3036,750,3786,3021,750,3771,제주특별자치도 서귀포시 강정동 216
3082,중흥/골드클래스아파트,33.25255,126.50203,686,12,698,682,12,694,제주특별자치도 서귀포시 강정동 216
3083,중흥/골드클래스아파트,33.25274,126.50221,6277,32,6309,6068,31,6099,제주특별자치도 서귀포시 강정동 194
3084,대신중학교,33.256190000000004,126.505,668,19,687,652,18,670,제주특별자치도 서귀포시 강정동 213
3085,대신중학교,33.25595,126.50581,4155,34,4189,4027,33,4060,제주특별자치도 서귀포시 강정동 186-1
3086,상창교차로,33.28047,126.35886,35,8,43,35,8,43,제주특별자치도 서귀포시 안덕면 상창리 1222-2
3087,상창교차로,33.28071,126.35917,8,4,12,8,4,12,제주특별자치도 서귀포시 안덕면 상창리 1222-2
3088,해아미,33.4292,126.31847,101,6,107,99,6,105,제주특별자치도 제주시 애월읍 곽지리 417-2
3089,오당빌레,33.45337,126.35249,49,11,60,48,11,59,제주특별자치도 제주시 애월읍 하가리 795-4
3091,수산2리퐁낭거리,33.44103,126.86168,162,1,163,156,1,157,제주특별자치도 서귀포시 성산읍 수산리 2443-1
3093,교래분교,33.436409999999995,126.6794,242,44,286,229,41,270,제주특별자치도 제주시 조천읍 교래리 563
3099,동복리관광체험어장,33.553290000000004,126.7156,1269,622,1891,1216,601,1817,제주특별자치도 제주시 구좌읍 동복리 722-2
3100,이도초등학교,33.48924,126.53275,2841,18,2859,2808,18,2826,제주특별자치도 제주시 이도이동 2034-8
3103,교래분교,33.43635,126.67927,44,14,58,43,14,57,제주특별자치도 제주시 조천읍 교래리 563-1
3104,어대오름,33.501059999999995,126.76082,4,1,5,4,1,5,제주특별자치도 제주시 구좌읍 덕천리 556
3105,어대오름,33.50105,126.761,10,7,17,10,7,17,제주특별자치도 제주시 구좌읍 덕천리 555-1
3106,행원목장,33.51767,126.76983,382,429,811,374,412,786,제주특별자치도 제주시 구좌읍 행원리 산 31
3108,동사라마을,33.46791,126.44902,26,4,30,25,4,29,제주특별자치도 제주시 해안동 2265-1
3109,생각하는정원,33.3263,126.25502,66,85,151,62,79,141,제주특별자치도 제주시 한경면 저지리 1529-4
3110,생각하는정원,33.326,126.25526,435,201,636,419,195,614,제주특별자치도 제주시 한경면 저지리 1529-2
3111,저지리중동,33.3353,126.25704,44,11,55,44,11,55,제주특별자치도 제주시 한경면 저지리 1763-5
3112,제6부두,33.5224,126.54445,1136,134,1270,1091,129,1220,제주특별자치도 제주시 건입동 908-26
3113,우진교차로,33.46088,126.69885,151,2,153,151,2,153,제주특별자치도 제주시 조천읍 선흘리 4070-12
3114,우진교차로,33.46008,126.69919,11,10,21,11,10,21,제주특별자치도 제주시 조천읍 선흘리 산 124-22
3115,국제여객선터미널,33.52427,126.54453,238,67,305,234,55,289,제주특별자치도 제주시 건입동 1453
3116,제6부두,33.52312,126.54463,31,5,36,31,4,35,제주특별자치도 제주시 건입동 1453
3117,제석머리,33.31507,126.17694,54,18,72,53,16,69,제주특별자치도 제주시 한경면 용수리 2737-4
3118,제석머리,33.31547,126.17717,119,14,133,108,14,122,제주특별자치도 제주시 한경면 용수리 4719-1
3119,각시물,33.32475,126.25931,4,4,8,4,4,8,제주특별자치도 제주시 한경면 저지리 2891-4
3120,각시물,33.324729999999995,126.26013,26,36,62,25,34,59,제주특별자치도 제주시 한경면 저지리 3258
3121,하도리개긋물,33.50208,126.88235,37,12,49,37,12,49,제주특별자치도 제주시 구좌읍 하도리 산 56
3122,하도리개긋물,33.5015,126.88263,11,4,15,11,4,15,제주특별자치도 제주시 구좌읍 하도리 1038-1
3123,하도리서문동,33.52002,126.87133,540,22,562,528,22,550,제주특별자치도 제주시 구좌읍 하도리 3281-1
3124,금산목,33.55322,126.80452,758,162,920,749,157,906,제주특별자치도 제주시 구좌읍 행원리 1292-5
3127,해녀박물관,33.521809999999995,126.86305,209,80,289,209,77,286,제주특별자치도 제주시 구좌읍 상도리 471-32
3128,해녀박물관,33.52172,126.86291,1963,473,2436,1900,457,2357,제주특별자치도 제주시 구좌읍 세화리 33-7
3129,해양맨션,33.53739,126.63999,12,1,13,12,1,13,제주특별자치도 제주시 조천읍 조천리 1328-5
3130,금능블루하와이,33.38172,126.21925,143,105,248,130,100,230,제주특별자치도 제주시 한림읍 금능리 2000-2
3131,금능블루하와이,33.38167,126.21954,901,556,1457,809,534,1343,제주특별자치도 제주시 한림읍 금능리 1994-1
3133,처남빌레,33.44781,126.33937,311,24,335,303,23,326,제주특별자치도 제주시 애월읍 상가리 1941-10
3136,삼화지구3단지,33.515229999999995,126.58598,5160,14,5174,5132,14,5146,제주특별자치도 제주시 도련일동 1911
3137,삼화지구3단지,33.51512,126.58629,6380,13,6393,6354,13,6367,제주특별자치도 제주시 도련이동 550
3138,농림축산검역본부,33.51007,126.50469,808,37,845,804,35,839,제주특별자치도 제주시 용담이동 885
3139,동백동산습지센터,33.50932,126.71439,136,48,184,131,46,177,제주특별자치도 제주시 조천읍 선흘리 926
3140,동백동산습지센터,33.50904,126.71461,51,39,90,50,38,88,제주특별자치도 제주시 조천읍 선흘리 922
3141,이도초등학교,33.4894,126.53256,2751,30,2781,2706,30,2736,제주특별자치도 제주시 이도이동 747
3147,체오름,33.47404,126.76149,20,3,23,20,3,23,제주특별자치도 제주시 구좌읍 송당리 산 49-1
3151,까끄래기오름,33.43365,126.70553999999998,27,8,35,27,7,34,제주특별자치도 제주시 조천읍 교래리 산 10-5
3152,한라도서관,33.47586,126.51525,16,2,18,16,2,18,제주특별자치도 제주시 오라이동 899-3
3153,연미월왓,33.48154,126.50804,679,12,691,666,11,677,제주특별자치도 제주시 오라이동 1698-4
3154,연미월왓,33.48109,126.50908,711,6,717,707,6,713,제주특별자치도 제주시 오라이동 1770-2
3155,금백조로입구,33.44768,126.76537,5,3,8,5,3,8,제주특별자치도 제주시 구좌읍 송당리 2236-8
3158,"방선문3차,4차빌리지",33.48773,126.52624,353,1,354,353,1,354,제주특별자치도 제주시 도남동 767-1
3159,"방선문3차,4차빌리지",33.48766,126.52667,1393,14,1407,1380,13,1393,제주특별자치도 제주시 도남동 659-7
3160,지방합동청사,33.49001,126.52308,209,3,212,209,3,212,제주특별자치도 제주시 도남동 1058
3162,고수동입구,33.322109999999995,126.75706,75,1,76,72,1,73,제주특별자치도 서귀포시 남원읍 신흥리 2481
3164,돔뱅이왓,33.23516,126.36945,1,2,3,1,2,3,제주특별자치도 서귀포시 하예동 1810-1
3165,광평교차로,33.33059,126.35501,201,51,252,195,44,239,제주특별자치도 서귀포시 안덕면 동광리 산 28-1
3166,보목포구(출발),33.23949,126.60626,1126,83,1209,1097,78,1175,제주특별자치도 서귀포시 보목동 1635
3167,향기마을,33.34386,126.79018,63,2,65,63,2,65,제주특별자치도 서귀포시 표선면 세화리 2176-3
3169,별내린전망대,33.24719,126.41673,44,56,100,41,53,94,제주특별자치도 서귀포시 색달동 2947-1
3170,별내린전망대,33.24723,126.41686,77,61,138,73,54,127,제주특별자치도 서귀포시 색달동 2947-1
3171,서광동리웃네거리,33.29462,126.33048,96,24,120,93,21,114,제주특별자치도 서귀포시 안덕면 동광리 1242-1
3172,서복전시관,33.24519,126.57018,667,992,1659,658,981,1639,제주특별자치도 서귀포시 서귀동 101-12
3173,서복전시관,33.245090000000005,126.5703,65,28,93,62,26,88,제주특별자치도 서귀포시 서귀동 101-14
3174,대정농협,33.22214,126.25226,13509,326,13835,13307,316,13623,제주특별자치도 서귀포시 대정읍 하모리 928-1
3175,국립기상과학원,33.25804,126.51732,124,7,131,123,7,130,제주특별자치도 서귀포시 서호동 1580
3176,위미감협,33.28107,126.66925,75,2,77,75,2,77,제주특별자치도 서귀포시 남원읍 위미리 1448-1
3178,국세공무원교육원생활관,33.25563,126.51915,195,82,277,194,77,271,제주특별자치도 서귀포시 서호동 1515
3179,활오름,33.26119,126.4832,181,5,186,181,5,186,제주특별자치도 서귀포시 강정동 3801-45
3180,독벌은이동산,33.36885,126.68389,356,37,393,350,35,385,제주특별자치도 서귀포시 남원읍 수망리 산 191-24
3182,삼달2리사무소,33.36916,126.86784,153,27,180,150,27,177,제주특별자치도 서귀포시 성산읍 삼달리 23-1
3183,한라산둘레길,33.328109999999995,126.60586,332,22,354,317,21,338,제주특별자치도 서귀포시 남원읍 하례리 산 30-1
3184,서귀포항입구,33.24009,126.5643,541,81,622,538,77,615,제주특별자치도 서귀포시 서귀동 786-6
3185,중문관광단지,33.25238,126.41297,2582,1147,3729,2420,1043,3463,제주특별자치도 서귀포시 색달동 2484-1
3187,표선생활체육관,33.35311,126.81472,8,2,10,8,2,10,제주특별자치도 서귀포시 표선면 하천리 1832-1
3188,표선생활체육관,33.35329,126.81678,192,4,196,190,2,192,제주특별자치도 서귀포시 표선면 하천리 1809-1
3189,모슬포남항여객선터미널(운진항),33.21119,126.25748,12783,2295,15078,12391,2120,14511,제주특별자치도 서귀포시 대정읍 하모리 634-31
3190,모슬포남항여객선터미널(운진항),33.21097,126.25733,1885,294,2179,1813,280,2093,제주특별자치도 서귀포시 대정읍 하모리 646-20
3191,회수동,33.26393,126.44419,191,39,230,184,38,222,제주특별자치도 서귀포시 회수동 384-5
3194,무릉손당호,33.27206,126.21125,11,1,12,7,1,8,제주특별자치도 서귀포시 대정읍 무릉리 2329-1
3196,선반로입구,33.24091,126.50509,108,5,113,107,5,112,제주특별자치도 서귀포시 강정동 424
3197,위미2리교차로,33.27775,126.66166,65,2,67,65,2,67,제주특별자치도 서귀포시 남원읍 위미리 2794
3198,위미리(위미2리교차로),33.27737,126.66101,77,29,106,76,22,98,제주특별자치도 서귀포시 남원읍 위미리 2759-1
3198,위미리(위미2리교차로),33.277570000000004,126.66307,77,29,106,76,22,98,제주특별자치도 서귀포시 남원읍 위미리 2041
3199,무릉리(사장동),33.26579,126.1995,222,72,294,199,68,267,제주특별자치도 서귀포시 대정읍 무릉리 3036-1
3200,무릉리(사장동),33.2656,126.1995,109,10,119,107,10,117,제주특별자치도 서귀포시 대정읍 무릉리 3036-1
3201,제주신화월드서머셋,33.29997,126.31878,26,2,28,25,2,27,제주특별자치도 서귀포시 안덕면 서광리 산 24-4
3202,신화역사공원,33.305640000000004,126.31967,7359,372,7731,7221,345,7566,제주특별자치도 서귀포시 안덕면 서광리 산 24-4
3203,제주오설록티뮤지엄,33.304520000000004,126.28862,1869,1891,3760,1779,1804,3583,제주특별자치도 서귀포시 안덕면 서광리 산 50-24
3204,오설록,33.30454,126.2888,417,267,684,403,257,660,제주특별자치도 서귀포시 안덕면 서광리 산 51-5
3205,제주항공우주박물관,33.30337,126.30124,314,138,452,297,128,425,제주특별자치도 서귀포시 안덕면 서광리 산 39-1
3206,제주항공우주박물관,33.303470000000004,126.30105,91,77,168,80,73,153,제주특별자치도 서귀포시 안덕면 서광리 산 39-1
3208,헬스케어타운리조트,33.28596,126.55772,736,58,794,675,52,727,제주특별자치도 서귀포시 동홍동 2048
3209,함덕에덴빌리지,33.53031,126.66508,140,11,151,139,10,149,제주특별자치도 제주시 조천읍 함덕리 1748-4
3212,열방대학,33.53696,126.70166,492,10,502,464,10,474,제주특별자치도 제주시 조천읍 북촌리 82-2
3214,차귀포구,33.30898,126.16504,128,63,191,121,60,181,제주특별자치도 제주시 한경면 고산리 3611-1
3216,주전동,33.33602,126.17677,72,2,74,72,2,74,제주특별자치도 제주시 한경면 용수리 1360-4
3218,성산청소년수련원,33.36144,126.84023,64,4,68,64,3,67,제주특별자치도 서귀포시 성산읍 신풍리 455-2
3220,동광육거리,33.310140000000004,126.34119,306,267,573,290,250,540,제주특별자치도 서귀포시 안덕면 동광리 810-5
3221,선반로입구,33.24138,126.50548,921,24,945,912,24,936,제주특별자치도 서귀포시 강정동 350-3
3222,제주항공우주호텔,33.30212,126.29524,11,67,78,11,62,73,제주특별자치도 서귀포시 안덕면 서광리 산 41
3223,제주항공우주호텔,33.30196,126.29528,177,121,298,175,117,292,제주특별자치도 서귀포시 안덕면 서광리 산 41
3225,노리매,33.28102,126.28735,326,126,452,322,124,446,제주특별자치도 서귀포시 대정읍 구억리 1055
3226,소인국테마파크,33.28965,126.32062,146,71,217,144,66,210,제주특별자치도 서귀포시 안덕면 서광리 719-3
3227,소인국테마파크,33.28949,126.32056,48,17,65,46,17,63,제주특별자치도 서귀포시 안덕면 서광리 718-3
3228,세계자동차제주박물관,33.28266,126.34867,32,26,58,29,23,52,제주특별자치도 서귀포시 안덕면 상창리 2065-1
3229,세계자동차제주박물관,33.28218,126.34914,70,54,124,57,49,106,제주특별자치도 서귀포시 안덕면 상창리 2068-7
3230,동광환승정류장1,33.31021,126.33932,698,209,907,676,197,873,제주특별자치도 서귀포시 안덕면 동광리 942-4
3231,동광단지,33.31387,126.35966,144,19,163,142,18,160,제주특별자치도 서귀포시 안덕면 동광리 74-37
3232,토평사거리,33.268809999999995,126.58521,119,18,137,114,17,131,제주특별자치도 서귀포시 토평동 2226-1
3233,토평사거리,33.26883,126.58559,899,377,1276,848,351,1199,제주특별자치도 서귀포시 토평동 2223-1
3236,제주항공우주박물관,33.30186,126.30186,193,83,276,190,80,270,제주특별자치도 서귀포시 안덕면 서광리 산 39
3237,제주항공우주박물관,33.30161,126.30199,102,71,173,94,65,159,제주특별자치도 서귀포시 안덕면 서광리 산 35-7
3238,"제주현대미술관,김창열미술관",33.33764,126.26653,240,118,358,236,115,351,제주특별자치도 제주시 한경면 저지리 2120-35
3239,"제주현대미술관,김창열미술관",33.33786,126.26647,183,51,234,181,50,231,제주특별자치도 제주시 한경면 저지리 2120-103
3240,선녀와나무꾼,33.47966,126.70192,145,83,228,142,80,222,제주특별자치도 제주시 조천읍 선흘리 2014
3241,한울랜드,33.49906,126.75305,8,10,18,6,10,16,제주특별자치도 제주시 구좌읍 덕천리 769
3242,덕천리,33.50255,126.77083,122,84,206,119,80,199,제주특별자치도 제주시 구좌읍 덕천리 1796
3243,종달항,33.497170000000004,126.91098,136,96,232,123,95,218,제주특별자치도 제주시 구좌읍 종달리 478-14
3244,환상숲곶자왈공원,33.32202,126.26344,77,20,97,74,13,87,제주특별자치도 제주시 한경면 저지리 3258
3245,환상숲곶자왈공원,33.32173,126.26342,138,149,287,131,146,277,제주특별자치도 제주시 한경면 저지리 2857-3
3246,대천환승정류장,33.43628,126.73682,379,236,615,365,229,594,제주특별자치도 제주시 구좌읍 송당리 산 126-6
3247,제주세계자연유산센터입구,33.45543,126.7104,35,37,72,29,34,63,제주특별자치도 제주시 조천읍 선흘리 464-1
3248,선녀와나무꾼,33.48015,126.70207,105,91,196,102,88,190,제주특별자치도 제주시 조천읍 선흘리 1997
3249,한울랜드,33.4994,126.75281,39,7,46,39,7,46,제주특별자치도 제주시 구좌읍 덕천리 산 62-24
3250,둔지오름,33.50611,126.79775,1,1,2,1,1,2,제주특별자치도 제주시 구좌읍 한동리 산 40
3251,둔지오름,33.50615,126.79796,44,47,91,44,47,91,제주특별자치도 제주시 구좌읍 한동리 4323
3252,메이즈랜드,33.49008,126.79953,10,12,22,10,12,22,제주특별자치도 제주시 구좌읍 송당리 353-4
3253,다랑쉬오름입구(북),33.48608,126.82988,28,25,53,28,24,52,제주특별자치도 제주시 구좌읍 세화리 2754
3254,다랑쉬오름입구(북),33.48595,126.82963,36,37,73,36,34,70,제주특별자치도 제주시 구좌읍 세화리 2754-1
3255,제주레일바이크,33.464620000000004,126.83642,136,149,285,131,135,266,제주특별자치도 제주시 구좌읍 상도리 산 373-2
3256,제주레일바이크,33.46464,126.83665,100,169,269,90,162,252,제주특별자치도 제주시 구좌읍 종달리 4639
3257,용눈이오름,33.46351,126.83188,2,5,7,1,5,6,제주특별자치도 제주시 구좌읍 상도리 1397-3
3258,용눈이오름,33.46328,126.83218,160,245,405,153,235,388,제주특별자치도 제주시 구좌읍 종달리 4648
3259,송당리마을,33.469840000000005,126.78591000000002,94,91,185,89,89,178,제주특별자치도 제주시 구좌읍 송당리 1463-1
3260,송당리마을,33.46965,126.78597,78,76,154,75,72,147,제주특별자치도 제주시 구좌읍 송당리 2774
3261,청수마을회관,33.31833,126.24762,38,5,43,38,5,43,제주특별자치도 제주시 한경면 청수리 1572-1
3262,청수마을회관,33.31812,126.24763,85,3,88,85,3,88,제주특별자치도 제주시 한경면 청수리 1572-3
3263,제주평화박물관,33.3048,126.25667,196,44,240,194,43,237,제주특별자치도 제주시 한경면 청수리 161-1
3264,제주평화박물관,33.30468,126.25663,98,36,134,98,36,134,제주특별자치도 제주시 한경면 청수리 145-5
3265,아부오름,33.446290000000005,126.78112,96,78,174,91,76,167,제주특별자치도 제주시 구좌읍 송당리 산 315
3266,아부오름,33.44653,126.78136,16,16,32,16,16,32,제주특별자치도 제주시 구좌읍 송당리 산 174-1
3269,종달항,33.49748,126.91143999999998,27,16,43,27,16,43,제주특별자치도 제주시 구좌읍 종달리 477-16
3270,제주시청(아라방면),33.499559999999995,126.52977,192611,5901,198512,189613,5680,195293,제주특별자치도 제주시 이도이동 1938-1
3271,제주시청(광양방면),33.49892,126.53035,239964,7480,247444,236477,7218,243695,제주특별자치도 제주시 이도이동 1938-1
3272,고산동산(아라방면),33.496,126.53228,43922,448,44370,43469,429,43898,제주특별자치도 제주시 이도이동 1085-4
3273,고산동산(광양방면),33.495540000000005,126.53291000000002,78799,1276,80075,78113,1237,79350,제주특별자치도 제주시 이도이동 1085-4
3274,제주지방법원(아라방면),33.493109999999994,126.53509,44013,971,44984,43412,896,44308,제주특별자치도 제주시 이도이동 1085-4
3275,제주지방법원(광양방면),33.49363,126.53476,79035,2931,81966,78036,2797,80833,제주특별자치도 제주시 이도이동 1085-4
3276,제주중앙여자고등학교(아라방면),33.48941,126.53864,40715,524,41239,40159,511,40670,제주특별자치도 제주시 이도이동 2060
3277,제주중앙여자고등학교(광양방면),33.489020000000004,126.5392,89342,1379,90721,88113,1344,89457,제주특별자치도 제주시 이도이동 2060
3278,제주여자중고등학교(아라방면),33.48486,126.54293,40075,673,40748,39303,656,39959,제주특별자치도 제주시 아라일동 2420-5
3279,제주여자중고등학교(광양방면),33.4852,126.54289,74734,1163,75897,73365,1140,74505,제주특별자치도 제주시 아라일동 2420-5
3280,남국원(아라방면),33.47971,126.54381,22605,320,22925,22415,310,22725,제주특별자치도 제주시 아라이동 1582-2
3281,남국원(광양방면),33.47957,126.54388,38262,859,39121,37724,821,38545,제주특별자치도 제주시 아라이동 1582-6
3282,대정환승정류장(대정읍사무소),33.225770000000004,126.25295,12797,1483,14280,12523,1364,13887,제주특별자치도 서귀포시 대정읍 하모리 1414-2
3283,대정환승정류장(대정읍사무소),33.22605,126.25173,1379,61,1440,1370,59,1429,제주특별자치도 서귀포시 대정읍 하모리 1443-1
3284,대정읍사무소,33.22561,126.25241,18,12,30,18,12,30,제주특별자치도 서귀포시 대정읍 하모리 1423-13
3285,성읍환승정류장(성읍1리사무소),33.38943,126.79827,562,49,611,550,47,597,제주특별자치도 서귀포시 표선면 성읍리 666-6
3286,성읍환승정류장(성읍1리사무소),33.38947,126.79848,1759,509,2268,1657,459,2116,제주특별자치도 서귀포시 표선면 성읍리 667-1
3287,하례환승정류장(하례리입구),33.3,126.6007,5291,635,5926,5092,557,5649,제주특별자치도 서귀포시 상효동 1122-5
3288,남원환승정류장(남원읍사무소),33.28062,126.72082,6518,160,6678,6411,153,6564,제주특별자치도 서귀포시 남원읍 남원리 207-10
3289,남원환승정류장(남원읍사무소),33.28053,126.72114,10043,1596,11639,9776,1434,11210,제주특별자치도 서귀포시 남원읍 남원리 196-3
3290,"제주국제공항(대정,화순,일주서로)",33.506440000000005,126.49298,16578,20799,37377,15910,19562,35472,제주특별자치도 제주시 용담이동 1462-1
3291,애월환승정류장(애월리),33.46483,126.3187,2462,1402,3864,2415,1366,3781,제주특별자치도 제주시 애월읍 애월리 1534-2
3300,신사동(기점),33.52596,126.67789,6979,190,7169,6889,186,7075,제주특별자치도 제주시 조천읍 함덕리 65-20
3303,제주이야기,33.4291,126.40969,22,1,23,22,1,23,제주특별자치도 제주시 애월읍 유수암리 3234
3307,스위스마을입구,33.49169000000001,126.67463,216,39,255,208,38,246,제주특별자치도 제주시 조천읍 와산리 1488-12
3308,스위스마을입구,33.49154,126.67438,23,11,34,22,8,30,제주특별자치도 제주시 조천읍 와산리 1505-6
3309,한라용사촌,33.53455,126.79616,30,2,32,30,2,32,제주특별자치도 제주시 구좌읍 행원리 2333-18
3310,한라용사촌,33.534490000000005,126.79641,42,9,51,42,9,51,제주특별자치도 제주시 구좌읍 행원리 1927-11
3317,수장동입구,33.3419,126.21142,27,4,31,27,4,31,제주특별자치도 제주시 한경면 두모리 215-1
3318,수장동입구,33.34167,126.21142,6,1,7,6,1,7,제주특별자치도 제주시 한경면 두모리 215-4
3319,영평알동네,33.48215,126.56043,1098,11,1109,1069,11,1080,제주특별자치도 제주시 영평동 2483-7
3320,영평알동네,33.48195,126.56028,250,9,259,240,8,248,제주특별자치도 제주시 영평동 2482-1
3322,신성여자중고등학교,33.479859999999995,126.56331000000002,1503,2,1505,1462,2,1464,제주특별자치도 제주시 영평동 2466-6
3323,영산홍아파트,33.4952,126.53993,1626,6,1632,1623,6,1629,제주특별자치도 제주시 이도이동 539-5
3324,영산홍아파트,33.495540000000005,126.53995,25,1,26,24,1,25,제주특별자치도 제주시 이도이동 405
3325,탐라중학교,33.49085,126.54394,786,6,792,775,6,781,제주특별자치도 제주시 아라이동 3011-7
3326,탐라중학교,33.49136,126.54384,1450,39,1489,1439,36,1475,제주특별자치도 제주시 아라이동 3015
3329,광령2리,33.45033,126.42888,30,7,37,30,7,37,제주특별자치도 제주시 애월읍 광령리 3101-2
3330,광령2리,33.45041,126.42903,1451,23,1474,1427,23,1450,제주특별자치도 제주시 애월읍 광령리 4227
3333,민속자연사박물관,33.50732,126.53087,2234,35,2269,2221,34,2255,제주특별자치도 제주시 일도이동 1050-1
3334,민속자연사박물관,33.50692,126.5308,382,16,398,376,16,392,제주특별자치도 제주시 일도이동 968-2
3336,부영3차아파트,33.476209999999995,126.48742,378,12,390,370,12,382,제주특별자치도 제주시 연동 1361-2
3337,남조순오름입구,33.47741,126.49112,299,9,308,296,9,305,제주특별자치도 제주시 연동 1525-1
3338,남조순오름입구,33.47729,126.49136,162,14,176,159,14,173,제주특별자치도 제주시 연동 1546
3343,오등상동,33.46284,126.53359,96,2,98,96,2,98,제주특별자치도 제주시 오등동 459-4
3344,오등상동,33.46257,126.53367,55,1,56,54,1,55,제주특별자치도 제주시 오등동 459-8
3347,탐라광장,33.51384,126.52815,2067,140,2207,2033,131,2164,제주특별자치도 제주시 일도일동 1202-1
3348,탐라광장,33.51382,126.52839,1726,262,1988,1702,247,1949,제주특별자치도 제주시 일도일동 1196
3349,고산1리,33.300940000000004,126.18026,435,32,467,433,31,464,제주특별자치도 제주시 한경면 고산리 2865-5
3350,"제주국제공항(평화로, 800번)",33.50659,126.49288,17732,14316,32048,17409,13981,31390,제주특별자치도 제주시 용담이동 2002
3350,"제주국제공항(평화로,800번)",33.50636,126.49272,17732,14316,32048,17409,13981,31390,제주특별자치도 제주시 용담이동 2002
3351,"제주국제공항(일주동로,516도로)",33.50669,126.49335,16453,23556,40009,15759,22049,37808,제주특별자치도 제주시 용담이동 1462-1
3352,농림축산검역본부,33.5099,126.50468,478,22,500,474,21,495,제주특별자치도 제주시 용담이동 865-1
3354,제주동여자중학교,33.50294,126.54024,3124,19,3143,3111,19,3130,제주특별자치도 제주시 이도이동 325-16
3355,제주동여자중학교,33.50263,126.54028999999998,1096,26,1122,1086,26,1112,제주특별자치도 제주시 이도이동 339
3357,신천지아파트,33.50621,126.54506,2733,21,2754,2721,21,2742,제주특별자치도 제주시 일도이동 46-1
3359,삼화아파트,33.509370000000004,126.54383,620,44,664,613,44,657,제주특별자치도 제주시 일도이동 144-3
3360,영락교회,33.51118,126.54338,280,2,282,277,2,279,제주특별자치도 제주시 일도이동 153-5
3361,영락교회,33.51112,126.54364,521,49,570,519,49,568,제주특별자치도 제주시 일도이동 488-10
3362,사대부고,33.51338,126.51038,1016,65,1081,998,64,1062,제주특별자치도 제주시 용담삼동 581-14
3363,사대부고,33.51339,126.51058,175,21,196,173,20,193,제주특별자치도 제주시 용담이동 576-2
3364,용두암현대1차아파트,33.51593,126.50875,2692,483,3175,2626,471,3097,제주특별자치도 제주시 용담삼동 503-12
3365,용두암현대1차아파트,33.51627,126.50832,1014,160,1174,1006,154,1160,제주특별자치도 제주시 용담삼동 510-3
3367,제주성지,33.50983,126.52587,62,1,63,61,1,62,제주특별자치도 제주시 이도일동 1501-28
3368,일도초등학교,33.51109,126.52875,297,7,304,296,6,302,제주특별자치도 제주시 일도일동 1100-4
3372,국세공무원교육원공무원연금공단,33.25463,126.51779,4323,1847,6170,4323,1847,6170,제주특별자치도 서귀포시 서호동 1583
3373,국세공무원교육원공무원연금공단,33.25437,126.518,139,50,189,139,50,189,제주특별자치도 서귀포시 서호동 1583
3374,상효원수목원,33.30511,126.58575,58,22,80,57,21,78,제주특별자치도 서귀포시 상효동 1555-2
3379,모구리야영장,33.405590000000004,126.81707,5,2,7,5,1,6,제주특별자치도 서귀포시 성산읍 삼달리 1982
3380,모구리야영장,33.40595,126.81815,74,7,81,72,6,78,제주특별자치도 서귀포시 성산읍 난산리 2968-3
3382,유건이오름,33.41684,126.84042,25,7,32,25,6,31,제주특별자치도 서귀포시 성산읍 난산리 2573-2
3385,서귀포동부도서관,33.260670000000005,126.60773,38,6,44,34,4,38,제주특별자치도 서귀포시 신효동 1120-3
3386,서귀포동부도서관,33.26045,126.60813,22,1,23,22,1,23,제주특별자치도 서귀포시 신효동 1060-3
3387,효돈축구공원,33.26071,126.61182,83,9,92,82,9,91,제주특별자치도 서귀포시 신효동 895-3
3388,효돈축구공원,33.26048,126.61122,22,5,27,22,5,27,제주특별자치도 서귀포시 신효동 919-3
3389,효돈농협하나로마트,33.26072,126.61724,851,51,902,848,47,895,제주특별자치도 서귀포시 하효동 641-2
3390,효돈농협하나로마트,33.26045,126.618,629,114,743,617,111,728,제주특별자치도 서귀포시 하효동 631-6
3391,맹살공원,33.26315,126.62162,149,29,178,148,27,175,제주특별자치도 서귀포시 하효동 313
3392,맹살공원,33.26314,126.62198,192,45,237,189,45,234,제주특별자치도 서귀포시 하효동 281-3
3393,제지기오름,33.245490000000004,126.61105,106,13,119,106,13,119,제주특별자치도 서귀포시 하효동 1425
3394,제지기오름,33.2453,126.61114,13,3,16,12,3,15,제주특별자치도 서귀포시 하효동 1407-3
3395,쇠소깍하효항입구,33.2529,126.61723,812,251,1063,786,223,1009,제주특별자치도 서귀포시 하효동 1090
3396,쇠소깍하효항입구,33.25264,126.6172,170,102,272,165,97,262,제주특별자치도 서귀포시 하효동 1068-3
3400,하효마을회관,33.2618,126.61758,271,14,285,270,12,282,제주특별자치도 서귀포시 하효동 190-1
3401,쇠소깍입구,33.25678,126.62174,937,623,1560,906,592,1498,제주특별자치도 서귀포시 하효동 1460
3405,앞동산,33.26568,126.61395,690,15,705,681,13,694,제주특별자치도 서귀포시 신효동 694-2
3406,감귤박물관,33.27132,126.61075,97,23,120,96,23,119,제주특별자치도 서귀포시 신효동 510-10
3407,감귤박물관,33.27172,126.61048999999998,205,30,235,199,30,229,제주특별자치도 서귀포시 신효동 506-18
3410,대천동주민센터,33.249340000000004,126.47794,26,3,29,26,3,29,제주특별자치도 서귀포시 도순동 1372
3415,강정의례회관,33.2381,126.47979,68,1,69,67,1,68,제주특별자치도 서귀포시 강정동 4511-1
3416,예천전문요양원,33.500029999999995,126.62007,1,5,6,1,5,6,제주특별자치도 제주시 회천동 3269
3417,하귀휴먼시아2단지입구,33.48188,126.41408,1838,7,1845,1826,7,1833,제주특별자치도 제주시 애월읍 하귀1리 238-1
3419,신산로,33.507940000000005,126.53406,232,42,274,229,41,270,제주특별자치도 제주시 일도이동 167-26
3420,문예회관,33.50548,126.53563,143,10,153,142,10,152,제주특별자치도 제주시 일도이동 470
3421,한림체육관,33.40898,126.26721,5554,88,5642,5424,86,5510,제주특별자치도 제주시 한림읍 한림리 915-11
3422,조천체육관(종점),33.5401,126.64279,14,5,19,14,5,19,제주특별자치도 제주시 조천읍 조천리 1198-3
3425,신촌초등학교(종점),33.53273,126.61876,37,2,39,37,1,38,제주특별자치도 제주시 조천읍 신촌리 4005
3426,고산환승정류장(종점),33.30077,126.18023,783,14,797,781,14,795,제주특별자치도 제주시 한경면 고산리 2920-4
3428,대천환승정류장(종점),33.43616,126.73706,10,1,11,10,1,11,제주특별자치도 제주시 구좌읍 송당리 산 126-7
3429,대천환승정류장(종점),33.43627,126.73677,13,5,18,13,4,17,제주특별자치도 제주시 구좌읍 송당리 산 126-6
3434,용화로,33.50968,126.50889,955,42,997,947,42,989,제주특별자치도 제주시 용담이동 616-12
3435,용화로,33.50958,126.5085,1898,31,1929,1883,31,1914,제주특별자치도 제주시 용담이동 627-48
3436,용마로,33.51483,126.50595,594,150,744,593,148,741,제주특별자치도 제주시 용담삼동 531-26
3437,용마로,33.515159999999995,126.50618,801,68,869,790,62,852,제주특별자치도 제주시 용담삼동 519-17
3438,조천도서관,33.53706,126.66796,3,1,4,3,1,4,제주특별자치도 제주시 조천읍 함덕리 915-1
3439,제주연구원,33.46765,126.51417,88,1,89,88,1,89,제주특별자치도 제주시 오라이동 44-13
3440,명월상동회관,33.37495,126.28304,258,4,262,258,4,262,제주특별자치도 제주시 한림읍 명월리 421-3
3444,명월리사무소,33.38675,126.26649,6,10,16,6,10,16,제주특별자치도 제주시 한림읍 명월리 1714-8
3447,고산동산,33.49511,126.53437,2385,50,2435,2372,50,2422,제주특별자치도 제주시 이도이동 1085-4
3448,고산동산,33.49463,126.53302,11024,179,11203,10911,172,11083,제주특별자치도 제주시 이도이동 1019-11
3449,고산동산,33.495290000000004,126.534,380,21,401,372,21,393,제주특별자치도 제주시 이도이동 1058-15
3450,제주소방서,33.49166,126.53581,3501,73,3574,3458,72,3530,제주특별자치도 제주시 이도이동 1029
3451,삼양파출소사거리,33.52052,126.58753,1031,96,1127,1008,92,1100,제주특별자치도 제주시 삼양이동 2181-18
3452,삼양파출소사거리,33.52056,126.58773,413,21,434,398,21,419,제주특별자치도 제주시 삼양이동 1494-15
3454,황사평성지,33.4868,126.55506,289,2,291,287,1,288,제주특별자치도 제주시 영평동 2662-11
3455,동문성당,33.51007,126.53237,1703,16,1719,1696,16,1712,제주특별자치도 제주시 일도이동 1031-11
3456,동문성당,33.51032,126.53252,44,3,47,44,3,47,제주특별자치도 제주시 일도이동 1024-30
3459,선흘분교입구,33.51599,126.70629,62,3,65,59,2,61,제주특별자치도 제주시 조천읍 선흘리 987-1
3460,선흘분교입구,33.51515,126.70644,4,1,5,4,1,5,제주특별자치도 제주시 조천읍 선흘리 1032
3462,생이집동산,33.27001,126.61299,137,5,142,135,5,140,제주특별자치도 서귀포시 신효동 548-2
3465,동광환승정류장(종점),33.3102,126.33937,34,12,46,34,10,44,제주특별자치도 서귀포시 안덕면 동광리 942-4
3466,동광환승정류장(종점),33.310340000000004,126.33932,22,5,27,22,5,27,제주특별자치도 서귀포시 안덕면 동광리 942-3
3467,번개과학체험관,33.28918,126.58627,52,18,70,50,18,68,제주특별자치도 서귀포시 토평동 1890-8
3468,소암기념관,33.24501,126.56736,91,3,94,91,3,94,제주특별자치도 서귀포시 서귀동 160-5
3469,소암기념관,33.24484,126.56763,46,16,62,46,15,61,제주특별자치도 서귀포시 서귀동 60-2
3470,덕수2리교차로,33.27668,126.31418,50,4,54,48,4,52,제주특별자치도 서귀포시 안덕면 덕수리 1453-1
3471,덕수2리교차로,33.275290000000005,126.31209,16,5,21,14,5,19,제주특별자치도 서귀포시 안덕면 덕수리 1605-5
3474,솜반천,33.25321,126.55336,101,5,106,100,5,105,제주특별자치도 서귀포시 서홍동 1219-1
3475,솜반천,33.25322,126.55351,89,1,90,88,1,89,제주특별자치도 서귀포시 서홍동 1223-4
3478,흙담솔사가,33.25885,126.5524,59,1,60,59,1,60,제주특별자치도 서귀포시 서홍동 1554-2
3479,흙담솔사가,33.25871,126.55227,332,5,337,329,5,334,제주특별자치도 서귀포시 서홍동 1530-3
3480,하효마을다목적회관,33.25815,126.61758,465,26,491,462,25,487,제주특별자치도 서귀포시 하효동 604-1
3481,신효웃동네,33.26741,126.61362,27,1,28,27,1,28,제주특별자치도 서귀포시 신효동 682-5
3482,신효웃동네,33.2674,126.61388,97,2,99,97,2,99,제주특별자치도 서귀포시 신효동 676-2
3483,보목동동네,33.24305,126.60597,992,53,1045,988,50,1038,제주특별자치도 서귀포시 보목동 399-7
3484,보목동동네,33.24307,126.60648,133,33,166,131,30,161,제주특별자치도 서귀포시 보목동 396-1
3485,위미3리마을회관,33.27512,126.68907,1655,45,1700,1626,43,1669,제주특별자치도 서귀포시 남원읍 위미리 161-1
3486,제주대학교병원,33.46784,126.54501,11428,143,11571,11334,138,11472,제주특별자치도 제주시 아라일동 1753-3
3487,첨단꿈에그린2단지아파트,33.45301,126.5764,4339,42,4381,4326,42,4368,제주특별자치도 제주시 월평동 745
3491,사려니마을,33.426390000000005,126.6559,165,60,225,156,55,211,제주특별자치도 제주시 조천읍 교래리 산 86-3
3492,사려니마을,33.42627,126.65595,45,40,85,42,38,80,제주특별자치도 제주시 조천읍 교래리 855
3493,구좌정수장,33.50508,126.77245,1,1,2,1,1,2,제주특별자치도 제주시 구좌읍 덕천리 308-5
3494,아라뜨래별,33.437290000000004,126.55464,17,5,22,16,5,21,제주특별자치도 제주시 아라일동 산 40-4
3495,남용통상,33.29072,126.57892,97,27,124,90,26,116,제주특별자치도 서귀포시 토평동 3284-1
3496,용운사,33.25999,126.62346,245,52,297,241,49,290,제주특별자치도 서귀포시 하효동 407-1
3497,정혜재활원,33.287,126.57819,712,126,838,677,120,797,제주특별자치도 서귀포시 토평동 3083-7
3498,온난화대응농업연구소,33.46625,126.51817,53,1,54,53,1,54,제주특별자치도 제주시 오등동 1730-1
3499,온난화대응농업연구소,33.46627,126.51842,34,1,35,34,1,35,제주특별자치도 제주시 오등동 1730-10
3500,"거슨새미오름,안돌오름",33.44509,126.7569,84,87,171,81,83,164,제주특별자치도 제주시 구좌읍 송당리 2339-3
3501,"거슨새미오름,안돌오름",33.44515,126.75685,288,32,320,284,31,315,제주특별자치도 제주시 구좌읍 송당리 2339-3
3503,배낭골,33.3458,126.23028,186,4,190,155,4,159,제주특별자치도 제주시 한경면 조수리 595-2
3505,홍수암,33.35326,126.22956,54,32,86,48,32,80,제주특별자치도 제주시 한림읍 월림리 951-2
3506,행장디,33.50113,126.56221,311,7,318,301,7,308,제주특별자치도 제주시 화북이동 3106-1
3507,행장디,33.50112,126.56269,24,4,28,24,4,28,제주특별자치도 제주시 화북이동 3160-3
3508,한국전력변전소,33.49832,126.53717,357,5,362,355,5,360,제주특별자치도 제주시 이도이동 996-7
3509,한국전력변전소,33.49838,126.53744,1349,26,1375,1337,26,1363,제주특별자치도 제주시 이도이동 444
3510,NHF삼화1단지,33.51746,126.5821,17314,93,17407,17175,91,17266,제주특별자치도 제주시 삼양이동 2338
3511,첨단꿈에그린2단지아파트,33.45189,126.57691,402,1,403,398,1,399,제주특별자치도 제주시 월평동 750
3514,제주관광대학(가상),33.4482,126.43583,16143,101,16244,15827,96,15923,제주특별자치도 제주시 애월읍 광령리 2619-3
3515,제주사대부설중학교,33.51497,126.51044,541,284,825,519,269,788,제주특별자치도 제주시 용담삼동 581-13
3516,제주사대부설중학교,33.51497,126.51055,221,145,366,215,143,358,제주특별자치도 제주시 용담이동 571-1
3517,항몽유적지입구,33.4574,126.41046,636,190,826,593,188,781,제주특별자치도 제주시 애월읍 상귀리 856-2
3518,항몽유적지입구,33.45742,126.4107,585,165,750,577,161,738,제주특별자치도 제주시 애월읍 고성리 1304-19
3519,명월상동,33.37509,126.27953,168,3,171,168,3,171,제주특별자치도 제주시 한림읍 명월리 350
3521,첨단로8길,33.44393,126.57193999999998,12,1,13,11,1,12,제주특별자치도 제주시 영평동 2192-1
3522,첨단로8길,33.44393,126.57212,1212,20,1232,1206,20,1226,제주특별자치도 제주시 영평동 2273
3525,지미봉입구,33.49515,126.90454,68,8,76,68,8,76,제주특별자치도 제주시 구좌읍 종달리 549-1
3526,지미봉입구,33.49488,126.90409,1,3,4,1,3,4,제주특별자치도 제주시 구좌읍 종달리 565-47
3527,아라초등학교,33.4777,126.54452,975,17,992,964,17,981,제주특별자치도 제주시 아라이동 1574-2
3528,하늘정원,33.51377,126.78009,16,8,24,16,8,24,제주특별자치도 제주시 구좌읍 행원리 3431
3529,하늘정원,33.51372,126.78028,50,18,68,47,18,65,제주특별자치도 제주시 구좌읍 행원리 3431-1
3530,동부경찰서,33.50178,126.53681,589,6,595,585,6,591,제주특별자치도 제주시 이도이동 1211-1
3531,동부경찰서,33.50159,126.53706,219,14,233,219,14,233,제주특별자치도 제주시 이도이동 444-1
3534,첨단과기단지입구교학촌아파트,33.45776,126.57145,76,4,80,76,3,79,제주특별자치도 제주시 영평동 2273
3539,탐라도서관,33.477540000000005,126.47759,657,13,670,648,10,658,제주특별자치도 제주시 노형동 765
3540,으뜸마을,33.47894,126.48033999999998,642,9,651,632,9,641,제주특별자치도 제주시 노형동 737
3542,상귀리,33.4735,126.40984,585,16,601,573,16,589,제주특별자치도 제주시 애월읍 상귀리 264-6
3543,제일교,33.51234,126.53191,289,8,297,288,8,296,제주특별자치도 제주시 일도이동 995-78
3550,구좌정수장,33.5048,126.77187,10,5,15,10,5,15,제주특별자치도 제주시 구좌읍 덕천리 311
3551,구좌정수장,33.50529,126.7722,188,15,203,188,14,202,제주특별자치도 제주시 구좌읍 덕천리 308-4
3553,행원교차로,33.545790000000004,126.80459,14,2,16,14,2,16,제주특별자치도 제주시 구좌읍 행원리 1145-2
3558,두문포노린당,33.49647,126.90913,115,43,158,107,42,149,제주특별자치도 제주시 구좌읍 종달리 486-6
3559,두문포노린당,33.4963,126.90915,1,5,6,1,5,6,제주특별자치도 제주시 구좌읍 종달리 565-40
3566,한림체육관,33.40892,126.26734,682,17,699,670,16,686,제주특별자치도 제주시 한림읍 한림리 886-8
3570,장전포제청,33.44413,126.38228,5,2,7,5,2,7,제주특별자치도 제주시 애월읍 장전리 1595-8
3573,장전초등학교,33.44963,126.39098,6,7,13,6,4,10,제주특별자치도 제주시 애월읍 장전리 430-5
3574,번대동,33.4777,126.39207,3089,81,3170,3054,78,3132,제주특별자치도 제주시 애월읍 하귀2리 2965-1
3575,어썸브리즈,33.259159999999994,126.27569,46,1,47,44,1,45,제주특별자치도 서귀포시 대정읍 안성리 1801-1
3580,통물,33.247679999999995,126.53115,94,21,115,90,20,110,제주특별자치도 서귀포시 호근동 2142
3581,봉림사,33.25473,126.53996,29,3,32,29,3,32,제주특별자치도 서귀포시 호근동 662-3
3582,봉림사,33.25473,126.54035,42,10,52,42,9,51,제주특별자치도 서귀포시 호근동 663-3
3583,배튼개입구,33.24157,126.44357,421,102,523,412,100,512,제주특별자치도 서귀포시 대포동 2606-20
3584,배튼개입구,33.24091,126.44324,335,70,405,323,68,391,제주특별자치도 서귀포시 대포동 2229-3
3585,동물개동산앞,33.240120000000005,126.4312,1014,200,1214,982,197,1179,제주특별자치도 서귀포시 대포동 1812-1
3586,동물개동산앞,33.24013,126.43105,536,227,763,513,205,718,제주특별자치도 서귀포시 대포동 1816-3
3592,강정새마을금고,33.236470000000004,126.47731,678,12,690,654,12,666,제주특별자치도 서귀포시 강정동 4399-21
3597,수산리사무소,33.44769,126.88239,593,14,607,593,13,606,제주특별자치도 서귀포시 성산읍 수산리 1208-2
3598,수산리사무소,33.44775,126.88253,89,6,95,88,6,94,제주특별자치도 서귀포시 성산읍 수산리 611-2
3599,석부작박물관,33.249990000000004,126.53472,63,26,89,62,25,87,제주특별자치도 서귀포시 호근동 509-2
3600,석부작박물관,33.25001,126.53526,73,25,98,71,23,94,제주특별자치도 서귀포시 호근동 512-5
3601,외돌개,33.241240000000005,126.54763,334,245,579,310,233,543,제주특별자치도 서귀포시 서홍동 780-1
3605,성읍119지역센터,33.38403,126.79449,8,4,12,8,4,12,제주특별자치도 서귀포시 표선면 성읍리 1381-1
3610,국제교회,33.28203,126.27853,349,17,366,343,17,360,제주특별자치도 서귀포시 대정읍 보성리 2468
3611,국제교회,33.28296,126.27806,947,27,974,940,25,965,제주특별자치도 서귀포시 대정읍 보성리 2478
3612,위미중학교,33.280570000000004,126.66246,281,2,283,265,2,267,제주특별자치도 서귀포시 남원읍 위미리 4591
3613,만지동,33.29315,126.62729,2,5,7,2,5,7,제주특별자치도 서귀포시 남원읍 신례리 1279-1
3614,휴애리자연생활공원,33.30834,126.63287,202,176,378,197,162,359,제주특별자치도 서귀포시 남원읍 신례리 2010-1
3615,휴애리자연생활공원,33.30813,126.6334,210,205,415,203,195,398,제주특별자치도 서귀포시 남원읍 신례리 2012-1
3616,예래오마트,33.24972,126.39413,38,1,39,36,1,37,제주특별자치도 서귀포시 상예동 1178-12
3617,예래오마트,33.24975,126.39426,1780,26,1806,1762,24,1786,제주특별자치도 서귀포시 상예동 802-4
3618,예래동노인회관,33.24667,126.39282,58,3,61,56,3,59,제주특별자치도 서귀포시 상예동 1200-1
3619,예래동노인회관,33.24667,126.39303999999998,2148,27,2175,2109,27,2136,제주특별자치도 서귀포시 상예동 4999
3620,예래생태체험관,33.24426,126.3895,76,1,77,73,1,74,제주특별자치도 서귀포시 하예동 45-1
3621,예래생태체험관,33.24408,126.38933,1713,40,1753,1682,38,1720,제주특별자치도 서귀포시 하예동 45-3
3622,진양빌라,33.243590000000005,126.38733,71,6,77,71,6,77,제주특별자치도 서귀포시 하예동 221-1
3623,진양빌라,33.24349,126.38737,1642,118,1760,1635,114,1749,제주특별자치도 서귀포시 하예동 221-1
3624,삼무공원,33.49116,126.49004,761,135,896,754,134,888,제주특별자치도 제주시 연동 260-13
3625,삼무공원,33.490790000000004,126.49023,224,53,277,223,53,276,제주특별자치도 제주시 연동 271
3627,세곳못,33.441959999999995,126.38125,31,3,34,31,3,34,제주특별자치도 제주시 애월읍 소길리 542-2
3628,명월리노인복지회관,33.38439,126.26736,18,5,23,18,5,23,제주특별자치도 제주시 한림읍 명월리 1616-1
3629,명월리노인복지회관,33.3847,126.26735,185,28,213,185,27,212,제주특별자치도 제주시 한림읍 명월리 1641-5
3630,유수암리,33.42711,126.4103,280,9,289,280,9,289,제주특별자치도 제주시 애월읍 유수암리 336-3
3631,한스빌타운하우스,33.43203,126.40707,14,1,15,14,1,15,제주특별자치도 제주시 애월읍 유수암리 882-1
3632,제주월드컵경기장,33.24913,126.50784,1892,108,2000,1872,107,1979,제주특별자치도 서귀포시 법환동 816-9
3633,제주노인복지타운,33.25436,126.43887,47,7,54,46,3,49,제주특별자치도 서귀포시 회수동 658-13
3634,제주노인복지타운,33.254090000000005,126.43907,4,6,10,4,6,10,제주특별자치도 서귀포시 회수동 637-3
3636,서복전시관,33.245020000000004,126.57044,472,88,560,470,86,556,제주특별자치도 서귀포시 서귀동 102-6
3638,정방동문화의집,33.2461,126.56853,69,13,82,69,13,82,제주특별자치도 서귀포시 서귀동 137-6
3639,중문동주민센터,33.25359,126.43323999999998,35,4,39,35,3,38,제주특별자치도 서귀포시 중문동 1894-2
3640,중문동주민센터,33.25347,126.43331,116,44,160,115,40,155,제주특별자치도 서귀포시 중문동 1870-1
3978,새별오름,33.35913,126.36296000000002,12,1,13,10,1,11,제주특별자치도 제주시 애월읍 봉성리 산 53-12
3979,새별오름,33.3608,126.3644,45,16,61,45,15,60,제주특별자치도 제주시 애월읍 봉성리 산 53-8
4010,김만덕기념관,33.515809999999995,126.53003,205,61,266,201,55,256,제주특별자치도 제주시 건입동 1148-1
4011,김만덕기념관,33.51592,126.52992,574,148,722,560,138,698,제주특별자치도 제주시 건입동 1430
4012,도평로광평마을입구,33.47914,126.46198,521,32,553,517,31,548,제주특별자치도 제주시 노형동 3104-9
4013,화북공업단지,33.51161,126.56547,46,1,47,45,1,46,제주특별자치도 제주시 화북이동 2271-7
4014,도평로광평마을입구,33.47928,126.46216,103,14,117,101,14,115,제주특별자치도 제주시 노형동 3104-9
4015,봉개초등학교,33.49005,126.59527,236,35,271,234,31,265,제주특별자치도 제주시 봉개동 1906-3
4016,이도수선화아파트,33.4944,126.55058,1168,23,1191,1155,23,1178,제주특별자치도 제주시 이도이동 67-1
4017,차고지(가상),33.49839,126.51651,136,13,149,136,13,149,제주특별자치도 제주시 삼도일동 586
4018,이도수선화아파트,33.494040000000005,126.55058,209,8,217,208,8,216,제주특별자치도 제주시 이도이동 66-1
4019,제주장애인요양원,33.45514,126.5713,522,6,528,514,6,520,제주특별자치도 제주시 영평동 2163
4020,제주장애인요양원,33.45516,126.5715,2561,61,2622,2530,59,2589,제주특별자치도 제주시 영평동 2273
4021,윗가시나물,33.4668,126.5697,354,2,356,349,2,351,제주특별자치도 제주시 영평동 2037-11
4022,승천로,33.49331,126.54165,744,1,745,738,1,739,제주특별자치도 제주시 아라이동 3012-3
4024,승천로,33.49381,126.54146,1813,34,1847,1784,31,1815,제주특별자치도 제주시 이도이동 2075
4025,이도수선화아파트,33.49064,126.55142,913,3,916,908,3,911,제주특별자치도 제주시 이도이동 105-1
4026,이도수선화아파트,33.49047,126.55134,153,1,154,152,1,153,제주특별자치도 제주시 이도이동 104-1
4027,한라도서관입구,33.48151,126.51572,100,3,103,99,3,102,제주특별자치도 제주시 오라이동 3828
4028,고지교,33.48678,126.51732,121,1,122,119,1,120,제주특별자치도 제주시 오라이동 943-3
4029,대원오등동입구,33.477340000000005,126.54233,135,2,137,135,2,137,제주특별자치도 제주시 아라일동 6049
4031,선돌목동길,33.44953,126.55103,175,8,183,169,8,177,제주특별자치도 제주시 아라일동 393-16
4032,선돌목동길,33.44913,126.55081,35,9,44,34,8,42,제주특별자치도 제주시 오등동 산 182-8
4033,연동한일시티파크,33.49152,126.48878,9479,1239,10718,9046,1177,10223,제주특별자치도 제주시 연동 2335-4
4034,연동한일시티파크,33.49158,126.48935,2472,611,3083,2370,571,2941,제주특별자치도 제주시 연동 250
4035,용마마을,33.517070000000004,126.50353,28,14,42,26,13,39,제주특별자치도 제주시 용담삼동 1064-3
4036,용마마을,33.51685,126.50371,7,1,8,6,1,7,제주특별자치도 제주시 용담삼동 1020-1
4038,물곧밭,33.457190000000004,126.40043,23,1,24,23,1,24,제주특별자치도 제주시 애월읍 수산리 57-4
4039,물곧밭,33.456579999999995,126.40096,220,3,223,219,3,222,제주특별자치도 제주시 애월읍 수산리 85-2
4040,예원동,33.46095,126.39782,533,4,537,530,4,534,제주특별자치도 제주시 애월읍 상귀리 1584
4041,브릭캠퍼스,33.45828,126.486,22,20,42,22,20,42,제주특별자치도 제주시 노형동 244-16
4043,첨단행복주택,33.455420000000004,126.57564,530,5,535,528,5,533,제주특별자치도 제주시 월평동 751
4044,첨단행복주택,33.455890000000004,126.57564,63,1,64,63,1,64,제주특별자치도 제주시 월평동 750
4047,소란마을,33.455330000000004,126.54928,57,9,66,57,9,66,제주특별자치도 제주시 아라일동 408-4
4048,아라뜨래별,33.437290000000004,126.55474,327,19,346,326,19,345,제주특별자치도 제주시 아라일동 산 40-1
4049,영등물,33.55532,126.73618,576,485,1061,541,474,1015,제주특별자치도 제주시 구좌읍 김녕리 4371
4050,매일올레시장7번입구,33.24909,126.56706,8822,2141,10963,8627,2036,10663,제주특별자치도 서귀포시 서귀동 335
4051,위미3리,33.27531,126.68672,583,41,624,566,40,606,제주특별자치도 서귀포시 남원읍 위미리 183-4
4052,고산문화의집,33.30015,126.18323999999998,236,21,257,233,21,254,제주특별자치도 제주시 한경면 고산리 3147-4
4053,소보리당입구,33.26403,126.38182,111,34,145,111,32,143,제주특별자치도 서귀포시 상예동 4999
4054,고산문화의집,33.300290000000004,126.18329,817,54,871,810,47,857,제주특별자치도 제주시 한경면 고산리 2901-3
4055,송당리사무소,33.47167,126.78227,247,60,307,246,55,301,제주특별자치도 제주시 구좌읍 송당리 1370-13
4056,수산체육공원입구,33.45033,126.85083,36,4,40,35,4,39,제주특별자치도 서귀포시 성산읍 수산리 3038-11
4058,아부오름,33.44283,126.78042,4,3,7,4,3,7,제주특별자치도 제주시 구좌읍 송당리 산 166-7
4059,백약이오름,33.44103,126.79463,25,51,76,24,51,75,제주특별자치도 서귀포시 표선면 성읍리 1892
4062,백약이오름,33.44138,126.79426,77,86,163,77,84,161,제주특별자치도 제주시 구좌읍 송당리 산 244-1
4063,아부오름,33.44307,126.78045,33,14,47,30,13,43,제주특별자치도 제주시 구좌읍 송당리 산 166-3
4064,명도암입구삼거리,33.42757,126.64043999999998,604,144,748,491,132,623,제주특별자치도 제주시 조천읍 교래리 777-2
4065,명도암입구삼거리,33.427620000000005,126.64015,184,19,203,163,17,180,제주특별자치도 제주시 조천읍 교래리 산 137-25
4066,성읍분투왓,33.40206,126.78349,18,4,22,14,3,17,제주특별자치도 서귀포시 표선면 성읍리 2375-7
4068,블루마운틴커피박물관,33.38041,126.83752,29,14,43,28,14,42,제주특별자치도 서귀포시 성산읍 삼달리 1510-1
4069,블루마운틴커피박물관,33.38089,126.83703,7,3,10,7,3,10,제주특별자치도 서귀포시 성산읍 삼달리 1507-2
4073,해양경찰청제주수련원,33.37892,126.79063,4,11,15,3,11,14,제주특별자치도 서귀포시 표선면 성읍리 3294
4076,옛성정문,33.31763,126.74512,2,1,3,2,1,3,제주특별자치도 서귀포시 남원읍 신흥리 1586-1
4077,의귀초등학교,33.31043,126.71523,99,1,100,99,1,100,제주특별자치도 서귀포시 남원읍 의귀리 1485-1
4078,노루생이삼거리,33.42292,126.49281,14,10,24,13,10,23,제주특별자치도 제주시 연동 산 146-3
4080,제주시공동묘지관리소,33.41948,126.49167,129,9,138,127,9,136,제주특별자치도 제주시 노형동 산 18-4
4081,노루생이삼거리,33.42245,126.49305,204,25,229,194,25,219,제주특별자치도 제주시 연동 산 146-3
4082,선담밭,33.27123,126.27655,97,8,105,96,8,104,제주특별자치도 서귀포시 대정읍 보성리 469-6
4083,선담밭,33.27117,126.27676,49,2,51,49,2,51,제주특별자치도 서귀포시 대정읍 보성리 469-5
4084,신화역사공원,33.30513,126.3189,626,124,750,611,114,725,제주특별자치도 서귀포시 안덕면 서광리 산 24-4
4085,제주신화월드테마파크,33.30279,126.3155,1245,174,1419,1200,167,1367,제주특별자치도 서귀포시 안덕면 서광리 산 35-15
4086,KIS빌리지,33.26933,126.27793,42,4,46,41,4,45,제주특별자치도 서귀포시 대정읍 보성리 479
4087,KIS빌리지,33.26941,126.27809,77,10,87,77,9,86,제주특별자치도 서귀포시 대정읍 안성리 1985-2
4088,제주신화월드테마파크,33.30265,126.31546000000002,6981,606,7587,6729,575,7304,제주특별자치도 서귀포시 안덕면 서광리 산 35-15
4089,지경동산,33.492,126.67176,55,19,74,55,19,74,제주특별자치도 제주시 조천읍 와산리 1642-13
4090,송당북문,33.47312,126.78493,36,11,47,36,11,47,제주특별자치도 제주시 구좌읍 송당리 1387-13
4091,평대마장,33.50068,126.81583,28,23,51,28,23,51,제주특별자치도 제주시 구좌읍 평대리 2866
4092,평대마장,33.50075,126.81561,37,9,46,37,8,45,제주특별자치도 제주시 구좌읍 평대리 2843-1
4094,지경동산,33.49221,126.67155,319,41,360,306,38,344,제주특별자치도 제주시 조천읍 대흘리 2787
4095,상귀동카름,33.47282,126.41364,316,3,319,312,3,315,제주특별자치도 제주시 애월읍 상귀리 20-3
4097,한림농협주유소,33.40872,126.26223,385,35,420,381,34,415,제주특별자치도 제주시 한림읍 한림리 1548-2
4099,사장동,33.53347,126.65968,2,1,3,2,1,3,제주특별자치도 제주시 조천읍 함덕리 2572
4100,사장동,33.53342,126.65988,30,2,32,29,2,31,제주특별자치도 제주시 조천읍 함덕리 2540-3
4102,이스트힐스,33.4816,126.63349,47,4,51,47,4,51,제주특별자치도 제주시 조천읍 와흘리 2814
4103,별진밭,33.4891,126.62797,4,1,5,4,1,5,제주특별자치도 제주시 회천동 37-2
4107,신흥리복지회관,33.54681,126.65216,201,4,205,199,4,203,제주특별자치도 제주시 조천읍 신흥리 144-7
4108,신흥리포구,33.54874,126.6508,213,15,228,213,15,228,제주특별자치도 제주시 조천읍 신흥리 530-15
4109,신흥리복지회관,33.54677,126.652,140,2,142,140,2,142,제주특별자치도 제주시 조천읍 신흥리 141-8
4113,제주세계자연유산센터입구,33.45543,126.71032,12,2,14,12,2,14,제주특별자치도 제주시 조천읍 선흘리 1844
4114,동방남비케길,33.48208,126.69157,267,3,270,266,3,269,제주특별자치도 제주시 조천읍 와산리 1707
4115,동방남비케길,33.481970000000004,126.69178,39,1,40,39,1,40,제주특별자치도 제주시 조천읍 와산리 307-2
4116,북촌리,33.54743,126.6947,15,3,18,14,3,17,제주특별자치도 제주시 조천읍 북촌리 639-1
4117,북촌리,33.54745,126.69479,103,13,116,99,13,112,제주특별자치도 제주시 조천읍 북촌리 639-7
4118,행원리오션뷰2차,33.526990000000005,126.78933,12,21,33,11,20,31,제주특별자치도 제주시 구좌읍 행원리 3559
4119,하도리신동,33.52359000000001,126.88374,34,12,46,34,11,45,제주특별자치도 제주시 구좌읍 하도리 1681-1
4120,하도리신동,33.52355,126.88387,213,13,226,213,13,226,제주특별자치도 제주시 구좌읍 하도리 1682
4121,행원리오션뷰2차,33.5269,126.78918,9,8,17,9,8,17,제주특별자치도 제주시 구좌읍 행원리 2794
4123,법기동,33.33027,126.17285,62,7,69,60,7,67,제주특별자치도 제주시 한경면 용수리 3551-7
4124,청수리사거리,33.321740000000005,126.24507,235,11,246,230,11,241,제주특별자치도 제주시 한경면 청수리 1686-1
4125,청수리사거리,33.32164,126.24512,167,13,180,166,10,176,제주특별자치도 제주시 한경면 청수리 1634-2
4126,법기동,33.33032,126.17271,61,6,67,61,6,67,제주특별자치도 제주시 한경면 용수리 3551-14
4127,용수리마을회관,33.32525,126.16874,163,15,178,161,14,175,제주특별자치도 제주시 한경면 용수리 4107-12
4128,주구동산,33.322790000000005,126.17015,149,11,160,149,11,160,제주특별자치도 제주시 한경면 용수리 4312-5
4129,붉으내,33.31889,126.17239,15,1,16,15,1,16,제주특별자치도 제주시 한경면 용수리 4719-1
4131,방지물,33.29693,126.22997,30,1,31,30,1,31,제주특별자치도 제주시 한경면 낙천리 856-3
4136,상명리동카름,33.36482,126.27206,310,1,311,310,1,311,제주특별자치도 제주시 한림읍 상명리 813-3
4139,배낭골,33.34583,126.23014,19,7,26,18,7,25,제주특별자치도 제주시 한경면 조수리 595-3
4140,낙천폭낭거리,33.32415,126.229,19,3,22,19,3,22,제주특별자치도 제주시 한경면 낙천리 1647-1
4143,유수암리사무소,33.4414,126.40315,296,4,300,296,4,300,제주특별자치도 제주시 애월읍 유수암리 1892-1
4144,웃거리,33.43935,126.40268,184,1,185,184,1,185,제주특별자치도 제주시 애월읍 유수암리 3234
4145,한스빌타운하우스,33.43134000000001,126.40767,108,5,113,107,5,112,제주특별자치도 제주시 애월읍 유수암리 885-3
4146,제주이야기,33.428960000000004,126.40952,13,2,15,13,2,15,제주특별자치도 제주시 애월읍 유수암리 354-7
4147,유수암상동경로당,33.42343,126.4056,771,34,805,768,34,802,제주특별자치도 제주시 애월읍 유수암리 1042-27
4148,더라목,33.45753,126.39025,22,1,23,20,1,21,제주특별자치도 제주시 애월읍 수산리 1315-1
4154,왕대왓,33.23465,126.48241000000002,1607,74,1681,1564,71,1635,제주특별자치도 서귀포시 강정동 2857-2
4155,왕대왓,33.23434,126.48362,1047,222,1269,1029,222,1251,제주특별자치도 서귀포시 강정동 2867-22
4160,제주세계자연유산센터거문오름,33.45683,126.7135,231,175,406,225,165,390,제주특별자치도 제주시 조천읍 선흘리 478-3
4161,인향동,33.2767,126.2438,32,5,37,32,5,37,제주특별자치도 서귀포시 대정읍 무릉리 322-7
4162,인향동,33.27626,126.24372,301,17,318,299,15,314,제주특별자치도 서귀포시 대정읍 무릉리 4097
4163,하효고막곶,33.2491,126.61394,1,1,2,1,1,2,제주특별자치도 서귀포시 하효동 1213-4
4164,망동산,33.256809999999994,126.61885,526,15,541,520,14,534,제주특별자치도 서귀포시 하효동 905-4
4165,하효고막곶,33.24905,126.61372,249,103,352,230,97,327,제주특별자치도 서귀포시 하효동 1232-4
4166,하례돈야로,33.29395,126.60711,307,4,311,305,4,309,제주특별자치도 서귀포시 남원읍 하례리 1715-5
4167,삼매봉중계소입구,33.24232,126.5522,10,3,13,10,3,13,제주특별자치도 서귀포시 서홍동 762-4
4168,삼매봉중계소입구,33.2422,126.55278,195,11,206,189,10,199,제주특별자치도 서귀포시 서홍동 753-10
4170,동상효회전교차로,33.2768,126.60591,51,12,63,50,12,62,제주특별자치도 서귀포시 상효동 199-2
4172,체육공원입구,33.27407,126.60831,63,9,72,62,9,71,제주특별자치도 서귀포시 신효동 1544-10
4174,헬스케어타운,33.28099,126.56379,421,32,453,411,29,440,제주특별자치도 서귀포시 토평동 3263
4175,소남동산,33.29445,126.6317,16,3,19,16,3,19,제주특별자치도 서귀포시 남원읍 신례리 1522-2
4181,자미성,33.29019,126.66064,3,1,4,3,1,4,제주특별자치도 서귀포시 남원읍 위미리 2572-3
4184,농협서부지점,33.25588,126.5244,114,6,120,113,5,118,제주특별자치도 서귀포시 호근동 1814-4
4185,약천사(출발지),33.24336,126.45061,402,133,535,375,121,496,제주특별자치도 서귀포시 하원동 1700-2
4188,심향사,33.29456,126.62174,129,2,131,128,2,130,제주특별자치도 서귀포시 남원읍 신례리 1647
4189,활오름,33.26135,126.4832,21,1,22,21,1,22,제주특별자치도 서귀포시 강정동 3791-2
4191,토산1리송천교,33.32431,126.76141,29,2,31,28,2,30,제주특별자치도 서귀포시 표선면 토산리 1879-1
4194,성산보건지소,33.447,126.91495,72,111,183,67,105,172,제주특별자치도 서귀포시 성산읍 고성리 2747
4197,토산1리송천교,33.324490000000004,126.76134,69,6,75,69,6,75,제주특별자치도 서귀포시 표선면 토산리 1893
4200,흥덕사,33.39903,126.876,19,2,21,19,2,21,제주특별자치도 서귀포시 성산읍 난산리 224-2
4202,달산봉입구,33.34321,126.82603,14,3,17,14,3,17,제주특별자치도 서귀포시 표선면 하천리 1100-4
4203,대진유토피아,33.34241,126.81477,478,39,517,470,39,509,제주특별자치도 서귀포시 표선면 표선리 2954
4204,예담요양원,33.34226,126.81633,141,10,151,140,8,148,제주특별자치도 서귀포시 표선면 표선리 2709
4205,크라운골프연습장,33.33979,126.8029,116,1,117,116,1,117,제주특별자치도 서귀포시 표선면 세화리 2489
4210,(구)화산초등학교,33.326229999999995,126.79726,108,1,109,106,1,107,제주특별자치도 서귀포시 표선면 세화리 2489
4220,대정읍다목적회관,33.22094,126.26695,1,1,2,1,1,2,제주특별자치도 서귀포시 대정읍 상모리 2775-1
4221,화순해안경비안전센터사계출장소,33.22527,126.29979,33,18,51,32,18,50,제주특별자치도 서귀포시 안덕면 사계리 2294-35
4222,대정읍다목적회관,33.22099,126.26702,235,101,336,211,93,304,제주특별자치도 서귀포시 대정읍 상모리 2773-2
4223,화순리동하동경로당,33.24022,126.33795,36,5,41,35,5,40,제주특별자치도 서귀포시 안덕면 화순리 763-4
4224,화순금모래해수욕장,33.2396,126.33572,81,15,96,77,15,92,제주특별자치도 서귀포시 안덕면 화순리 776-8
4225,화순리동하동경로당,33.24054,126.33865,32,2,34,31,2,33,제주특별자치도 서귀포시 안덕면 화순리 742-1
4226,서광서리3교차로,33.29092,126.30065,15,2,17,15,2,17,제주특별자치도 서귀포시 안덕면 서광리 1394-5
4227,진부동,33.288059999999994,126.30272,65,6,71,59,6,65,제주특별자치도 서귀포시 안덕면 서광리 1857-3
4228,진부동,33.288059999999994,126.30287,259,17,276,150,16,166,제주특별자치도 서귀포시 안덕면 서광리 2471
4229,서광서리3교차로,33.29108,126.30066,44,9,53,44,9,53,제주특별자치도 서귀포시 안덕면 서광리 1393-5
4230,제주신화월드서머셋,33.2999,126.31853999999998,39,14,53,38,13,51,제주특별자치도 서귀포시 안덕면 서광리 산 24-8
4233,먼머루,33.27698,126.31021,2,3,5,1,3,4,제주특별자치도 서귀포시 안덕면 덕수리 1614-1
4235,인향동,33.27642,126.24358,78,3,81,77,3,80,제주특별자치도 제주시 한경면 청수리 3389
4236,향토오일시장,33.26623,126.57349,989,33,1022,971,29,1000,제주특별자치도 서귀포시 동홍동 774-3
4237,칠십리음식특화거리,33.2441,126.56914,362,64,426,356,63,419,제주특별자치도 서귀포시 서귀동 93-23
4238,일과1리,33.23415,126.24243,23,1,24,23,1,24,제주특별자치도 서귀포시 대정읍 일과리 158
4240,고내포구,33.4671,126.33717,40,9,49,39,7,46,제주특별자치도 제주시 애월읍 고내리 1156-4
4241,신엄포구,33.47298,126.35,45,23,68,43,19,62,제주특별자치도 제주시 애월읍 고내리 337-2
4242,신엄입구,33.4784,126.36345,43,12,55,41,10,51,제주특별자치도 제주시 애월읍 신엄리 2730-3
4243,구엄포구,33.48406,126.37781,73,19,92,72,18,90,제주특별자치도 제주시 애월읍 구엄리 600-2
4244,가문동마을길,33.483509999999995,126.39577,42,11,53,40,11,51,제주특별자치도 제주시 애월읍 하귀2리 2615-2
4245,가문동마을길,33.48359,126.39579,18,10,28,18,9,27,제주특별자치도 제주시 애월읍 하귀2리 2615-5
4247,신엄입구,33.47849,126.36346,63,14,77,59,14,73,제주특별자치도 제주시 애월읍 신엄리 2730-4
4248,신엄포구,33.47305,126.3499,26,25,51,26,24,50,제주특별자치도 제주시 애월읍 고내리 337-2
4249,고내포구,33.46728,126.33684,3,7,10,3,7,10,제주특별자치도 제주시 애월읍 고내리 1156-4
6100732,구터미널,33.25203,126.56024,53617,2814,56431,52604,2689,55293,제주특별자치도 서귀포시 서귀동 337
6100848,제주시외버스터미널,33.49955,126.5148,1655,315,1970,1615,307,1922,제주특별자치도 제주시 오라일동 2441-4
6103001,제주월드컵경기장,33.24948,126.50862,42357,4356,46713,41209,4124,45333,제주특별자치도 서귀포시 법환동 760
6103005,서귀포시구시외버스터미널,33.25217,126.56052,59541,2713,62254,58562,2553,61115,제주특별자치도 서귀포시 서귀동 337
6115000,여객선대합실,33.96269,126.29761,2012,116,2128,1696,100,1796,제주특별자치도 제주시 추자면 대서리 4-39
6115001,추자면자치센터,33.963640000000005,126.29681,876,21,897,805,17,822,제주특별자치도 제주시 추자면 대서리 14-5
6115002,대서리사무소,33.96284,126.29564,289,6,295,253,6,259,제주특별자치도 제주시 추자면 대서리 147-7
6115003,한의원,33.96232,126.29416,487,8,495,419,7,426,제주특별자치도 제주시 추자면 대서리 370
6115004,엘지마트,33.96141,126.29452,868,13,881,790,13,803,제주특별자치도 제주시 추자면 영흥리 367-9
6115005,추자보건지소,33.96092,126.29554,155,6,161,120,5,125,제주특별자치도 제주시 추자면 영흥리 367-9
6115006,영흥리,33.959990000000005,126.29642,529,7,536,516,6,522,제주특별자치도 제주시 추자면 영흥리 367-9
6115007,영흥리부녀회사무실,33.959579999999995,126.29719,223,8,231,193,7,200,제주특별자치도 제주시 추자면 영흥리 367-9
6115009,추자교,33.95537,126.30091000000002,14,4,18,12,1,13,제주특별자치도 제주시 추자면 영흥리 94-1
6115010,묵리입구,33.95033,126.30689,130,4,134,94,4,98,제주특별자치도 제주시 추자면 묵리 산 124-1
6115011,묵리항,33.94683,126.31181,10,2,12,9,2,11,제주특별자치도 제주시 추자면 묵리 683-1
6115012,묵리,33.94464,126.31302,131,6,137,114,4,118,제주특별자치도 제주시 추자면 묵리 731-8
6115013,신양2리입구,33.94254,126.31511,150,2,152,147,2,149,제주특별자치도 제주시 추자면 묵리 227-2
6115015,한전사택,33.940670000000004,126.32204,47,1,48,45,1,46,제주특별자치도 제주시 추자면 신양리 841-2
6115017,추자해변장여관,33.94209,126.32477,2,1,3,2,1,3,제주특별자치도 제주시 추자면 신양리 979-36
6115018,추자중학교,33.94384,126.32577,90,1,91,81,1,82,제주특별자치도 제주시 추자면 신양리 434-7
6115019,신양1리,33.945609999999995,126.32767,220,3,223,204,2,206,제주특별자치도 제주시 추자면 신양리-2
6115020,하추자보건소,33.94603,126.32886,427,19,446,394,18,412,제주특별자치도 제주시 추자면 신양리 421-1
6115024,돈대산입구,33.95134,126.32771,2155,95,2250,1871,81,1952,제주특별자치도 제주시 추자면 예초리 325-1
6115025,모진이작지해수욕장입구,33.948640000000005,126.33099,61,6,67,50,5,55,제주특별자치도 제주시 추자면 신양리 979
6115026,하추자보건소,33.946290000000005,126.33081,566,13,579,507,11,518,제주특별자치도 제주시 추자면 신양리-2
6115028,추자중학교,33.945190000000004,126.32692,1138,31,1169,1065,25,1090,제주특별자치도 제주시 추자면 신양리-2
6115029,추자해변장여관,33.94379,126.32571000000002,189,18,207,159,16,175,제주특별자치도 제주시 추자면 신양리 434-7
6115031,한전사택,33.94032,126.32357,47,1,48,44,1,45,제주특별자치도 제주시 추자면 신양리 874-13
6115034,묵리,33.94262,126.31491,17,2,19,9,2,11,제주특별자치도 제주시 추자면 묵리 227-2
6115035,묵리항,33.94468,126.31297,249,7,256,231,7,238,제주특별자치도 제주시 추자면 묵리 731-6
6115036,묵리입구,33.94794,126.30906,643,12,655,612,12,624,제주특별자치도 제주시 추자면 묵리 산 86-1
6115037,추자교,33.95284,126.30382,24,5,29,19,4,23,제주특별자치도 제주시 추자면 묵리 산 131-1
6115038,추자119지역센터,33.95534,126.30104,75,5,80,58,5,63,제주특별자치도 제주시 추자면 영흥리 94-1
6115039,영흥리부녀회사무실,33.95966,126.30011,11,1,12,10,1,11,제주특별자치도 제주시 추자면 영흥리 23-4
6115042,엘지마트,33.96109000000001,126.29527,28,1,29,28,1,29,제주특별자치도 제주시 추자면 영흥리 367-9
6115043,한의원,33.96168,126.29411,58,2,60,53,2,55,제주특별자치도 제주시 추자면 대서리 147-16
6115045,추자면사무소,33.962990000000005,126.29588,34,1,35,33,1,34,제주특별자치도 제주시 추자면 대서리 140-9
6115046,여객선대합실,33.96351,126.29717,36,4,40,34,4,38,제주특별자치도 제주시 추자면 대서리 14-6
6115047,우도천진항,33.49334,126.95151,3647,1459,5106,2821,1286,4107,제주특별자치도 제주시 우도면 연평리 2656
6115048,우도봉입구,33.49558,126.95411,22,2,24,21,2,23,제주특별자치도 제주시 우도면 연평리 1666-2
6115052,비양동,33.51123,126.96567,1851,362,2213,1624,336,1960,제주특별자치도 제주시 우도면 연평리 133-1
6115059,하우목동,33.50731,126.95093,339,147,486,273,135,408,제주특별자치도 제주시 우도면 연평리 2164-2
6115100,서귀포시외버스터미널,33.24873,126.50799,3378,325,3703,3340,317,3657,제주특별자치도 서귀포시 법환동 843
6115101,서귀포시외버스터미널(가상정류소),33.248940000000005,126.50813,35245,2736,37981,34610,2578,37188,제주특별자치도 서귀포시 법환동 843
