station_id,station_name,geton_usage,getoff_usage,total_usage,tour_station
2972,제주국제공항(종점),700,30005,30705,0
638,제주국제공항(구제주방면),17301,9951,27252,0
1355,제주국제공항(신제주방면),11872,14289,26161,0
3290,"제주국제공항(대정,화순,일주서로)",7952,2421,10373,0
3351,"제주국제공항(일주동로,516도로)",8751,91,8842,0
2973,제주국제공항,6991,173,7164,0
149,제주버스터미널,3366,2986,6352,0
1579,제주국제공항(600번),6238,41,6279,0
279,동문로터리(동문시장),4741,1210,5951,1
150,제주버스터미널,2986,2938,5924,0
192,함덕환승정류장(함덕해수욕장),3943,1841,5784,1
321,제주도청신제주로터리,1508,3680,5188,0
198,함덕환승정류장(함덕해수욕장),1824,3308,5132,1
3270,제주시청(아라방면),1988,3138,5126,0
3350,"제주국제공항(평화로,800번)",4605,91,4696,0
320,제주도청신제주로터리,3637,1055,4692,0
3271,제주시청(광양방면),2883,1759,4642,0
2349,성산일출봉입구,3055,1488,4543,1
1564,제주시외버스터미널,4297,128,4425,0
2617,성산환승정류장(고성리한국물류),2694,1587,4281,1
2969,제주버스터미널(종점),17,4085,4102,0
2616,성산환승정류장(고성리회전교차로),1587,2504,4091,1
2348,성산일출봉입구,1284,2619,3903,1
2495,동광환승정류장4(제주방면),2224,1662,3886,0
280,동문로터리(동문시장),1609,2179,3788,1
2746,서귀포등기소,1630,2090,3720,0
1784,중앙로터리(동),2286,1290,3576,0
325,관덕정,2834,711,3545,1
1565,시외버스출발지(가상정류소),3162,186,3348,0
358,한라병원,1779,1568,3347,0
621,제주국제공항입구,122,3073,3195,0
357,한라병원,1640,1530,3170,0
863,세화환승정류장(세화리),781,2270,3051,1
1013,세화환승정류장(세화리),2173,729,2902,1
1699,제주월드컵경기장서귀포버스터미널,1284,1611,2895,0
2970,제주시외버스터미널(종점),50,2775,2825,0
324,관덕정,741,2037,2778,1
6103001,제주월드컵경기장,1832,933,2765,0
1091,한담동,1876,871,2747,1
284,중앙로(국민은행),775,1970,2745,0
151,한국병원,1451,1260,2711,0
283,중앙로(현대약국),1805,833,2638,0
1129,한림환승정류장(한림리),918,1649,2567,1
323,서문시장,442,2054,2496,0
1138,협재해수욕장,781,1711,2492,1
164,광양사거리,1125,1352,2477,0
3189,모슬포남항여객선터미널(운진항),2192,253,2445,0
2053,중문환승정류장(중문우체국),1699,729,2428,1
2353,성산항입구,1078,1302,2380,1
1137,협재해수욕장,1745,606,2351,1
2355,성산항,2232,40,2272,1
6103005,서귀포시구시외버스터미널,945,1278,2223,0
1228,김녕환승정류장(김녕초등학교),1652,542,2194,1
273,동광양,1362,819,2181,0
2354,성산항입구,1317,861,2178,1
1090,한담동,853,1324,2177,1
2221,성산항,80,2089,2169,1
186,은남동,1932,211,2143,1
2052,중문환승정류장(중문우체국),727,1374,2101,1
2243,고성리제주은행,1381,585,1966,0
1957,중앙로터리,865,1067,1932,0
282,중앙로(동문시장),457,1449,1906,0
187,은남동,289,1614,1903,1
1130,한림환승정류장(한림리),1240,570,1810,1
274,동광양,752,956,1708,0
1220,월정리,504,1198,1702,1
2051,천제연폭포,695,985,1680,1
361,남녕고등학교,993,677,1670,0
3190,모슬포남항여객선터미널(운진항),169,1488,1657,0
362,월랑마을남녕고등학교,733,918,1651,0
3291,애월환승정류장(애월리),511,1093,1604,1
6115100,서귀포시외버스터미널,75,1525,1600,0
6100732,구터미널,1099,498,1597,0
1645,중문관광단지입구,1298,287,1585,1
2494,동광환승정류장5(서귀방면),1057,521,1578,0
2743,동광환승정류장2(영어교육도시방면),1177,388,1565,0
2021,제주국제컨벤션센터,1314,224,1538,1
319,연동주민센터,1303,213,1516,0
360,노형오거리,911,588,1499,0
1953,제주은행,1148,330,1478,0
2088,동문로터리,121,1357,1478,1
2140,동문로터리,1378,94,1472,1
2240,성산포수협,356,1038,1394,1
1229,김녕환승정류장(김녕초등학교),509,883,1392,1
1660,제주국제컨벤션센터중문대포해안주상절리대,285,1100,1385,1
874,제일교동문시장입구,88,1292,1380,0
342,삼무공원,1223,126,1349,0
1214,구좌중앙초등학교,815,530,1345,0
318,연동주민센터,252,1091,1343,0
322,서문시장,1084,250,1334,0
391,삼무공원사거리,1089,244,1333,0
3275,제주지방법원(광양방면),1046,279,1325,0
2379,표선환승정류장(표선면사무소),1165,124,1289,1
96,제주민속오일장,670,618,1288,1
291,천수동,746,536,1282,0
747,비자림,856,407,1263,1
1253,성판악,820,429,1249,1
36,현사마을,370,859,1229,0
148,남서광마을입구,687,539,1226,0
2674,성판악,429,765,1194,1
1219,월정리,686,503,1189,1
2233,표선환승정류장(표선면사무소),65,1124,1189,1
294,고으니모르국립제주박물관,560,619,1179,0
200,제주대학교,387,784,1171,0
3274,제주지방법원(아라방면),293,871,1164,0
341,삼무공원,254,902,1156,0
748,비자림,437,713,1150,1
185,제원아파트,924,222,1146,1
189,도호동,163,977,1140,1
147,용천마을,557,582,1139,0
2020,평생학습관,485,653,1138,0
170,동산교,687,449,1136,0
2063,남군농협,273,857,1130,0
2242,표선환승정류장(표선리사무소),443,675,1118,1
2613,고성리구성산농협,471,643,1114,0
6115101,서귀포시외버스터미널(가상정류소),981,127,1108,0
501,한라수목원,968,130,1098,1
2734,오설록,214,875,1089,1
166,탐라장애인종합복지관,633,454,1087,0
1093,곽지해수욕장,431,654,1085,1
394,함덕리(3구),723,355,1078,1
390,삼무공원사거리,255,815,1070,0
395,함덕리(3구),399,663,1062,1
184,제원아파트,184,864,1048,1
637,월성마을,487,556,1043,0
1624,월정리용천동,638,402,1040,1
1135,협재리,766,273,1039,1
2246,하모2리,657,374,1031,1
696,제주대학교입구,585,443,1028,0
304,용문사거리,356,668,1024,0
3026,비석거리,225,797,1022,0
2,오광로입구,815,195,1010,0
3289,남원환승정류장(남원읍사무소),866,126,992,1
305,용문사거리,722,263,985,0
292,천수동,476,502,978,0
447,제주고등학교/중흥S클래스,493,482,975,0
1919,비석거리,833,130,963,0
1136,협재리,226,736,962,1
2137,천제연폭포,501,461,962,1
2792,제주민속촌,925,37,962,1
2056,중문초등학교,464,493,957,0
431,정존마을,553,400,953,0
3203,제주오설록티뮤지엄,552,399,951,1
901,송당로타리,514,429,943,0
307,용담1동주민센터,668,265,933,0
188,도호동,820,108,928,1
1087,애월환승정류장(애월리),633,290,923,1
2009,뉴경남호텔,33,883,916,1
2382,표선환승정류장(표선리제주은행),472,441,913,1
591,원노형,195,712,907,0
201,제주대학교,720,186,906,0
2062,현대산부인과,171,723,894,0
1955,청소년문화의집,196,695,891,0
2073,평생학습관,509,376,885,0
1646,중문관광단지입구,224,661,885,1
1748,남성마을입구,461,417,878,0
3282,대정환승정류장(대정읍사무소),766,107,873,1
281,중앙로(중앙성당),645,218,863,0
3273,고산동산(광양방면),583,278,861,0
3277,제주중앙여자고등학교(광양방면),677,181,858,0
311,제주여자상업고등학교,472,385,857,0
1139,한림공원,533,321,854,0
97,제주민속오일장,414,431,845,1
628,한라수목원,82,758,840,1
26,하귀초등학교,500,338,838,0
2104,뉴경남호텔,805,30,835,1
1747,남성마을입구,382,448,830,0
4050,매일올레시장7번입구,680,149,829,0
1956,청소년문화의집,562,267,829,0
586,오라오거리,647,171,818,0
269,삼성초등학교,290,522,812,0
1123,옹포사거리,382,428,810,0
1,국제여객선터미널,781,28,809,0
171,월구마을,265,543,808,0
1772,대륜동주민센터,545,263,808,0
1213,구좌중앙초등학교,392,405,797,0
3372,국세공무원교육원공무원연금공단,779,8,787,0
2057,중문초등학교,441,346,787,0
37,하귀초등학교,309,476,785,0
432,정존마을,409,372,781,0
306,용담1동주민센터,210,561,771,0
3276,제주중앙여자고등학교(아라방면),198,570,768,0
222,삼양동주민센터,501,266,767,1
900,송당로타리,400,361,761,0
152,한국병원,354,406,760,0
285,시민회관,501,259,760,0
359,노형오거리,457,297,754,0
1665,창천리,507,236,743,0
1648,예래입구,236,507,743,0
3279,제주여자중고등학교(광양방면),446,295,741,0
3288,남원환승정류장(남원읍사무소),95,645,740,0
1196,종달초등학교,494,244,738,0
1060,대천환승정류장(세화방향),340,379,719,1
1124,옹포사거리,452,266,718,0
1538,김녕미로공원,577,140,717,1
2703,광치기해변,461,242,703,1
121,제주대학교병원,224,477,701,0
1094,곽지해수욕장,498,192,690,1
2842,제주오설록티뮤지엄,351,338,689,1
398,함덕비석거리,476,202,678,1
1647,예래입구,547,130,677,0
1197,종달초등학교,261,411,672,0
1225,김녕해수욕장,302,369,671,1
2347,성산리입구,478,192,670,0
1140,한림공원,316,350,666,1
1222,만장굴입구,377,285,662,1
221,삼양초등학교,275,387,662,0
272,광양,100,559,659,0
396,함덕농협지소,436,200,636,0
595,연동입구,263,362,625,0
308,제주중학교/제주향교,226,398,624,0
2843,중문관광단지여미지식물원입구,52,572,624,1
1705,서귀포우체국서귀포시청제2청사,584,37,621,0
1186,해녀박물관입구,315,305,620,1
3272,고산동산(아라방면),167,452,619,0
629,연동입구,162,455,617,0
89,신광사거리,278,338,616,0
120,제주대학교병원,432,183,615,0
399,함덕비석거리,200,413,613,0
3230,동광환승정류장1,70,531,601,0
2636,영실매표소,307,293,600,1
1187,해녀박물관입구,319,278,597,1
270,보성시장,481,114,595,0
11,노형오거리,450,144,594,0
2825,중문관광단지여미지식물원입구,520,71,591,1
443,제주한라대학교,379,209,588,0
1685,플레이케이팝박물관,466,122,588,1
2820,삼정지에듀,538,50,588,0
2851,제주월드컵경기장(600번),83,505,588,0
1080,애월고등학교,168,413,581,0
193,함덕리(4구),259,320,579,0
1952,(구)중앙파출소,492,84,576,0
1153,신창환승정류장(한경면사무소),486,87,573,0
1134,한림주유소,270,296,566,0
1079,고내리,314,252,566,0
1463,메종글래드제주,63,491,554,1
301,용문마을회관,473,79,552,0
1200,평대리사무소,166,385,551,0
2244,하모3리,243,300,543,0
109,제주연안여객터미널,298,238,536,0
2493,동광환승정류장6(모슬포방면),179,357,536,0
1226,김녕해수욕장,306,229,535,1
2237,제주민속촌,10,523,533,1
3278,제주여자중고등학교(아라방면),237,294,531,0
2738,하모체육공원,32,497,529,0
1567,금능해수욕장,298,229,527,1
3106,행원목장,158,367,525,1
1730,서귀포여자고등학교,303,221,524,0
1640,상창보건진료소,184,340,524,0
1954,동미빌딩,388,134,522,0
302,용문마을,135,387,522,0
1675,신시가지,196,325,521,0
2719,붉은오름,336,185,521,1
1951,중문관광단지,60,459,519,1
168,남서광마을,237,279,516,0
1666,창천리,100,416,516,0
2114,스위트호텔,297,217,514,1
2279,하모3리축협,171,342,513,0
2094,한국콘도입구,446,63,509,1
2346,성산리입구,168,341,509,0
286,시민회관,170,338,508,0
2704,광치기해변,243,264,507,1
1081,애월고등학교,349,158,507,0
2080,(구)중앙파출소,115,391,506,0
2844,제주월드컵경기장(600번),412,94,506,0
468,제주동중학교,289,214,503,0
1274,교래입구,36,467,503,0
1959,구삼일금고,240,261,501,0
878,신창환승정류장(한경면사무소),89,409,498,0
2469,화순환승정류장(안덕농협),187,306,493,0
1706,서귀포우체국서귀포시청제2청사,40,453,493,0
2956,원노형,73,418,491,0
300,용문마을회관,109,382,491,0
1221,만장굴입구,215,275,490,1
1015,세화리시장2동,183,306,489,0
1189,세화리구좌농협,237,247,484,0
1989,대평리,231,253,484,0
2014,하얏트호텔,276,207,483,1
167,홍랑로입구,328,155,483,0
397,함덕농협지소,161,322,483,0
1086,애월리,194,287,481,0
275,문예회관,270,209,479,0
2819,한국국제학교,454,24,478,0
3373,국세공무원교육원공무원연금공단,14,463,477,0
108,제주연안여객터미널,71,403,474,0
1817,효돈중학교,258,213,471,0
346,수협제주도지회,393,78,471,0
691,원노형,429,40,469,0
1162,고산환승정류장(고산1리고산성당앞),346,122,468,0
2350,성산리,323,144,467,0
1092,곽지모물,355,111,466,0
1360,제주도립미술관입구,423,42,465,1
206,제주대학교입구,85,380,465,0
1125,한림여자중학교,221,237,458,0
2602,신양리입구,160,298,458,0
2821,삼정지에듀,41,416,457,0
411,조천환승정류장(조천우체국),279,177,456,1
12,롯데마트,217,239,456,0
1014,세화리시장2동,314,140,454,0
1142,금능리,315,134,449,0
91,신성마을,283,161,444,0
27,외도초등학교,277,167,444,1
1566,금능해수욕장,230,209,439,1
1078,고내리,242,197,439,0
2127,창천리남당물동산,273,165,438,0
1771,고래왓,168,269,437,0
3,오광로입구,84,352,436,0
271,광양,264,171,435,0
2468,화순환승정류장(안덕농협),271,163,434,0
1230,김녕리,201,231,432,0
278,인화초등학교,236,195,431,0
345,수협제주도지회,158,272,430,0
3281,남국원(광양방면),241,189,430,0
596,원노형,345,82,427,0
1729,서귀포여자고등학교,244,182,426,0
99,월랑로입구,166,260,426,0
786,고산환승정류장(고산1리),119,300,419,0
3348,탐라광장,89,330,419,0
620,다호마을,204,214,418,0
2718,붉은오름,218,198,416,1
28,외도초등학교,128,287,415,1
2967,관음사,407,4,411,0
90,신성마을,160,251,411,0
2464,산방산,310,101,411,1
313,제주동초등학교,253,154,407,0
2038,천지동주민센터,196,209,405,0
2113,천지연폭포(종점),233,172,405,1
692,메종글래드제주,343,62,405,
3185,중문관광단지,331,72,403,
1051,대천환승정류장(제주방향),263,139,402,0
553,제주관광대학,178,223,401,0
2971,제주한라대학교(종점),190,210,400,0
1359,제주도립미술관입구,20,379,399,1
299,화물청사입구,151,247,398,0
234,신촌초등학교,277,117,394,0
1266,제주돌문화공원,129,263,392,1
2603,신양리입구,251,141,392,0
2721,탄산온천,279,111,390,1
2879,섭지코지,281,109,390,1
2522,남원읍사무소,281,107,388,0
169,동성마을,105,279,384,0
1141,금능리,162,222,384,0
1639,상창보건진료소,268,115,383,0
2659,남원생활체육관,72,310,382,0
125,아라주공아파트,84,295,379,0
1367,사려니숲길,221,158,379,1
45,하귀환승정류장(하귀하나로마트),183,192,375,0
410,조천환승정류장(조천리사무소),148,225,373,0
1636,롯데호텔,239,132,371,1
3401,쇠소깍입구,227,143,370,1
3204,오설록,92,277,369,1
1121,옹포리,216,153,369,0
401,해양연구소,160,206,366,0
312,제주동초등학교,126,240,366,0
1356,제주절물자연휴양림,88,277,365,1
2019,아랑조을거리입구,181,183,364,0
2737,토요시장입구,111,253,364,0
4049,영등물,184,180,364,0
44,하귀환승정류장(하귀하나로마트),230,133,363,0
135,산천단,230,131,361,0
2465,산방산,121,238,359,1
433,노형초등학교,174,184,358,0
389,서문로터리,99,258,357,0
589,큰동네,178,178,356,0
136,산천단한국폴리텍대학,141,214,355,0
1144,월령리,283,72,355,0
122,인다마을,284,70,354,0
2523,남원읍사무소,132,220,352,0
1203,평대초등학교,278,72,350,0
2055,중문동,166,184,350,0
1539,"다랑쉬오름입구(남),손지오름",140,209,349,1
1058,대천환승정류장(표선방향),159,188,347,0
1148,판포리,114,232,346,0
402,신흥리(마을입구)함덕고등학교,237,107,344,0
3062,서귀포시외버스터미널(가상정류소),336,7,343,0
276,문예회관,187,156,343,0
2082,아랑조을거리입구,111,231,342,0
124,아라주공아파트,275,67,342,0
9,노형우체국,255,87,342,0
10,노형우체국,101,239,340,0
2083,LH아파트,191,148,339,0
4033,연동한일시티파크,286,52,338,0
3099,동복리관광체험어장,213,125,338,1
400,해양연구소,205,131,336,0
2793,고성리성산농협,226,110,336,0
293,국립제주박물관,224,112,336,1
1063,산굼부리,143,191,334,1
2567,성산포수협표선지점,256,78,334,0
859,동성동,200,133,333,0
1122,옹포리,132,200,332,0
2818,한국국제학교,37,295,332,0
467,제주동중학교,110,221,331,0
1095,금빛신협,191,140,331,0
1127,한국통신,125,206,331,0
2892,함덕리(4구),286,44,330,0
795,금능석물원,271,59,330,1
554,제주관광대학,205,125,330,0
310,제주여자상업고등학교,119,208,327,0
2466,화순리,142,183,325,0
13,롯데마트,170,154,324,0
4034,연동한일시티파크,122,202,324,0
2010,플레이케이팝박물관,172,151,323,1
2054,중문동,173,148,321,0
1836,위미문화의집,180,141,321,0
2032,천지연폭포입구,318,3,321,1
1749,삼매봉입구,131,189,320,1
481,연동대림1차아파트,263,57,320,0
2093,고래왓,189,130,319,0
2817,블랭섬홀아시아,36,281,317,0
1259,제주돌문화공원,269,47,316,1
1145,월령리,55,260,315,0
4088,제주신화월드테마파크,186,128,314,1
1366,사려니숲길,121,185,306,1
737,한림고등학교,20,284,304,0
316,사라봉오거리,203,99,302,1
356,남녕마트,130,171,301,0
1064,산굼부리,207,93,300,1
235,신촌초등학교,88,212,300,0
3128,해녀박물관,253,44,297,1
355,남녕마트,192,105,297,0
1515,함덕리(4구),28,267,295,0
174,명주주택,286,9,295,0
2105,서귀포항,291,4,295,0
3031,서귀포칼호텔(종점),68,227,295,1
3174,대정농협,195,99,294,0
480,연동대림1차아파트,90,203,293,0
631,공항초소,49,244,293,0
2700,약천사,209,83,292,0
2356,오조해녀의집,154,138,292,1
2814,동백동산,209,80,289,1
424,오현중고등학교,139,148,287,0
2657,남원생활체육관,238,46,284,0
126,케이티앤지,227,55,282,0
2180,상천리사무소,92,188,280,0
2816,블랭섬홀아시아,247,33,280,0
1072,중엄리,174,105,279,0
303,용문마을,203,75,278,0
2752,남원포구입구,149,129,278,0
19,수정동,173,105,278,0
3115,국제여객선터미널,16,261,277,0
268,화북남문,195,82,277,0
1147,판포리,203,74,277,0
861,종달리,113,163,276,0
3127,해녀박물관,35,241,276,1
2357,오조해녀의집,155,120,275,1
3287,하례환승정류장(하례리입구),230,44,274,0
1026,교래사거리,77,196,273,0
703,평대,7,266,273,0
351,이호테우해수욕장,245,27,272,1
2111,서귀포칼호텔,259,13,272,1
1071,중엄리,141,131,272,0
3081,유승한내들아파트,259,12,271,0
131,아라동주민센터,206,65,271,0
738,한림고등학교,252,17,269,0
1188,세화리구좌농협,129,140,269,0
423,오현중고등학교,139,128,267,0
1208,계룡동,150,117,267,0
403,신흥리(마을입구)함덕고등학교,97,170,267,0
1816,비석거리,237,30,267,0
153,중앙마을,9,258,267,0
172,오라3동,82,185,267,0
3172,서복전시관,255,11,266,0
1870,하례환승정류장(하례리입구),68,197,265,0
2216,고성리장만이동산,158,107,265,1
1801,삼아아파트,218,47,265,0
3116,제6부두,2,260,262,0
1235,동복리,116,146,262,0
59,일우한란아파트,17,245,262,1
2461,사계리동동,181,80,261,0
1143,금능석물원,53,207,260,1
3080,유승한내들아파트,49,209,258,0
344,제주썬호텔,185,72,257,1
2656,광지동,145,111,256,0
588,우당도서관,166,90,256,0
3169,별내린전망대,14,241,255,1
2280,인성리(남문지앞사거리),74,181,255,0
592,화북초등학교,113,141,254,0
1096,금빛신협,128,126,254,0
2506,구억리,46,208,254,0
2459,사계리사무소,166,87,253,0
1768,수모루,121,132,253,0
112,종합어시장,91,162,253,0
2796,탄산온천,105,146,251,1
132,아라초등학교,77,173,250,0
1195,종달리,133,116,249,0
635,공항초소,209,40,249,0
3465,동광환승정류장(종점),3,246,249,0
1572,제주절물자연휴양림,243,6,249,1
435,노형오거리,189,59,248,0
1250,어리목입구,60,188,248,1
1133,한림천주교회,126,119,245,0
1216,행원리,114,130,244,0
3131,금능블루하와이,226,18,244,1
1540,"다랑쉬오름입구(남),손지오름",168,76,244,
2129,창천초등학교,125,119,244,0
466,화북남문,89,155,244,0
2751,남원포구입구,145,98,243,0
2587,신산환승정류장(성산농협신산지점),173,70,243,0
2095,켄싱턴제주호텔입구,10,233,243,1
2278,인성리(남문지앞사거리),205,38,243,0
1265,교래사거리,67,175,242,0
1126,한림여자중학교,109,132,241,0
1653,1100도로입구,236,5,241,0
1275,교래입구,202,38,240,0
165,탐라장애인종합복지관,114,125,239,0
327,농협지역본부,118,121,239,0
1215,행원리,149,90,239,0
60,일우한란아파트,214,23,237,1
2739,구억리옹기체험관,209,27,236,1
1234,동복리,146,90,236,0
1240,북촌리,65,170,235,0
1239,북촌리,161,74,235,0
1027,교래사거리,137,97,234,0
207,제주대학교입구,155,79,234,0
2013,신라호텔,123,109,232,1
1988,대평리,176,55,231,0
1101,귀덕초등학교,150,80,230,0
263,회천입구,112,117,229,0
1963,솔동산입구,161,67,228,0
218,제4부두,207,21,228,0
2139,비석거리,47,181,228,0
449,부영아파트,162,66,228,0
1249,어리목,201,26,227,1
1967,세기아파트,64,163,227,0
1227,동성동,138,89,227,0
93,제성마을,162,64,226,0
3286,성읍환승정류장(성읍1리사무소),204,22,226,0
1128,한국통신,147,78,225,0
2039,서귀포농협,128,97,225,0
3130,금능블루하와이,39,183,222,1
694,6호광장,216,6,222,0
430,월산정수장입구,81,140,221,0
483,신제주오피스텔,36,185,221,0
1386,제주해변공연장,151,69,220,1
1224,지경곰,58,162,220,0
123,인다마을,58,162,220,0
3284,대정읍사무소,9,211,220,0
2586,신산환승정류장(성산농협신산지점),63,156,219,0
3364,용두암현대1차아파트,205,13,218,0
3280,남국원(아라방면),96,121,217,0
1755,외돌개,205,12,217,1
1835,위미문화의집,115,101,216,0
1676,성산하이츠빌라,169,47,216,0
1074,신엄리,116,99,215,0
1887,서귀포산업과학고등학교,62,153,215,0
2351,성산리취락구조,172,41,213,0
1069,구엄리,66,147,213,0
1595,비자림로교래입구,185,28,213,0
499,제주제일고등학교,43,170,213,0
1450,디지털융합센터,163,49,212,0
1212,한동리서동,102,109,211,0
1260,교래사거리,124,87,211,0
141,정부제주지방합동청사,49,162,211,0
875,신산로,97,114,211,0
1943,켄싱턴리조트악근천,117,94,211,1
1475,선진동,119,91,210,0
1802,주공34단지,125,85,210,0
1201,평대리사무소,146,62,208,0
3173,서복전시관,7,201,208,0
2467,화순리,125,82,207,0
1958,서귀북초등학교,184,22,206,0
2794,농협하나로마트,101,104,205,0
472,운전면허시험장,86,119,205,0
277,인화초등학교,92,113,205,0
1102,귀덕1리,87,118,205,0
429,월산정수장입구,117,86,203,0
2215,고성리장만이동산,58,145,203,0
1231,김녕리,119,84,203,0
448,중흥S클래스아파트,107,96,203,0
2552,샤인빌리조트입구,106,96,202,1
1944,켄싱턴리조트악근천,133,69,202,1
39,하귀우체국,92,109,201,0
1962,솔동산입구,89,112,201,0
486,해안로,46,154,200,1
1070,구엄리,135,64,199,0
3070,삼다체육공원입구,172,27,199,0
4194,성산보건지소,40,158,198,0
1389,제주해변공연장,105,93,198,1
1180,하도리,155,42,197,0
113,탑동푸른쉼터,140,57,197,1
1059,대천환승정류장(교래방향),126,71,197,0
1202,평대초등학교,192,4,196,0
1181,하도리,68,127,195,0
1531,교래자연휴양림,106,89,195,1
2012,하나호텔한국관광공사,131,64,195,0
453,사대부고,141,54,195,0
464,제주고등학교,18,177,195,0
2612,고성리제주은행,129,65,194,0
2624,시흥리,67,125,192,0
2460,사계리사무소,64,128,192,0
1073,신엄리,105,86,191,0
2361,성산고등학교,110,81,191,0
2551,샤인빌리조트입구,137,54,191,1
3396,쇠소깍하효항입구,42,149,191,1
225,조천리,88,102,190,0
3112,제6부두,174,16,190,0
487,해안로,166,23,189,0
2965,제주도립미술관,125,63,188,1
822,동명리,81,107,188,0
707,만장굴입구,4,184,188,1
1672,중문고등학교,115,73,188,0
175,명주주택,76,112,188,0
2800,수산1리비석거리,164,21,185,0
34,신산마을,154,30,184,0
2772,산방복지회관,72,111,183,0
2891,교래리보건소,117,64,181,0
465,제주고등학교,172,9,181,0
3246,대천환승정류장,85,96,181,0
24,번대동,94,87,181,0
1211,한동리서동,115,66,181,0
3258,용눈이오름,101,79,180,1
2476,덕수초등학교,111,69,180,0
454,사대부고,77,102,179,0
2765,주공34단지,52,127,179,0
1207,계룡동,84,94,178,0
2362,성산고등학교,83,94,177,0
20,연대마을,123,54,177,0
1837,위미1리사무소,86,91,177,0
33,신산마을,40,136,176,0
427,월산마을,61,115,176,0
2064,서문로터리입구,51,125,176,0
490,도두동,81,95,176,0
2008,서귀포항,19,156,175,0
805,송당초등학교,77,97,174,0
1120,한림고등학교,113,61,174,0
4085,제주신화월드테마파크,73,101,174,1
38,하귀우체국,85,89,174,0
2026,법환농협,132,41,173,0
2059,(구)중문동주민센터,67,106,173,0
1349,애월신협,130,43,173,0
1662,씨에스호텔,66,107,173,1
1960,오션팰리스호텔,87,86,173,1
1845,공천포,87,86,173,1
231,대섬입구,96,77,173,0
241,화북주공아파트,115,58,173,0
1206,평대리서동,72,100,172,0
2756,대포포구,96,76,172,0
2405,표선면충혼묘지,78,93,171,0
450,으뜸마을,74,97,171,0
1740,법환농협,71,99,170,0
1671,중문고등학교,69,101,170,0
488,오래물광장,153,17,170,0
100,월랑입구,125,43,168,0
2478,대정고등학교,37,131,168,0
428,월산마을,100,67,167,0
92,제성마을,63,104,167,0
1209,한동리,106,60,166,0
233,신촌리,82,84,166,0
1205,평대리서동,104,61,165,0
142,정부제주지방합동청사,110,55,165,0
232,신촌리,89,75,164,0
2381,표선초등학교,126,37,163,0
3601,외돌개,61,102,163,1
2771,"테디밸리골프앤리조트,헬로키티아일랜드",56,107,163,1
3518,항몽유적지입구,71,90,161,1
1918,비석거리,10,151,161,0
2597,온평초등학교,118,43,161,0
1849,하례1리입구,89,72,161,0
823,한림2리,109,52,161,0
1661,씨에스호텔,135,25,160,1
1100,하동복지회관,64,96,160,0
210,인화동,91,69,160,0
2598,혼인지입구,34,126,160,0
383,용담사거리,26,134,160,0
173,명신마을,134,25,159,0
1541,메이즈랜드,75,84,159,1
7,노형주공아파트,144,14,158,0
1492,신사동(종점),63,95,158,0
652,봉개동,96,62,158,0
1819,효돈초등학교,101,56,157,0
2679,수산초등학교,139,18,157,0
659,우당도서관입구,2,155,157,0
2878,섭지코지,48,108,156,1
392,월성마을회관,121,35,156,0
230,대섬입구,94,62,156,0
226,조천리,97,59,156,0
2322,해병부대,126,29,155,0
1085,애월중학교,77,78,155,0
3233,토평사거리,148,7,155,0
352,이호테우해수욕장,16,139,155,1
223,삼양2동,128,26,154,0
3516,제주사대부설중학교,36,118,154,0
651,봉개동,83,71,154,0
445,제주한라대학교,72,82,154,0
2714,문화마을,78,76,154,0
2596,온평초등학교,39,114,153,0
1779,서귀북초등학교,23,130,153,0
3285,성읍환승정류장(성읍1리사무소),17,135,152,0
1973,주공2단지,34,118,152,0
343,제주썬호텔,51,100,151,1
1358,한라생태숲,74,77,151,1
3486,제주대학교병원,84,67,151,0
2697,대포항,63,87,150,0
61,우령이마을,13,137,150,0
2364,모슬포우체국,35,114,149,0
2583,삼달교차로,83,66,149,0
1818,효돈중학교,51,97,148,0
115,탑동입구,49,99,148,1
624,큰구릉내,91,57,148,1
1641,우남동,80,67,147,1
1164,화전마을,81,66,147,1
2132,강창학종합경기장,134,13,147,1
1532,S중앙병원,61,86,147,1
3202,신화역사공원,81,65,146,1
1838,위미초등학교,76,70,146,1
145,제주국제대학교,80,65,145,1
1869,서귀포산업과학고등학교,119,26,145,1
2524,동부보건소,81,64,145,1
3124,금산목,63,82,145,1
1974,산남새마을금고,124,20,144,1
315,사라봉,22,122,144,1
2699,약천사,53,90,143,1
1269,전원마을,54,88,142,1
1199,평대리동동,58,84,142,1
2877,산이수동,93,46,139,1
2799,수산1리비석거리,93,46,139,1
1677,반참모르,96,42,138,1
2774,성박물관,101,37,138,1
21,모감동,73,65,138,1
1850,하례1리입구,77,60,137,1
2651,의귀환승정류장(의귀초등학교),129,8,137,1
1198,평대리동동,80,56,136,1
4160,제주세계자연유산센터거문오름,87,49,136,1
858,동복리휴게소,83,53,136,1
1846,공천포,77,59,136,1
415,서해안로,122,14,136,1
461,무수천,70,65,135,1
2365,덕수초등학교,64,71,135,1
2406,표선면충혼묘지,85,50,135,1
2665,의귀환승정류장(의귀초등학교),29,106,135,1
31,내도동동마을,96,38,134,1
2374,표선고등학교,6,128,134,1
2285,수산초등학교,22,112,134,1
2660,광지동,74,60,134,1
590,큰동네,109,25,134,1
471,운전면허시험장,72,61,133,1
482,신제주오피스텔,122,11,133,1
1537,김녕미로공원,63,70,133,1
2352,성산리취락구조,49,84,133,1
203,제대아파트,123,10,133,1
224,삼양2동,34,98,132,1
2399,성읍농협,78,54,132,1
2757,대포포구,82,50,132,1
489,오래물광장,38,94,132,1
1464,연동365의원,63,69,132,1
2173,산이수동,69,62,131,1
1113,용운동,76,55,131,1
1165,화전마을,55,76,131,1
43,남주동,82,49,131,1
3585,동물개동산앞,64,67,131,1
2582,삼달교차로,70,61,131,1
3517,항몽유적지입구,73,57,130,1
2489,서광리,104,26,130,1
409,조천체육관,65,65,130,1
2133,강창학종합경기장,26,103,129,1
2072,효돈초등학교,53,76,129,1
195,함덕광명샤인빌앞,97,32,129,1
204,제대마을,8,120,128,1
2107,서귀포여자중학교,66,62,128,1
2812,성산농협,17,111,128,1
439,고성1리종합운동장,87,41,128,1
1839,대화동,47,80,127,1
408,조천만세동산,78,49,127,1
3365,용두암현대1차아파트,59,68,127,1
384,용담사거리,82,45,127,1
205,제대마을,126,1,127,1
2885,월평마을,71,55,126,1
349,이호동주민센터,115,11,126,1
2658,동부보건소,70,56,126,1
22,모감동,55,71,126,1
2058,(구)중문동주민센터,72,54,126,1
422,거로입구,48,77,125,1
2882,서건도,115,10,125,1
2778,"테디밸리골프앤리조트,헬로키티아일랜드",66,58,124,1
479,대림2차아파트,101,23,124,1
2569,표선리사거리,73,50,123,1
1232,남흘동,49,74,123,1
1210,한동리,52,71,123,1
3515,제주사대부설중학교,89,34,123,1
2610,고성오일시장,94,28,122,1
1379,관음사등산로입구,18,104,122,1
1743,법환초등학교,84,38,122,1
1642,우남동,73,48,121,1
1241,북촌리해동,31,90,121,1
1083,애월읍사무소,47,74,121,1
2005,상예입구,91,29,120,1
1088,신설동,71,49,120,1
3615,휴애리자연생활공원,68,52,120,1
146,제주국제대학교,54,66,120,1
1742,법환초등학교,51,69,120,1
491,도리초등학교,108,11,119,1
63,외도부영1차아파트,105,14,119,1
240,화북주공아파트,34,84,118,1
2888,비석거리,72,46,118,1
1932,토평마을회관,57,61,118,1
2811,성산농협,83,35,118,1
2141,안덕계곡,59,59,118,1
2134,숨비나리,70,48,118,1
1821,신효,39,78,117,1
3347,탐라광장,37,80,117,1
1146,판포리상동,97,20,117,1
2360,오조리입구,54,63,117,1
2694,동홍사거리,80,37,117,1
2884,월평마을,76,41,117,1
393,월성마을회관,25,91,116,1
2775,성박물관,45,71,116,1
2966,롯데시티호텔(600번),87,29,116,1
2398,성읍농협앞,78,38,116,1
5,이호2동,38,78,116,1
1961,오션팰리스호텔,55,60,115,1
2448,모슬포우체국,64,51,115,1
1461,신광사거리,19,96,115,1
62,우령마을입구,105,10,115,1
866,용수리충혼묘지,60,55,115,1
1075,자운당,68,46,114,1
211,인화동,43,71,114,1
2625,시흥리,32,82,114,1
84,수산리사무소앞,68,46,114,1
414,서해안로,27,87,114,1
623,백록초등학교,98,16,114,1
1158,고산1리(구출장소),26,87,113,1
2276,산방산,81,32,113,1
2695,동홍사거리,42,71,113,1
3072,회수마을회관,96,17,113,1
1233,남흘동,77,36,113,1
1114,용운동,55,58,113,1
463,해안동입구,68,45,113,1
2742,NLCS제주,3,110,113,1
1934,토평마을회관,69,44,113,1
3256,제주레일바이크,67,46,113,1
1914,서귀포향토오일시장,99,14,113,1
1728,강정초등학교,89,23,112,1
228,조천리새마을공장,63,48,111,1
1390,삼도119센터,52,59,111,1
641,외도부영1차아파트,10,101,111,1
434,노형초등학교,55,56,111,1
1161,고산,26,84,110,1
98,제주민속오일장입구,52,58,110,1
585,갈왓,104,6,110,1
626,정든마을,16,93,109,1
2741,NLCS제주,105,4,109,1
154,용천마을,91,18,109,1
3259,송당리마을,44,65,109,1
496,해안동입구,50,59,109,1
1236,동복리휴게소,50,59,109,1
209,서해아파트,83,25,108,1
23,번대동,73,35,108,1
2768,LH12단지,22,86,108,1
3232,토평사거리,5,103,108,1
30,내도동서마을,24,84,108,1
1257,남조로검문소,41,67,108,1
2635,서귀포자연휴양림,70,37,107,1
2730,충혼묘지광장,77,30,107,1
2647,수망가름,87,20,107,1
29,내도동서마을,86,21,107,1
1357,한라생태숲,55,52,107,1
1669,하원동,60,47,107,1
578,광평동로노형성당,50,56,106,1
1223,지경곰,50,56,106,1
1992,하예중동,92,14,106,1
2686,신양리,72,34,106,1
476,한라중학교/부영아파트,76,30,106,1
2209,수산2리비석거리,11,95,106,1
606,해오름아파트,26,80,106,1
2698,대포항,93,12,105,1
1176,하도리창흥동,77,28,105,1
314,사라봉,49,56,105,1
872,자운당,47,58,105,1
1971,서귀포중학교,64,41,105,1
1533,S중앙병원,44,60,104,1
229,조천읍사무소,53,51,104,1
2712,트릭아트뮤지엄,69,35,104,1
3164,돔뱅이왓,1,103,104,1
576,광평,61,43,104,1
259,동광초등학교,17,87,104,1
2883,서건도,13,91,104,1
1184,하도리면수동,55,48,103,1
2599,혼인지입구,85,18,103,1
1238,북촌다려마을,64,39,103,1
3480,하효마을다목적회관,8,95,103,1
421,거로입구,84,19,103,1
2655,남원1리사무소,56,47,103,1
451,대학동,59,44,103,1
2117,열린병원,65,37,102,1
158,보건소,27,75,102,1
260,동광초등학교,93,9,102,1
2004,상예입구,17,85,102,1
1388,이화아파트,53,49,102,1
3614,휴애리자연생활공원,57,45,102,1
870,판포리상동,27,75,102,1
2471,화순동취락지구,53,48,101,1
4064,명도암입구삼거리,44,57,101,1
1822,신효동,86,15,101,1
2646,수망사거리,23,78,101,1
2964,롯데시티호텔(600번),40,61,101,1
1077,애월119센터,45,56,101,1
1511,용해로,68,32,100,1
579,광평동로,74,26,100,1
3448,고산동산,55,45,100,1
700,하귀하나로마트,50,50,100,1
1449,카카오,33,66,99,1
2477,덕수초등학교,27,72,99,1
1938,주공아파트5단지,92,7,99,1
6100848,제주시외버스터미널,93,6,99,1
492,도리초등학교,24,75,99,1
2682,수산2리,90,8,98,1
2572,하천하동,75,23,98,1
3242,덕천리,33,65,98,1
3077,제주월드컵경기장,86,11,97,1
1848,망장포입구,62,35,97,1
6,노형주공아파트,9,88,97,1
2600,성산농협종합유통센터,73,24,97,1
1242,북촌리해동,72,24,96,1
2097,중문골프장,3,93,96,1
1750,삼매봉,3,92,95,1
1177,하도리창흥동,44,51,95,1
3069,공무원연금공단,46,49,95,1
1448,라마다프라자제주호텔,74,21,95,1
1237,북촌다려마을,55,40,95,1
577,광평,48,47,95,1
4011,김만덕기념관,51,44,95,1
2135,숨비나리,42,53,95,1
42,남주동,31,63,94,1
354,월랑초등학교,14,80,94,1
4062,백약이오름,49,45,94,1
475,한화아파트,31,63,94,1
1670,하원동,56,38,94,1
3632,제주월드컵경기장,35,59,94,1
1769,광대왓,55,38,93,1
688,신제주초등학교,77,16,93,1
1770,광대왓,19,74,93,1
876,문예회관,15,78,93,1
3326,탐라중학교,91,2,93,1
4084,신화역사공원,25,67,92,1
2611,고성오일시장,16,76,92,1
1160,고산우체국앞,67,25,92,1
3013,상천리,53,39,92,1
2488,보성초등학교,5,86,91,1
326,농협지역본부,25,66,91,1
2959,임항로,55,36,91,1
3109,생각하는정원,20,71,91,1
1076,고내리애월119센터,39,52,91,1
1393,화북휴먼시아,86,5,91,1
1576,금산목,51,40,91,1
1834,상원동,51,39,90,1
3436,용마로,36,54,90,1
1204,평대초등학교,1,89,90,1
3447,고산동산,16,73,89,1
157,보건소,61,28,89,1
4222,대정읍다목적회관,34,55,89,1
1949,서건도입구,34,55,89,1
2580,신풍리하동,48,41,89,1
328,제주중앙여자중학교,22,66,88,1
4055,송당리사무소,36,52,88,1
1575,영등물,47,41,88,1
2556,세화2리사무소,53,35,88,1
1383,삼도119센터,40,48,88,1
3220,동광육거리,65,23,88,1
1964,송산동주민센터,55,33,88,1
1098,금성리,54,34,88,1
32,내도동동마을,24,64,88,1
4,이호2동,58,29,87,1
2463,산방산,17,70,87,1
474,유수암상동,52,35,87,1
1103,사동복지회관,61,26,87,1
1630,메이즈랜드,56,31,87,1
1613,제주유리의성,73,14,87,1
1796,검은여입구,75,11,86,1
4010,김만덕기념관,16,70,86,1
3050,공무원연금공단,48,38,86,1
417,어영마을,16,70,86,1
2359,오조리,39,47,86,1
2281,서귀포자연휴양림,27,59,86,1
1370,방림원,26,60,86,1
2487,보성초등학교,78,7,85,1
2661,남원1리사무소,46,39,85,1
2605,성산읍사무소,48,37,85,1
1157,용수리,59,26,85,1
2106,서귀포여자중학교,44,41,85,1
1752,여의물,36,48,84,1
438,고성1리종합운동장,50,34,84,1
114,탑동입구,73,11,84,1
3300,신사동(기점),60,24,84,1
2490,서광리,22,62,84,1
3110,생각하는정원,73,11,84,1
416,어영마을,79,4,83,1
1510,용해로,35,48,83,1
3466,동광환승정류장(종점),3,80,83,1
1174,국학원,28,54,82,1
1797,검은여입구,23,59,82,1
2446,대정초교후문,18,64,82,1
2470,화순동취락지구,31,51,82,1
446,시티주유소,22,59,81,1
4203,대진유토피아,48,33,81,1
216,제주해양경찰서,18,63,81,1
2535,어촌계입구,46,35,81,1
2125,안덕계곡,48,33,81,1
3265,아부오름,23,58,81,1
3225,노리매,55,26,81,1
3429,대천환승정류장(종점),1,80,81,1
3624,삼무공원,73,8,81,1
1117,수원리,45,35,80,1
2732,하례2리입구,68,12,80,1
3636,서복전시관,26,54,80,1
473,유수암상동,51,29,80,1
3395,쇠소깍하효항입구,68,12,80,1
129,제주의료원,58,22,80,1
15,관전동,53,27,80,1
1504,한마음병원,25,55,80,1
3485,위미3리마을회관,52,28,80,1
2568,막상올레,49,31,80,1
418,몰래물,58,21,79,1
1109,귀덕2리,49,30,79,1
1099,하동복지회관,66,13,79,1
676,경제통상진흥원,70,9,79,1
1993,하예중동,14,65,79,1
2622,성산국민체육센터,35,44,79,1
2723,안덕면사무소,64,14,78,1
444,탐라도서관,19,59,78,1
425,화북초등학교,41,37,78,1
419,제주대학교교육대학,28,50,78,1
1612,제주유리의성,22,56,78,1
95,제주서중학교,46,32,78,1
2534,폭낭사거리,35,43,78,1
3255,제주레일바이크,38,40,78,1
868,구한경의원앞,28,50,78,1
317,신제주초등학교,33,45,78,1
1252,봉개체육공원,54,24,78,1
2548,산여리통입구,34,44,78,1
452,대학동,36,41,77,1
1159,고산1리(구출장소),69,8,77,1
1866,위미3리마을회관,32,45,77,1
1806,보목신협,75,2,77,1
2130,창천초등학교,5,72,77,1
2395,성읍1리,45,32,77,1
17,연대마을,41,36,77,1
116,남국사,38,39,77,1
4154,왕대왓,43,34,77,1
2074,신협,61,15,76,1
309,사라봉오거리,12,64,76,1
3238,"제주현대미술관,김창열미술관",43,33,76,1
208,서해아파트,16,60,76,1
1847,망장포입구,32,44,76,1
1462,연동365의원,42,34,76,1
1840,서성동,55,21,76,1
2627,시흥리사무소,44,32,76,1
1751,여의물,39,37,76,1
1042,남조로검문소,37,39,76,1
3497,정혜재활원,49,27,76,1
2951,와산리경로당,46,29,75,1
214,인화동입구,40,35,75,1
215,인화동입구,39,36,75,1
3500,"거슨새미오름,안돌오름",38,37,75,1
1820,앞동산,15,60,75,1
869,신창중학교,21,54,75,1
1423,송당물혹,41,34,75,1
412,용담레포츠공원,58,17,75,1
4015,봉개초등학교,25,50,75,1
3245,환상숲곶자왈공원,56,19,75,1
1788,농협보목지소,70,5,75,1
2533,태흥초등학교,44,31,75,1
1937,L마트,14,60,74,1
2380,표선초등학교,21,53,74,1
2544,수농원,39,35,74,1
1589,번대동,49,25,74,1
1244,911의원,21,53,74,1
4155,왕대왓,57,17,74,1
1169,렛츠런파크,40,34,74,1
1826,종보존연구센터,24,49,73,1
3501,"거슨새미오름,안돌오름",18,55,73,1
1107,귀덕새마을금고,51,22,73,1
478,대림2차아파트,16,57,73,1
1384,이화아파트,61,12,73,1
2218,고성리노인회관,44,29,73,1
2950,와산리경로당,53,20,73,1
2626,시흥리사무소,24,49,73,1
871,곽지모물,10,63,73,1
1413,일성콘도미니엄,32,41,73,1
2673,수악교,25,48,73,1
3586,동물개동산앞,63,10,73,1
1424,송당물혹,37,36,73,1
1627,애월하나로마트,7,66,73,1
14,비석동,24,48,72,1
2027,수모루,42,30,72,1
1865,신성동,42,30,72,1
927,저지오름,24,48,72,1
3239,"제주현대미술관,김창열미술관",28,44,72,1
253,대림아파트,50,22,72,1
220,원당봉,58,14,72,1
2856,소보리당,37,35,72,1
2525,씨사이드홈,18,54,72,1
1447,라마다프라자제주호텔,12,60,72,1
2755,모슬포항,55,16,71,1
2450,상모3리,63,8,71,1
1927,평안전문요양원,22,48,70,1
899,송당초등학교,43,27,70,1
1167,국학원,37,33,70,1
2623,성산국민체육센터,46,24,70,1
2977,하귀하나로마트,11,59,70,1
3073,회수마을회관,16,54,70,1
1255,전원마을,40,29,69,1
1392,화북휴먼시아,8,61,69,1
2358,성산고입구삼거리,34,35,69,1
1805,보목신협앞,24,45,69,1
2451,상모리감협,26,43,69,1
1629,붉은오름휴양림입구,49,20,69,1
2554,가마초등학교,35,34,69,1
1110,귀덕2리,37,31,68,1
2452,상모리감협,53,15,68,1
2449,상모2리,12,56,68,1
1844,신례2리교차로,33,35,68,1
4041,브릭캠퍼스,7,61,68,1
3574,번대동,27,41,68,1
3622,진양빌라,2,66,68,1
35,현사마을,11,56,67,1
2573,하천하동,27,40,67,1
1942,강정천,50,17,67,1
2507,구억리삼거리,34,33,67,1
1082,애월읍사무소,31,36,67,1
1108,귀덕새마을금고,23,44,67,1
18,연대마을,32,35,67,1
1185,하도리면수동,40,26,66,1
2060,어두모루,49,17,66,1
3283,대정환승정류장(대정읍사무소),39,27,66,1
256,대유대림아파트,33,32,65,1
1017,덕천리,45,20,65,1
2474,덕수리동동,44,21,65,1
213,일도2동주민센터,35,30,65,1
254,대림아파트,43,22,65,1
693,봉개워터파크,26,39,65,1
420,제주대학교교육대학,38,26,64,1
2514,서광서리,48,16,64,1
2835,남원취락구조,29,35,64,1
1867,위미3리,43,21,64,1
1950,서건도입구,43,21,64,1
3611,국제교회,34,30,64,1
928,저지오름,38,26,64,1
3236,제주항공우주박물관,27,37,64,1
1864,신성동,26,38,64,1
2136,상창리사무소,25,39,64,1
2086,공업단지입구,26,37,63,1
1118,수원리,30,33,63,1
2087,공업단지입구,27,36,63,1
3450,제주소방서,37,26,63,1
639,대동마을,22,41,63,1
755,한경면사무소,9,54,63,1
2604,성산읍사무소,26,37,63,1
2403,성읍2리,27,36,63,1
3451,삼양파출소사거리,39,24,63,1
2834,남원취락구조,29,34,63,1
622,백록초등학교,10,52,62,1
2375,표선고등학교,52,10,62,1
2857,상원동,32,30,62,1
1948,고향모루,49,13,62,1
1828,세천동,33,29,62,1
1178,하도리동동,19,43,62,1
3610,국제교회,36,26,62,1
860,구좌보건소,14,48,62,1
2566,표선파출소,19,42,61,1
41,안남동,20,41,61,1
130,제주의료원,18,43,61,1
1935,영천동주민센터,27,34,61,1
3269,종달항,11,50,61,1
111,산지변전소,12,49,61,1
2397,성읍1리,12,49,61,1
1171,제주공룡원,43,17,60,1
1726,강정농협,16,44,60,1
437,고성1리사무소,56,4,60,1
1878,돈내코,2,58,60,1
3391,맹살공원,14,46,60,1
2553,가마초등학교,24,36,60,1
353,월랑초등학교,41,19,60,1
1434,제주국제대학교,4,56,60,1
239,봉개동주민센터,26,34,60,1
2585,희진주유소,39,21,60,1
4054,고산문화의집,34,25,59,1
1472,제주여자중고등학교,2,57,59,1
2880,동모루왓,40,19,59,1
2217,고성리노인회관,32,27,59,1
1394,축산진흥원입구,37,22,59,1
2443,대정읍사무소,23,36,59,1
2542,신흥교차로,35,24,59,1
1966,서귀포중학교,40,19,59,1
2898,도련초등학교,12,47,59,1
1941,강정천,30,29,59,1
1151,구한경의원앞,39,20,59,1
2991,김영갑갤러리두모악,13,46,59,1
711,항몽유적지,23,35,58,1
2509,구억리상동,29,29,58,1
1735,공물,45,13,58,1
1782,서귀중앙여자중학교,22,36,58,1
2724,안덕면사무소,6,52,58,1
1686,농업기술원,48,10,58,1
3206,제주항공우주박물관,21,37,58,1
3584,배튼개입구,28,30,58,1
2547,산여리통입구,45,13,58,1
1578,별빛누리공원/난타공연장,19,39,58,1
2536,어촌계입구,26,32,58,1
2577,신천리취락구조,36,22,58,1
3226,소인국테마파크,15,42,57,1
1734,공물,31,26,57,1
3623,진양빌라,56,1,57,1
603,삼양종점,51,6,57,1
1190,구좌보건소,24,33,57,1
1097,금성리,22,35,57,1
640,대동마을,37,20,57,1
251,신설동,28,29,57,1
749,조수리,33,24,57,1
1377,별빛누리공원/난타공연장,54,3,57,1
1414,일성콘도미니엄,50,7,57,1
1571,제주국제대학교,49,8,57,1
3583,배튼개입구,39,17,56,1
2720,표선허브동산,24,32,56,1
839,선인동,23,33,56,1
1741,뒷동산,35,21,56,1
2516,서광서리사수동,19,37,56,1
462,무수천,30,26,56,1
1829,세천동,31,25,56,1
78,사평마을,23,33,56,1
2035,파인힐호텔,6,49,55,1
3240,선녀와나무꾼,34,21,55,1
2037,제석공원,26,29,55,1
87,세기아파트,27,28,55,1
1105,초록마을,34,21,55,1
1827,종보존연구센터,33,22,55,1
1452,도평입구,31,24,55,1
1527,4.3평화공원,51,4,55,1
2715,문화마을,25,30,55,1
1698,동남아파트,19,36,55,1
2394,성읍1리,30,24,54,1
1066,교래리보건소,34,20,54,1
77,사평마을,38,16,54,1
1916,측골,9,45,54,1
2595,온평리,32,22,54,1
1262,제주목장,36,18,54,1
1483,제주삼양동유적,53,1,54,1
1503,한마음병원,36,18,54,1
2437,대수동,33,21,54,1
2002,예래동주민센터,6,48,54,1
2202,물진밭입구,45,8,53,1
3421,한림체육관,34,19,53,1
1947,고향모루,24,29,53,1
1825,서귀포시중앙도서관,26,27,53,1
983,봉성하나로마트,41,12,53,1
832,만장굴,6,47,53,1
3452,삼양파출소사거리,7,46,53,1
261,연수마을,41,12,53,1
40,안남동,38,15,53,1
670,이도2동행정복지센터,9,44,53,1
2436,대수동,16,36,52,1
1415,수원주유소,17,35,52,1
4185,약천사(출발지),49,3,52,1
2061,어두모루,15,37,52,1
262,제주학생문화원,26,26,52,1
2588,신산리,19,33,52,1
1179,하도리동동,25,27,52,1
4020,제주장애인요양원,27,25,52,1
2001,정문동,2,50,52,1
3051,국세공무원교육원생활관,25,27,52,1
3437,용마로,19,32,51,1
1783,서귀중앙여자중학교,34,17,51,1
155,삼도1동주민센터,10,41,51,1
3455,동문성당,5,46,51,1
2555,세화2리사무소,22,29,51,1
1915,서귀포향토오일시장,4,47,51,1
2735,대정초등학교,39,12,51,1
255,대유대림아파트,43,8,51,1
46,큰구릉내,29,22,51,1
80,연미마을입구,18,33,51,1
1353,한라도서관,37,14,51,1
2396,성읍1리,47,4,51,1
1644,예래사우나,33,18,51,1
522,새가름,12,39,51,1
3251,둔지오름,21,30,51,1
2638,1100고지휴게소,22,28,50,1
4051,위미3리,25,25,50,1
2848,서귀포보건소,19,31,50,1
2457,사계리서동,35,15,50,1
79,동성마을입구,27,23,50,1
83,수산리사무소앞,15,35,50,1
1465,한국BMI,17,32,49,1
1697,삼주연립주택,19,30,49,1
75,오라1동,20,29,49,1
350,이호동주민센터,19,30,49,1
3205,제주항공우주박물관,35,14,49,1
2518,서광동리마을,30,19,49,1
3042,모슬포항,6,43,49,1
847,대흘2리,42,7,49,1
1152,신창리한경수협,31,18,49,1
1789,함덕골,11,38,49,1
1626,애월하나로마트,46,3,49,1
3625,삼무공원,14,34,48,1
3214,차귀포구,28,20,48,1
548,아라초등학교,22,26,48,1
1832,뒤통모루,22,26,48,1
413,용담레포츠공원,12,36,48,1
1491,함덕농협주유소,8,40,48,1
1731,수모루,11,37,48,1
140,영주고등학교,18,30,48,1
2621,성산고입구삼거리,18,30,48,1
4035,용마마을,4,44,48,1
2858,원물오름,26,22,48,1
3053,서귀포시중앙도서관,28,20,48,1
2028,제석공원,15,33,48,1
3248,선녀와나무꾼,32,16,48,1
1112,라신동,32,15,47,1
1714,월평아왜낭목,43,4,47,1
1594,다희연,28,19,47,1
110,산지변전소,33,14,47,1
3390,효돈농협하나로마트,32,15,47,1
2584,희진주유소,24,23,47,1
2116,열린병원,9,38,47,1
3260,송당리마을,35,12,47,1
49,외도부영2차아파트,13,33,46,1
2838,이교동삼거리,21,25,46,1
1104,사동복지회관,21,25,46,1
2277,안성리,25,21,46,1
3082,중흥/골드클래스아파트,8,38,46,1
1106,초록마을,14,32,46,1
2400,성읍1리,15,31,46,1
1970,칼호텔,18,28,46,1
219,원당분화원,7,39,46,1
2565,표선오일시장,11,35,46,1
1433,제주국제자유도시개발센터,39,7,46,1
3078,제주월드컵경기장서문,5,40,45,1
2988,동복리관광체험어장,1,44,45,1
2425,신도1리,21,24,45,1
2447,진개동산,26,19,45,1
3178,국세공무원교육원생활관,19,26,45,1
2426,신도1리,23,22,45,1
1780,동덕아파트,38,7,45,1
1218,행원농공단지,27,18,45,1
469,원동,28,17,45,1
680,주르레마을,40,5,45,1
1512,도두동,10,35,45,1
348,이호동동마을,8,37,45,1
1443,하귀휴먼시아입구,4,41,45,1
1833,뒤통모루,29,16,45,1
470,원동,16,28,44,1
1261,교래리,26,18,44,1
1811,삼성여자고등학교,19,25,44,1
2445,대정초교후문,37,7,44,1
2614,신양리입구,20,24,44,1
1385,사라봉경로당입구,17,27,44,1
1824,월라봉,15,29,44,1
1471,제주여자중고등학교제주지방해양경찰청,32,12,44,1
2557,가흥동,15,29,44,1
1739,법환새마을금고,31,13,44,1
3514,제주관광대학(가상),42,2,44,1
2980,용담어린이집,33,11,44,1
3244,환상숲곶자왈공원,5,39,44,1
1019,선흘1리,33,11,44,1
50,외도부영2차아파트,32,11,43,1
2767,LH12단지,32,11,43,1
2985,삼화부영1차아파트,32,11,43,1
2462,사계리동동,9,34,43,1
2581,신풍리하동,26,17,43,1
2531,무도동,33,10,43,1
1016,하덕천,20,23,43,1
1792,동부하수처리장입구,39,4,43,1
1416,수원주유소,26,17,43,1
1155,두모리사무소,7,36,43,1
1981,고갠드르,32,10,42,1
2779,표선도서관,1,41,42,1
1628,붉은오름휴양림입구,12,30,42,1
2692,감산입구,28,14,42,1
94,제주서중학교,21,21,42,1
1172,산이굴,23,19,42,1
2265,거물여,26,16,42,1
604,삼양1동,38,4,42,1
139,영주고등학교,31,11,42,1
762,조수1리,22,20,42,1
3363,사대부고,10,32,42,1
831,송당상동,13,28,41,1
1111,라신동,16,25,41,1
1854,만지동,40,1,41,1
1284,더럭초등학교,34,7,41,1
4237,칠십리음식특화거리,16,25,41,1
1663,상예2동,18,23,41,1
677,이도2동행정복지센터,35,6,41,1
500,제주제일고등학교,25,16,41,1
994,상가리보건진료소,35,6,41,1
3012,상천리,21,20,41,1
1131,한수리,19,22,41,1
1132,한수리,12,29,41,1
1455,한일베라체,7,34,41,1
2786,진우파크빌,19,21,40,1
3074,법화사사거리,38,2,40,1
375,도련1동,39,1,40,1
76,오라1동,29,11,40,1
3307,스위스마을입구,11,29,40,1
2475,덕수리동동,5,35,40,1
1793,동부하수처리장입구,9,31,40,1
1296,더럭초등학교,4,36,40,1
1170,고성2리,35,5,40,1
1263,제주목장,14,26,40,1
602,삼양종점,7,32,39,1
1451,도평입구,27,12,39,1
2559,한지동,23,16,39,1
3510,NHF삼화1단지,30,9,39,1
2696,(구)중앙파출소,10,29,39,1
1050,거문오름입구,1,38,39,1
1245,1100고지휴게소,21,18,39,1
2666,의귀교회앞,38,1,39,1
2022,향토오일시장,13,26,39,1
2560,한지동,20,19,39,1
3139,동백동산습지센터,23,15,38,1
1154,두모리사무소,30,8,38,1
1544,화북휴먼시아정문,9,29,38,1
671,경제통상진흥원,2,36,38,1
458,광령1리사무소,24,14,38,1
1664,상예2동,14,24,38,1
2515,서광서리,20,18,38,1
2981,용담어린이집,14,24,38,1
2249,안성리사무소앞,8,30,38,1
1183,하도초등학교,8,30,38,1
2894,삼화지구,31,7,38,1
1371,방림원,35,3,38,1
1795,라임오렌지빌,36,2,38,1
1823,월라봉,26,12,38,1
3617,예래오마트,35,3,38,1
2517,서광서리사수동,34,4,38,1
2716,표선허브동산,23,15,38,1
4147,유수암상동경로당,15,22,37,1
3435,용화로,6,31,37,1
2424,신도3리,12,25,37,1
681,주르레마을,9,28,37,1
388,병문교,7,30,37,1
2115,보목포구(도착),13,24,37,1
840,선인동,26,11,37,1
138,사회복지법인춘강,10,27,37,1
1397,구산마을,31,6,37,1
4059,백약이오름,22,15,37,1
964,미듬아파트,9,28,37,1
1798,칼호텔,18,19,37,1
1799,효성빌라,21,16,37,1
675,한라일보,14,23,37,1
2453,상모리이교동,23,13,36,1
1808,상효입구,15,21,36,1
2126,감산리,12,24,36,1
2745,차남동산,17,19,36,1
2441,동일1리,16,20,36,1
3141,이도초등학교,21,15,36,1
407,주암주택,26,10,36,1
2031,파인힐호텔,35,1,36,1
3140,동백동산습지센터,18,18,36,1
1623,월정리용천동,20,16,36,1
2421,입석동,15,21,36,1
2538,태흥3리사무소,8,28,36,1
497,제주아트리움,16,20,36,1
2030,서귀포초등학교,31,4,35,1
682,하귀2리,32,3,35,1
2532,무도동,10,25,35,1
457,광령1리사무소,8,27,35,1
1018,선흘,9,26,35,1
347,이호동동마을,33,2,35,1
1654,대천동주민센터,17,18,35,1
1163,고산1리육거리,16,19,35,1
2492,동광문화마을,19,16,35,1
1781,서귀포고등학교,10,25,35,1
376,도련1동,4,31,35,1
1041,동회천,32,3,35,1
4124,청수리사거리,10,25,35,1
1150,금등리마을,16,19,35,1
1474,하도리서문동,7,28,35,1
3222,제주항공우주호텔,16,18,34,1
627,몰래물,14,20,34,1
3237,제주항공우주박물관,18,16,34,1
2128,창천리남당물동산,18,16,34,1
1049,거문오름입구,1,33,34,1
1843,농협주유소,22,12,34,1
3083,중흥/골드클래스아파트,26,8,34,1
4165,하효고막곶,32,2,34,1
3491,사려니마을,18,16,34,1
1526,4.3평화공원,2,32,34,1
1326,알밤오름,10,24,34,1
3100,이도초등학교,20,13,33,1
3243,종달항,30,3,33,1
1842,신례2리교차로,13,20,33,1
1460,거로사거리,27,6,33,1
965,미듬아파트,28,5,33,1
1502,탐라중학교,29,4,33,1
2601,성산농협종합유통센터,3,30,33,1
843,선흘2리,32,1,33,1
2896,오름중학교,24,9,33,1
668,민오름,17,16,33,1
1528,청소년수련원,32,1,33,1
2594,온평리,8,25,33,1
3014,서귀포보건소,26,7,33,1
3058,안덕119센터,8,25,33,1
2503,신평리,17,16,33,1
1264,교래리,18,15,33,1
243,화북주공아파트입구,28,5,33,1
2007,파라다이스호텔입구,30,3,33,1
3389,효돈농협하나로마트,12,21,33,1
8,못가름,27,6,33,1
252,신설동,13,20,33,1
796,조수1리,25,7,32,1
1525,청소년수련원,4,28,32,1
1048,선흘2리입구,13,19,32,1
88,세기아파트,7,25,32,1
2283,법정사입구,13,19,32,1
1149,금등리마을,23,9,32,1
3166,보목포구(출발),26,6,32,1
298,부록마을,17,15,32,1
1855,만지동,5,27,32,1
1936,영천동주민센터,22,10,32,1
3197,위미2리교차로,14,18,32,1
513,평화로광령1리입구,17,15,32,1
2831,진군을리,27,4,31,1
1800,효성빌라,6,25,31,1
848,대흘2리새동네,1,30,31,1
1022,낙선동,16,15,31,1
3199,무릉리(사장동),29,2,31,1
2881,동모루왓,2,29,31,1
2029,서귀포YWCA,22,9,31,1
769,저지리수동,25,6,31,1
4224,화순금모래해수욕장,12,19,31,1
982,봉성하나로마트,11,20,31,1
177,문서교,21,10,31,1
2564,표선오일시장,16,15,31,1
1535,새마을금고연수원,21,10,31,1
1256,초록마을,18,13,31,1
2068,호근사거리,15,16,31,1
2033,천지연폭포입구,2,29,31,1
1456,한일베라체,25,6,31,1
197,신사동,3,28,31,1
2003,예래동주민센터,20,10,30,1
4024,승천로,28,2,30,1
2984,도련초등학교,28,2,30,1
1913,동홍동청소년문화의집,28,2,30,1
3419,신산로,14,16,30,1
2620,성산고입구삼거리,4,26,30,1
4127,용수리마을회관,8,22,30,1
1363,도깨비공원,2,28,30,1
2371,하천리마을입구,15,15,30,1
1243,911의원,21,9,30,1
967,한림오일시장,17,13,30,1
404,충혼묘지,16,14,30,1
258,신천동,8,22,30,1
1484,제주삼양동유적,1,29,30,1
2571,하천리취락구조,11,19,30,1
2526,씨사이드홈,12,18,30,1
1543,근로복지공단,22,7,29,1
2574,신천리,19,10,29,1
2442,동일1리,21,8,29,1
2527,진은동,3,26,29,1
1000,용흥리,26,3,29,1
1945,서년듸,21,8,29,1
1926,평안전문요양원,25,4,29,1
2781,달산봉입구,8,21,29,1
555,월평마을,18,11,29,1
1381,삼담우체국,2,27,29,1
2628,영실입구,7,22,29,1
3496,용운사,15,14,29,1
3616,예래오마트,3,26,29,1
512,평화로광령1리입구,14,15,29,1
667,민오름,19,10,29,1
3111,저지리중동,12,17,29,1
3123,하도리서문동,15,14,29,1
3362,사대부고,25,4,29,1
712,항몽유적지,19,10,29,1
1168,렛츠런파크,12,17,29,1
1656,도순동,16,13,29,1
862,하도리서문동,18,11,29,1
118,웃인다마을,14,15,29,1
2836,주공6단지,9,20,29,1
2709,일출랜드입구,3,26,29,1
1034,대흘1리,12,16,28,1
2429,무릉1리학교앞,16,12,28,1
906,청수리,22,6,28,1
329,제주중앙여자중학교,14,14,28,1
2404,성읍2리,20,8,28,1
2983,삼화초등학교,24,4,28,1
484,신사수동,26,2,28,1
930,저지리,16,12,28,1
3522,첨단로8길,26,2,28,1
1500,제주영지학교,13,15,28,1
3521,첨단로8길,1,27,28,1
898,산남내,8,20,28,1
119,죽성마을입구,12,16,28,1
1387,사라봉경로당입구,10,18,28,1
1812,삼성여자고등학교,14,14,28,1
3120,각시물,22,6,28,1
3406,감귤박물관,16,12,28,1
2491,동광리,13,15,28,1
1683,용흥동,19,9,28,1
1268,초록마을,14,14,28,1
1316,동회천,6,22,28,1
662,월평마을,13,15,28,1
2537,태흥3리사무소,26,2,28,1
2619,오조리상동입구,19,9,28,1
242,화북주공아파트입구,7,21,28,1
2071,용당,16,12,28,1
2575,신천리,13,14,27,1
1116,대림입구,15,12,27,1
2159,동광단지,19,8,27,1
1276,견월교,19,8,27,1
3183,한라산둘레길,10,17,27,1
2529,서소동,19,8,27,1
1738,법환새마을금고,8,19,27,1
672,한라일보,8,19,27,1
1667,지세못,20,7,27,1
498,제주아트리움,17,10,27,1
3487,첨단꿈에그린2단지아파트,9,18,27,1
633,도평마을입구,24,3,27,1
2685,신양리,13,14,27,1
3180,독벌은이동산,13,14,27,1
2232,성읍1리,13,14,27,1
477,한라초등학교,4,23,27,1
2641,수악교,7,20,27,1
3059,안덕119센터,19,8,27,1
3444,명월리사무소,7,20,27,1
3071,삼다체육공원입구,6,21,27,1
2219,그린카센터,15,12,27,1
1680,염돈동,9,18,27,1
117,남국사,11,15,26,1
2473,덕수리군물왓,11,15,26,1
550,영평상동마을회관,23,3,26,1
2454,상모리이교동,8,18,26,1
144,양지(추모)공원,13,13,26,1
1727,강정초등학교,16,10,26,1
3426,고산환승정류장(종점),11,15,26,1
996,하가리오당빌레,20,6,26,1
1459,거로사거리,8,18,26,1
2025,큰솔동산,12,14,26,1
1733,주거물,19,7,26,1
2251,대정농공단지입구,13,13,26,1
1720,이천장물,7,19,26,1
1684,용흥동,11,15,26,1
2070,용당,15,11,26,1
3483,보목동동네,19,7,26,1
405,충혼묘지,6,20,26,1
2290,가시농협,11,15,26,1
3400,하효마을회관,4,22,26,1
3223,제주항공우주호텔,19,7,26,1
1885,법호촌온성학교,15,11,26,1
3075,법화사사거리,5,21,26,1
702,금악리,13,13,26,1
2897,삼화부영1차아파트,12,14,26,1
1052,성연목장,8,17,25,1
1005,장전리사무소,14,11,25,1
2370,하천리마을입구,16,9,25,1
199,제주모자원입구,14,11,25,1
2430,무릉1리리사무소앞,11,14,25,1
237,명도암입구,7,18,25,1
2440,대정서초등학교,22,3,25,1
1637,캐슬렉스골프클럽,11,14,25,1
2785,진우파크빌,17,8,25,1
3061,제주조각공원입구,14,11,25,1
594,매촌,13,12,25,1
879,남조로검문소,24,1,25,1
3352,농림축산검역본부,4,21,25,1
1499,제주영지학교,13,12,25,1
3048,대포동,15,10,25,1
3405,앞동산,8,17,25,1
2069,호근새마을금고,15,9,24,1
3056,국세공무원교육원국토교통부인재개발원,16,8,24,1
929,저지남동,9,15,24,1
4056,수산체육공원입구,3,21,24,1
3184,서귀포항입구,18,6,24,1
1156,신흥동,21,3,24,1
610,함덕5구,19,5,24,1
3543,제일교,3,21,24,1
2640,사리물,15,9,24,1
4226,서광서리3교차로,2,22,24,1
1422,삼남내,19,5,24,1
2875,송악펜션단지,19,5,24,1
2893,삼화지구,9,15,24,1
2801,수산2리생태체험센터,19,5,24,1
1711,머구낭동산,8,16,24,1
1994,예래동가동거리,22,2,24,1
107,수선화아파트,19,5,24,1
3200,무릉리(사장동),5,19,24,1
968,대림사거리,13,11,24,1
1841,농협주유소,7,17,24,1
547,제주교통방송아라아이파크,18,6,24,1
1807,상효입구,13,11,24,1
1273,견월교,4,20,24,1
3407,감귤박물관,12,12,24,1
143,양지(추모)공원,8,16,24,1
3068,국세공무원교육원국토교통부인재개발원,6,18,24,1
3046,새서귀초등학교,8,15,23,1
3392,맹살공원,16,7,23,1
1906,토평초등학교,9,14,23,1
4094,지경동산,13,10,23,1
3227,소인국테마파크,9,14,23,1
1907,토평초등학교,18,5,23,1
4229,서광서리3교차로,4,19,23,1
333,남광로입구,8,15,23,1
2497,감산리서동,7,16,23,1
1980,동문,16,7,23,1
1246,한라산둘레길(천아숲길입구),4,19,23,1
2968,관음사,2,21,23,1
1372,저지리신흥동,6,17,23,1
993,하가입구,10,13,23,1
3254,다랑쉬오름입구(북),12,11,23,1
3527,아라초등학교,7,16,23,1
987,납읍리,7,16,23,1
3505,홍수암,9,14,23,1
997,하가리오당빌레,7,16,23,1
3492,사려니마을,9,14,23,1
2546,송천교,13,10,23,1
1457,거로사거리,2,21,23,1
1004,장전알동네,22,1,23,1
2807,관광단지입구,4,19,23,1
2813,송악도서관,13,10,23,1
523,새가름,19,4,23,1
3323,영산홍아파트,1,22,23,1
936,이시돌삼거리,18,5,23,1
3263,제주평화박물관,11,12,23,1
2852,제주해안경비단,12,11,23,1
1756,서호북문,11,11,22,1
2530,서소동,7,15,22,1
2275,안덕초등학교,17,5,22,1
4125,청수리사거리,17,5,22,1
3620,예래생태체험관,1,21,22,1
995,상가리동동,20,2,22,1
1432,제주국제자유도시개발센터,8,14,22,1
406,주암주택,5,17,22,1
25,하귀리,8,14,22,1
1495,한라도서관입구,4,18,22,1
2508,구억리상동,7,15,22,1
551,영평동,18,4,22,1
3334,민속자연사박물관,4,18,22,1
746,알진오름입구,17,5,22,1
1453,부민장례식장,5,17,22,1
212,일도2동주민센터,11,11,22,1
3566,한림체육관,6,16,22,1
601,동회천,4,18,22,1
3253,다랑쉬오름입구(북),13,9,22,1
907,청수리,10,12,22,1
1868,서귀포산업과학고등학교,16,6,22,1
1289,와산삼거리,7,15,22,1
459,제일빌리지,11,11,22,1
1831,대원상동,9,12,21,1
257,신천동,20,1,21,1
1173,고성2리,10,11,21,1
1586,환경시설관리소,13,8,21,1
1217,행원농공단지,7,14,21,1
3231,동광단지,6,15,21,1
1608,더마파크,13,8,21,1
2618,오조리상동입구,9,12,21,1
3449,고산동산,5,16,21,1
2238,영락리,4,17,21,1
1327,알밤오름,9,12,21,1
2740,하모체육공원,9,12,21,1
2782,달산봉입구,10,11,21,1
2726,산방산,4,17,21,1
2725,화순문화마을,7,14,21,1
2606,오조리하동,15,6,21,1
937,금악리,17,4,21,1
176,문서교,5,16,21,1
3021,서귀포초등학교,6,15,21,1
1033,대흘1리,19,2,21,1
873,금붕사,5,16,21,1
775,산양곶자왈,2,19,21,1
1689,월산동,8,13,21,1
1317,고산1리육거리,9,11,20,1
2099,색달,4,16,20,1
1286,하가리연못,14,6,20,1
485,신사수동,7,13,20,1
3621,예래생태체험관,19,1,20,1
340,한마음근린공원,5,15,20,1
3325,탐라중학교,3,17,20,1
3434,용화로,7,13,20,1
2708,일출랜드입구,14,6,20,1
1006,알뱅듸왓,5,15,20,1
332,이도주공아파트,17,3,20,1
2994,위미농협하례지소,14,6,20,1
2639,올리수,5,15,20,1
51,도평초등학교,12,8,20,1
2170,좌기동,5,15,20,1
3355,제주동여자중학교,10,10,20,1
4113,제주세계자연유산센터입구,1,19,20,1
3330,광령2리,8,12,20,1
3065,서광동리웃네거리,11,9,20,1
1182,하도초등학교,12,8,20,1
1609,더마파크,13,7,20,1
798,낙천리,13,7,20,1
3182,삼달2리사무소,16,4,20,1
3495,남용통상,11,9,20,1
3349,고산1리,15,4,19,1
4063,아부오름,6,13,19,1
2592,화성농장,17,2,19,1
2706,수산2리입구,14,5,19,1
761,낙천리,13,6,19,1
3093,교래분교,14,5,19,1
716,소길리사무소,12,7,19,1
4146,제주이야기,2,17,19,1
4236,향토오일시장,15,4,19,1
2733,오설록,3,16,19,1
1716,월평알동네,17,2,19,1
1444,하귀휴먼시아1단지,2,17,19,1
1581,전경대입구,18,1,19,1
1542,근로복지공단,9,10,19,1
1373,신흥동,17,2,19,1
1614,제주평화양로원,11,8,19,1
1562,전국환경감시협회,5,14,19,1
1912,동홍동청소년문화의집,5,14,19,1
1501,탐라중학교,3,16,19,1
2422,입석동,9,10,19,1
1534,새마을금고연수원,7,12,19,1
2483,인향동입구,17,2,19,1
3241,한울랜드,7,11,18,1
543,정실오거리,15,3,18,1
2607,오조리하동,3,15,18,1
2788,수산1리사거리,11,7,18,1
2250,대정농공단지입구,5,13,18,1
1632,한림천주교회,12,6,18,1
549,영평상동마을회관,3,15,18,1
338,혜성무지개타운,13,5,18,1
1479,가시나물,10,8,18,1
3333,민속자연사박물관,12,6,18,1
999,용흥리,3,15,18,1
3028,사계어촌체험어장,12,6,18,1
3592,강정새마을금고,7,11,18,1
385,용담새마을금고,17,1,18,1
1007,알뱅듸왓,16,2,18,1
1008,장전리동가름,5,13,18,1
1982,남문,13,5,18,1
728,명월하동,17,1,18,1
1713,월평아왜낭목,12,6,18,1
1692,신시가지,7,11,18,1
4073,해양경찰청제주수련원,10,8,18,1
3084,대신중학교,3,15,18,1
4172,체육공원입구,2,16,18,1
1830,대원상동,9,9,18,1
1857,사가동,14,4,18,1
3138,농림축산검역본부,11,7,18,1
1760,용천사입구,13,4,17,1
1679,염돈,10,7,17,1
842,선흘2리,7,10,17,1
1757,서호북문,10,7,17,1
74,보건소,15,2,17,1
3361,영락교회,15,2,17,1
1737,신세계빌라,14,3,17,1
2179,상천리사무소,11,6,17,1
3147,체오름,15,2,17,1
336,제주제일중학교,15,2,17,1
335,제주제일중학교,5,12,17,1
977,귀덕3리,6,11,17,1
2401,바스메,5,12,17,1
2669,"남원읍충혼묘지,물영아리",10,7,17,1
581,오광로,16,1,17,1
1038,와흘,9,8,17,1
2543,수농원,10,7,17,1
2034,서귀포항,1,16,17,1
788,한장동,12,5,17,1
1687,농업기술원,4,13,17,1
2204,삼달1리삼달보건진료소,9,8,17,1
2693,감산입구,11,6,17,1
1440,하귀휴먼시아입구,16,1,17,1
2545,송천교,11,6,17,1
804,산남내,7,10,17,1
865,용당리,10,7,17,1
456,광령초등학교,15,2,17,1
745,알진오름입구,2,15,17,1
2273,일과2리서림수원지입구,6,11,17,1
1921,답다니,3,14,17,1
3085,대신중학교,10,7,17,1
801,신창리농산물종합유통센터,9,8,17,1
4089,지경동산,10,7,17,1
1115,대림입구,11,6,17,1
1920,답다니,6,11,17,1
2124,감산리,8,9,17,1
2876,송악펜션단지,4,13,17,1
1191,세화고등학교,3,14,17,1
4065,명도암입구삼거리,8,9,17,1
2484,신평리,9,8,17,1
1374,용수리마을회관,13,4,17,1
86,수산리,3,13,16,1
731,명월리,15,1,16,1
1736,신세계빌라,7,9,16,1
2675,온평초등학교,1,15,16,1
1290,제일농장,11,5,16,1
1009,장전리동가름,11,5,16,1
634,도평동,6,10,16,1
1886,법호촌온성학교,10,6,16,1
2802,수산2리생태체험센터,7,9,16,1
2024,큰솔동산,10,6,16,1
2978,성화마을회관,11,5,16,1
2023,대포동,5,11,16,1
1267,이기풍선교기념관,6,10,16,1
2085,아시아CGI애니메이션센터,12,4,16,1
966,한림오일시장,12,4,16,1
2707,수산2리입구,2,14,16,1
3264,제주평화박물관,9,7,16,1
2366,제주조각공원,3,13,16,1
2998,장애인복지회관,5,11,16,1
992,상가리,15,1,16,1
889,와산리,10,6,16,1
1673,한국통신,5,11,16,1
1258,이기풍선교기념관,13,3,16,1
1809,보목입구,9,7,16,1
3103,교래분교,11,5,16,1
1791,장안그랜드빌라,2,14,16,1
2953,금산,6,10,16,1
3387,효돈축구공원,1,15,16,1
1282,장전리사무소,3,13,16,1
3639,중문동주민센터,1,15,16,1
2870,서광리넙게오름(축협),14,1,15,1
3170,별내린전망대,11,4,15,1
3208,헬스케어타운리조트,10,5,15,1
3221,선반로입구,9,6,15,1
3171,서광동리웃네거리,7,8,15,1
3165,광평교차로,9,6,15,1
1573,노루생태관찰원,13,2,15,1
3086,상창교차로,1,14,15,1
1668,서진아파트,6,9,15,1
926,저지리,10,5,15,1
2847,굿밭거리,11,4,15,1
920,월림삼거리,2,13,15,1
877,용당리,9,6,15,1
1693,신시가지,9,6,15,1
2854,사거리,8,7,15,1
2563,그린카센터,5,10,15,1
3630,유수암리,1,14,15,1
1786,도영슈퍼앞,2,13,15,1
3638,정방동문화의집,10,5,15,1
3027,사계어촌체험어장,10,5,15,1
1931,뒷빌레,5,10,15,1
1375,주구동산,6,9,15,1
2899,삼화초등학교,6,9,15,1
1311,이시돌하단지,14,1,15,1
2937,앞밭가름,13,2,15,1
2982,화북휴먼시아정문,13,2,15,1
330,수선화아파트,9,6,15,1
1065,교래리,11,3,14,1
891,선흘목선동,9,5,14,1
2632,서귀포천문과학문화관,6,8,14,1
1057,대성목장,8,6,14,1
3308,스위스마을입구,4,10,14,1
2162,산양곶자왈,9,5,14,1
521,오름가름,7,7,14,1
934,명리동,10,4,14,1
674,게이트볼장,7,7,14,1
892,상덕천,5,9,14,1
3191,회수동,12,2,14,1
1193,상도마을회관,2,12,14,1
2808,관광단지입구,11,3,14,1
1365,제주삼다수,8,6,14,1
1497,오등동입구,10,4,14,1
2472,덕수리군물왓,13,1,14,1
4068,블루마운틴커피박물관,11,3,14,1
3229,세계자동차제주박물관,11,3,14,1
921,월림삼거리,12,2,14,1
3079,제주월드컵경기장서문,10,4,14,1
1328,웃가름,13,1,14,1
2289,가시리사무소,9,5,14,1
1968,보목포구입구,12,2,14,1
4228,진부동,7,7,14,1
440,광령3리,3,11,14,1
3526,지미봉입구,1,13,14,1
2722,화순문화마을,11,3,14,1
2065,고갠드르,3,11,14,1
1458,거로사거리,10,4,14,1
1248,한라산둘레길(천아숲길입구),9,5,14,1
803,목선동,12,2,14,1
1983,남문,8,6,14,1
2868,화순리생태탐방로,6,8,14,1
1283,납읍리섯잣길,13,1,14,1
1470,구산마을입구,5,9,14,1
2558,가흥동,10,4,14,1
2174,새소망요양병원,5,9,14,1
2519,서광동리마을,13,1,14,1
3467,번개과학체험관,3,11,14,1
1657,도순동,11,3,14,1
2310,좌기동,13,1,14,1
1547,광평고치동산,1,12,13,1
2267,세화1리마을회관,6,7,13,1
2540,신흥리취락구조,3,10,13,1
730,명월리,4,9,13,1
1313,상가리동동,1,12,13,1
1814,창남거리,8,5,13,1
2513,서광서보건진료소,6,7,13,1
4139,배낭골,4,9,13,1
4091,평대마장,8,5,13,1
1603,청소년수련원,2,11,13,1
460,제일빌리지,11,2,13,1
190,제주중앙중학교,3,10,13,1
2067,서호동마을회관,8,5,13,1
3484,보목동동네,4,9,13,1
1037,와흘리,8,5,13,1
1745,종합문예진흥사업소,5,8,13,1
2040,서홍새마을금고,9,4,13,1
1454,부민장례식장,7,6,13,1
1746,삼매봉도서관,10,3,13,1
794,구몰리동,9,4,13,1
3599,석부작박물관,9,4,13,1
1778,서홍새마을금고,8,5,13,1
1946,서년듸,6,7,13,1
750,조수1리,2,11,13,1
3338,남조순오름입구,8,5,13,1
2643,"남원읍충혼묘지,물영아리",2,11,13,1
180,삼양검문소,4,9,13,1
3247,제주세계자연유산센터입구,11,2,13,1
4048,아라뜨래별,12,1,13,1
1939,남주중고등학교,7,6,13,1
2917,서부신협유통영농조합,11,2,13,1
525,예비군훈련장,11,2,13,1
3020,동문로터리,5,7,12,1
845,대흘2리,3,9,12,1
2266,거물여,6,6,12,1
3067,막동산,10,2,12,1
3041,신흥1번지,7,5,12,1
2913,평화박물관입구,8,4,12,1
2302,신흥2리보건진료소,9,3,12,1
2225,신풍리화단이소,11,1,12,1
893,상덕천마을입구,7,5,12,1
2952,금산,5,7,12,1
3019,동문로터리,4,8,12,1
3022,석교동,5,7,12,1
2931,덕천보건진료소,4,8,12,1
1271,봉개교,3,9,12,1
3393,제지기오름,8,4,12,1
3117,제석머리,8,4,12,1
1794,라임오렌지빌,4,8,12,1
2433,영락리,9,3,12,1
127,종합사격장,10,2,12,1
386,용담새마을금고,2,10,12,1
2654,농협하나로마트,9,3,12,1
1421,삼남내,2,10,12,1
337,혜성무지개타운,8,4,12,1
1084,애월중학교,1,11,12,1
2458,사계리서동,3,9,12,1
1343,하가삼거리,1,11,12,1
3469,소암기념관,7,5,12,1
4087,KIS빌리지,11,1,12,1
2512,서광서보건진료소,6,6,12,1
2590,난산입구,5,7,12,1
2589,신산리,8,4,12,1
1301,이시돌하단지,8,4,12,1
1293,봉성하나로마트,2,10,12,1
1880,돈내코교,3,9,12,1
1813,창남거리,2,10,12,1
455,광령초등학교,5,7,12,1
1043,세미마을,3,9,12,1
3249,한울랜드,8,4,12,1
1549,대흘1리,6,6,12,1
2103,서홍동복지회관,5,7,12,1
938,금악초등학교,8,4,12,1
2773,산방복지회관,5,7,12,1
935,명리동,5,7,12,1
2760,농기구수리센터,1,11,12,1
981,봉성리서성동,9,3,12,1
683,하귀2리,3,9,12,1
2175,새소망요양병원,6,6,12,1
2372,표선청년회의소,7,5,12,1
2383,표선파출소,5,7,12,1
507,상귀리,11,1,12,1
3133,처남빌레,8,4,12,1
613,광령3리사무소,5,6,11,1
1881,고도농원,6,5,11,1
2270,세화1리북문,8,3,11,1
732,남문동,6,5,11,1
2268,세화1리마을회관,4,7,11,1
1853,신례교,5,6,11,1
1925,오희준공원,2,9,11,1
52,도평초등학교,5,6,11,1
181,삼양검문소,6,5,11,1
4052,고산문화의집,8,3,11,1
1708,서귀포경찰서,2,9,11,1
535,오봉교,10,1,11,1
4019,제주장애인요양원,7,4,11,1
339,이도근린공원,6,5,11,1
3600,석부작박물관,8,3,11,1
515,해병대아파트입구,6,5,11,1
2066,서호새마을금고,7,4,11,1
3029,사계용해경로당,7,4,11,1
1721,허물서,2,9,11,1
2036,송산동주민센터,2,9,11,1
2241,신흥리취락구조,8,3,11,1
806,신선동,6,5,11,1
1884,법호촌입구,4,7,11,1
2633,법정사입구,2,9,11,1
2402,바스메,6,5,11,1
2549,토산관광지구입구,8,3,11,1
1045,대흘교차로,4,7,11,1
1288,대흘초등학교,6,5,11,1
2789,수산1리사거리,6,5,11,1
2368,신풍입구,7,4,11,1
1469,구산마을입구,9,2,11,1
1194,상도마을회관,6,5,11,1
2309,무릉2리소공원,2,9,11,1
895,상덕천리,4,7,11,1
381,제주자동차검사소,9,1,10,1
1047,선흘2리입구,7,3,10,1
379,도련1동입구,1,9,10,1
3118,제석머리,6,4,10,1
1272,제주컨트리클럽,4,6,10,1
2205,삼달1리삼달보건진료소,4,6,10,1
3105,어대오름,6,4,10,1
2869,서광리넙게오름(축협),6,4,10,1
3580,통물,8,2,10,1
334,남광초등학교,6,4,10,1
4016,이도수선화아파트,4,6,10,1
3076,새서귀초등학교,4,6,10,1
2224,신풍리사무소,8,2,10,1
2303,신흥2리보건진료소,6,4,10,1
2886,보성리하동,7,3,10,1
2839,산지물,8,2,10,1
1744,남성마을,7,3,10,1
3551,구좌정수장,9,1,10,1
3542,상귀리,2,8,10,1
976,귀덕3리,8,2,10,1
597,금천마을,9,1,10,1
524,예비군훈련장,2,8,10,1
3317,수장동입구,4,6,10,1
989,원동입구,4,6,10,1
1674,한국통신,4,6,10,1
2384,표선파출소,2,8,10,1
137,사회복지법인춘강,1,9,10,1
73,제주시보건소,4,6,10,1
2390,가시리동상동,3,7,10,1
1702,대림한숲빌라,2,8,10,1
1712,머구낭동산,7,3,10,1
1020,신선동,4,6,10,1
2428,무릉문화의집,5,5,10,1
2324,골물동입구,4,6,10,1
931,제주서부신협,2,8,10,1
1035,탐라도뚜리농장,5,5,10,1
57,한라주택,2,8,10,1
3055,하귀농협경제사업장,9,1,10,1
2231,삼달1리,5,5,10,1
2855,사거리,5,5,10,1
969,대림사거리,3,7,10,1
4241,신엄포구,2,8,10,1
2248,일과2리사무소,3,7,10,1
4164,망동산,8,2,10,1
800,복호동입구,6,4,10,1
4197,토산1리송천교,6,4,10,1
3045,불미터,4,6,10,1
2936,앞밭가름,2,8,10,1
2562,동원산업,3,7,10,1
1530,교래자연휴양림,1,9,10,1
1856,사가동,7,3,10,1
1522,사라마을,5,5,10,1
3252,메이즈랜드,6,3,9,1
1715,월평알동네,2,7,9,1
4168,삼매봉중계소입구,6,3,9,1
1732,주거물,2,7,9,1
970,대림리사무소,8,1,9,1
3539,탐라도서관,3,6,9,1
4078,노루생이삼거리,1,8,9,1
3266,아부오름,7,2,9,1
3160,지방합동청사,6,3,9,1
2912,명리동알동네,6,3,9,1
2908,자운당사거리,3,6,9,1
3023,석교동,4,5,9,1
2439,대정서초등학교,1,8,9,1
374,도련반석스위트타운,8,1,9,1
1766,진진내,8,1,9,1
540,온난화대응농업연구소,6,3,9,1
1577,삼양3동포구,6,3,9,1
1488,해병대제9여단,5,4,9,1
2990,김영갑갤러리두모악,2,7,9,1
2989,신흥1번지,5,4,9,1
1872,감귤단지,7,2,9,1
1295,하가리노인회관,1,8,9,1
1442,하귀휴먼시아2단지앞,8,1,9,1
1011,극락사,1,8,9,1
600,은혜마을종점,5,4,9,1
529,대원마을,7,2,9,1
4230,제주신화월드서머셋,6,3,9,1
2098,색달,7,2,9,1
3336,부영3차아파트,6,3,9,1
986,납읍리섯잣길,1,8,9,1
809,어음2리사무소,5,4,9,1
2408,원불교,4,5,9,1
3054,대림아파트,6,3,9,1
4162,인향동,4,5,9,1
1329,웃가름,3,6,9,1
53,아름마을아파트,7,2,9,1
867,신흥동,3,6,9,1
2591,난산입구(성산기상대),7,2,9,1
3038,화순해안경기안전센터사계출장소,4,5,9,1
191,제주중앙중학교,1,8,9,1
1364,제주삼다수,3,6,9,1
2206,삼달1리사무소,5,4,9,1
1929,꽃동산,6,3,9,1
1546,성수동,6,3,9,1
2502,신평리,7,2,9,1
896,웃송당,3,6,9,1
894,상덕천리,1,8,9,1
2576,신천리취락구조,3,5,8,1
1046,대흘교차로,7,1,8,1
2874,제주공천포전지훈련센터,2,6,8,1
2305,신흥2리사무소,2,6,8,1
3198,위미리(위미2리교차로),3,5,8,1
1056,대성목장,3,5,8,1
2541,신흥교차로,1,7,8,1
1767,진진내,1,7,8,1
4247,신엄입구,7,1,8,1
3508,한국전력변전소,2,6,8,1
2325,상수동,4,4,8,1
4243,구엄포구,7,1,8,1
666,사평마을입구,4,4,8,1
1607,금능농공단지,7,1,8,1
3420,문예회관,4,4,8,1
2744,차남동산,3,5,8,1
1682,묵은길입구,5,3,8,1
2108,남성마을,1,7,8,1
246,혜원정사,4,4,8,1
1247,충혼묘지,4,4,8,1
984,구몰리동,3,5,8,1
2837,이교동삼거리,2,6,8,1
2539,태흥3리,4,4,8,1
2866,한남교,7,1,8,1
3262,청수마을회관,2,6,8,1
4161,인향동,5,3,8,1
773,청수리,1,7,8,1
387,병문교,3,5,8,1
2644,사리물,3,5,8,1
3528,하늘정원,5,3,8,1
2096,신라호텔,3,5,8,1
2178,광평리,3,5,8,1
1298,존손이굴,2,6,8,1
1776,솔대왓,5,3,8,1
3161,지방합동청사,1,7,8,1
514,해병대아파트입구,5,2,7,1
1378,탐라교육원,6,1,7,1
16,관전동,1,6,7,1
72,오라초등학교,4,3,7,1
2500,추사유배지,2,5,7,1
534,오봉교,3,4,7,1
4249,고내포구,2,5,7,1
297,부록마을,2,5,7,1
2615,신양입구,5,2,7,1
4053,소보리당입구,5,2,7,1
1348,광령2리사무소,3,4,7,1
1859,동문정류소,5,2,7,1
2084,아시아CGI애니메이션센터,1,6,7,1
4032,선돌목동길,1,6,7,1
1482,달샘마을,3,4,7,1
2561,동원산업,4,3,7,1
3509,한국전력변전소,6,1,7,1
3619,예래동노인회관,6,1,7,1
3618,예래동노인회관,1,6,7,1
4143,유수암리사무소,1,6,7,1
4128,주구동산,4,3,7,1
2652,산하동,5,2,7,1
1910,동홍분식,4,3,7,1
1777,양가왓,6,1,7,1
1759,바가잣도,1,6,7,1
3550,구좌정수장,2,5,7,1
1044,세미마을,6,1,7,1
2663,의귀산하동,5,2,7,1
2434,일과2리사무소,5,2,7,1
1724,섯가름,4,3,7,1
1398,구산마을,2,5,7,1
1395,축산진흥원입구,2,5,7,1
1053,성연목장,5,2,7,1
2637,영실입구,4,3,7,1
3470,덕수2리교차로,2,5,7,1
4012,도평로광평마을입구,4,3,7,1
1774,고근산,1,6,7,1
2409,원불교,3,4,7,1
4117,북촌리,4,3,7,1
2710,사농동산,4,3,7,1
2711,사농동산,3,4,7,1
1192,상도리세화고등학교,4,3,7,1
1681,묵은길입구,4,3,7,1
4018,이도수선화아파트,5,2,7,1
4221,화순해안경비안전센터사계출장소,4,3,7,1
1696,회수동,2,5,7,1
3354,제주동여자중학교,1,6,7,1
3030,사계용해경로당,4,3,7,1
1602,청소년수련원,6,1,7,1
2873,제주공천포전지훈련센터,2,5,7,1
1505,돌선밭,2,5,7,1
3201,제주신화월드서머셋,2,5,7,1
2298,토산1리리사무소앞,3,4,7,1
2846,굿밭거리,3,4,7,1
2226,신풍리사무소,6,1,7,1
772,청수리,6,1,7,1
625,한국방송통신대학,1,6,7,1
1498,오등동입구,2,5,7,1
665,선덕어린이집,5,2,7,1
2296,토산1리노인회관앞,5,2,7,1
3175,국립기상과학원,2,5,7,1
2294,토산1리운동장,5,2,7,1
2315,응전동,1,6,7,1
886,제일농장,6,1,7,1
1487,해병대제9여단,4,3,7,1
3159,"방선문3차,4차빌리지",4,3,7,1
3228,세계자동차제주박물관,4,3,7,1
1605,금능농공단지입구,5,2,7,1
1600,서부신협유통영농조합,5,1,6,1
4120,하도리신동,5,1,6,1
2895,오름중학교,2,4,6,1
1003,장전알동네,4,2,6,1
4126,법기동,3,3,6,1
2804,미타요양원,5,1,6,1
1691,신시가지,2,4,6,1
2211,수산2리퐁낭거리,4,2,6,1
2314,응전동,4,2,6,1
2962,백화동,3,3,6,1
2230,신풍리사거리,1,5,6,1
436,고성1리사무소,3,3,6,1
3531,동부경찰서,2,4,6,1
3530,동부경찰서,2,4,6,1
3529,하늘정원,2,4,6,1
2664,산하동,1,5,6,1
1039,새가름마을,4,2,6,1
2629,위호텔,4,2,6,1
3553,행원교차로,3,3,6,1
4029,대원오등동입구,2,4,6,1
331,이도주공아파트,2,4,6,1
2414,한남리사무소,3,3,6,1
3494,아라뜨래별,3,3,6,1
1382,미래컨벤션센터,1,5,6,1
4043,첨단행복주택,2,4,6,1
1119,한림2리,1,5,6,1
179,진드르,2,4,6,1
2304,신흥2리사무소,5,1,6,1
3479,흙담솔사가,3,3,6,1
3581,봉림사,2,4,6,1
3063,이스트소프트,1,5,6,1
915,상명리,5,1,6,1
3261,청수마을회관,4,2,6,1
1810,토평보목입구,4,2,6,1
3310,한라용사촌,4,2,6,1
980,봉성리서성동,2,4,6,1
2946,상하수도본부,5,1,6,1
1615,제주평화양로원,2,4,6,1
2930,덕천보건진료소,5,1,6,1
2282,거린사슴전망대,3,3,6,1
2101,색달동,5,1,6,1
4191,토산1리송천교,2,4,6,1
830,송당상동,5,1,6,1
2367,상수동,1,5,6,1
1606,금능농공단지,1,5,6,1
2203,물진밭입구,4,2,6,1
1858,동문정류소,4,2,6,1
3010,삼달1리게이트볼장,3,3,6,1
2550,토산관광지구입구,4,2,6,1
2247,일과1리,4,2,6,1
541,온난화대응농업연구소,4,2,6,1
1519,하귀1리,2,4,6,1
3368,일도초등학교,2,4,6,1
3374,상효원수목원,3,3,6,1
1036,탐라도뚜리농장,1,4,5,1
2100,색달동,2,3,5,1
1062,탐라승마장,1,4,5,1
1277,제주컨트리클럽,3,2,5,1
520,오름가름,1,4,5,1
2274,안덕초등학교,1,4,5,1
911,상명리,2,3,5,1
3196,선반로입구,3,2,5,1
4014,도평로광평마을입구,2,3,5,1
1481,달샘마을,3,2,5,1
528,대원마을,1,4,5,1
2320,불미공방,4,1,5,1
2830,진군을리,4,1,5,1
2631,위호텔,3,2,5,1
236,명도암입구,2,3,5,1
2223,신풍리사거리,4,1,5,1
971,대림리사무소,1,4,5,1
2668,디삘레,3,2,5,1
924,저지리성전동,3,2,5,1
678,서부경찰서,1,4,5,1
2222,삼달1리삼거리,2,3,5,1
2520,서광동리소랑못,4,1,5,1
2955,틀라목,2,3,5,1
1029,고평동,1,4,5,1
2229,신풍리화단이소,3,2,5,1
2900,수산저수지입구,4,1,5,1
2292,가시리동하동,3,2,5,1
504,광석동,1,4,5,1
3597,수산리사무소,4,1,5,1
2798,혼착밭,3,2,5,1
508,소앵동입구,2,3,5,1
4119,하도리신동,2,3,5,1
2377,표선중학교,4,1,5,1
1658,속도르,3,2,5,1
4090,송당북문,4,1,5,1
1302,이시돌삼거리,1,4,5,1
2849,남양맨션,1,4,5,1
1490,방선문빌리지,4,1,5,1
4082,선담밭,2,3,5,1
2986,존손이굴,2,3,5,1
2887,보성리상동,3,2,5,1
1583,동부위생처리장입구,1,4,5,1
3137,삼화지구3단지,1,4,5,1
857,금붕사,1,4,5,1
1649,회수삼거리,1,4,5,1
1021,낙선동,1,4,5,1
1923,흙통,4,1,5,1
2940,평화동회관,3,2,5,1
2645,디삘레,3,2,5,1
1709,하원초등학교,2,3,5,1
2417,의귀서동네,3,2,5,1
1860,신례초등학교,3,2,5,1
1707,서귀포경찰서,1,4,5,1
1407,웃드르빛센터,3,1,4,1
3121,하도리개긋물,2,2,4,1
752,조수1리중동,3,1,4,1
733,명월하동,3,1,4,1
1418,봉성리사무소,1,3,4,1
4083,선담밭,1,3,4,1
4027,한라도서관입구,1,3,4,1
764,조수1리,3,1,4,1
1520,애조로광령1리입구,3,1,4,1
4245,가문동마을길,1,3,4,1
2957,정든마을3단지,1,3,4,1
4184,농협서부지점,2,2,4,1
3011,삼달1리사무소,2,2,4,1
2911,명리동알동네,3,1,4,1
4129,붉으내,2,2,4,1
4118,행원리오션뷰2차,3,1,4,1
4092,평대마장,2,2,4,1
4077,의귀초등학교,1,3,4,1
4069,블루마운틴커피박물관,2,2,4,1
1318,산양리,2,2,4,1
2479,대정농공단지,1,3,4,1
3066,막동산,1,3,4,1
1061,탐라승마장,2,2,4,1
718,유수암상동경로당,3,1,4,1
690,광령2리입구,2,2,4,1
494,해안,2,2,4,1
2410,남원2리,2,2,4,1
441,광령3리,2,2,4,1
506,상귀리,1,3,4,1
3385,서귀포동부도서관,2,2,4,1
505,광석동,3,1,4,1
3468,소암기념관,2,2,4,1
55,계명동,1,3,4,1
2747,비안동,1,3,4,1
673,게이트볼장,1,3,4,1
1584,셰프라인월드,2,2,4,1
516,월정사,1,3,4,1
3534,첨단과기단지입구교학촌아파트,2,2,4,1
1643,소보리당입구,2,2,4,1
573,월광로,1,3,4,1
916,월림리,3,1,4,1
2691,삼달1리,3,1,4,1
518,정실마을,1,3,4,1
519,정실,3,1,4,1
708,선인동,2,2,4,1
1638,캐슬렉스골프클럽,1,3,4,1
3438,조천도서관,2,2,4,1
2119,공업단지,3,1,4,1
3309,한라용사촌,2,2,4,1
1617,안국사,1,3,4,1
542,정실오거리,2,2,4,1
3410,대천동주민센터,2,2,4,1
1002,흥국사,1,2,3,1
3422,조천체육관(종점),2,1,3,1
3417,하귀휴먼시아2단지입구,1,2,3,1
1514,우령서로입구,1,2,3,1
502,하귀반석,1,2,3,1
4123,법기동,2,1,3,1
4121,행원리오션뷰2차,2,1,3,1
4145,한스빌타운하우스,2,1,3,1
1804,주공2아파트,2,1,3,1
2918,못거리,2,1,3,1
2903,수산교차로,1,2,3,1
47,학원동,2,1,3,1
1485,오라동주민센터,1,2,3,1
582,오도마을,2,1,3,1
1852,신례교,1,2,3,1
536,진평연립입구,1,2,3,1
1616,안국사,2,1,3,1
2102,서홍동복지회관,2,1,3,1
1518,하귀1리,1,2,3,1
1651,볼목당,2,1,3,1
248,서회천,1,2,3,1
2784,세성로입구,2,1,3,1
2749,남원중학교,2,1,3,1
2926,농굴왓입구,1,2,3,1
2504,신평리상동,1,2,3,1
2373,표선청년회의소,2,1,3,1
632,성지요양원,1,2,3,1
2915,테왓동네,1,2,3,1
1604,금능농공단지입구,1,2,3,1
784,고산2리전답동,2,1,3,1
1621,명도암,1,2,3,1
1428,대림동,1,2,3,1
2418,의귀서동네,1,2,3,1
1758,바가잣도,1,2,3,1
1516,하귀농협장례식장,1,2,3,1
2431,영락사통,1,2,3,1
3493,구좌정수장,1,2,3,1
1984,서호입구,1,2,3,1
767,저지리수동,1,2,3,1
1717,동병듸,1,2,3,1
3582,봉림사,2,1,3,1
2313,평지동옹기박물관,1,2,3,1
3089,오당빌레,2,1,3,1
1025,유수암리,1,2,3,1
2312,평지동,2,1,3,1
1410,산양리감귤선과장,1,2,3,1
2678,토산보건진료소,2,1,3,1
2236,가시농협,2,1,3,1
1763,돗소,1,2,3,1
2239,감산리서동,1,2,3,1
1590,청용사,2,1,3,1
1570,거로마을,2,1,3,1
3104,어대오름,1,2,3,1
1585,셰프라인월드,2,1,3,1
3057,청화마을입구,1,2,3,1
1426,알송당,1,2,3,1
1704,국민건강보험공단,1,2,3,1
883,대흘리,2,1,3,1
4225,화순리동하동경로당,1,1,2,1
2166,신도2리,1,1,2,1
2949,한흘마을입구,1,1,2,1
3332,두문이머세(두맹이골목),1,1,2,1
4220,대정읍다목적회관,1,1,2,1
2333,한남섯동네,1,1,2,1
1545,성수동,1,1,2,1
4205,크라운골프연습장,1,1,2,1
2867,화순리생태탐방로,1,1,2,1
905,수룡동,1,1,2,1
2186,토산초등학교,1,1,2,1
723,용흥리상동,1,1,2,1
2081,동홍초등학교입구,1,1,2,1
841,양잠단지,1,1,2,1
2155,토산1리리사무소,1,1,2,1
4025,이도수선화아파트,1,1,2,1
2195,하천상동회관앞,1,1,2,1
1690,신시가지,1,1,2,1
4099,사장동,1,1,2,1
1803,주공아파트,1,1,2,1
2046,백구동네,1,1,2,1
669,신산마을주차장,1,1,2,1
2486,보성상동,1,1,2,1
649,봉개남문,1,1,2,1
3478,흙담솔사가,1,1,2,1
1001,흥국사,1,1,2,1
1582,동부위생처리장입구,1,1,2,1
3379,모구리야영장,1,1,2,1
1930,뒷빌레,1,1,2,1
264,봉개큰동네,1,1,2,1
1978,거문머들,1,1,2,1
779,조수2리윗동네,1,1,2,1
1976,동홍초등학교,1,1,2,1
2263,남원농협신흥지소,1,1,2,1
1494,신산마을입구,1,1,2,1
372,밤나무골,1,1,2,1